#ϯⲡⲉϥⲟⲩⲟⲉⲓ	V	-
#ϯⲡⲉϥⲟⲩⲟⲓ	V	-
#ϯⲡⲉⲕⲟⲩⲟⲉⲓ	V	-
#ϯⲡⲉⲕⲟⲩⲟⲓ	V	-
#ϯⲡⲉⲛⲟⲩⲟⲉⲓ	V	-
#ϯⲡⲉⲛⲟⲩⲟⲓ	V	-
#ϯⲡⲉⲥⲟⲩⲟⲉⲓ	V	-
#ϯⲡⲉⲥⲟⲩⲟⲓ	V	-
#ϯⲡⲉⲩⲟⲩⲟⲉⲓ	V	-
#ϯⲡⲉⲩⲟⲩⲟⲓ	V	-
#ⲑⲉ	N	-
#ⲓⲛⲉ	V	-
#ⲛⲑⲉ	CONJ	-
#ⲟⲡ	V	-
#ⲟⲩ	N	-
#ⲱ	V	-
,	PUNCT	-
]	PUNCT	-
·ⲻ	PUNCT	-
[	PUNCT	-
.	PUNCT	-
:	PUNCT	-
[....]ⲥ	UNKNOWN	-
[...]ϥ̣	UNKNOWN	-
=ⲥⲙⲟⲩ=	N	-
·	PUNCT	-
ϣ	V	-
ϣϣⲉ	V	-
ϣϥ	V	-
ϣϫⲉ	N	-
ϣϫⲏⲩ	N	-
ϣϭⲁ	V	-
ϣϭⲟⲙ	N	-
ϣϭⲟⲙ	V	-
ϣⲁ	AAOR	-
ϣⲁ	PREP	-
ϣⲁ	V	-
ϣⲁϣ	N	-
ϣⲁϥⲉ	V	-
ϣⲁϥⲧⲉ	N	-
ϣⲁϩ	N	-
ϣⲁϩ	V	-
ϣⲁϩⲛⲕⲱϩⲧ	N	-
ϣⲁϩⲛⲥⲁⲧⲉ	N	-
ϣⲁϩⲣⲁⲓ	ADV	-
ϣⲁϩⲣⲁⲓⲉⲡⲟⲟⲩⲛϩⲟⲟⲩ	ADV	-
ϣⲁϫⲉ	N	-
ϣⲁϫⲉ	V	-
ϣⲁⲁϥ	N	-
ϣⲁⲁⲛⲧ	N	-
ϣⲁⲁⲣ	N	-
ϣⲁⲁⲧ	V	-
ϣⲁⲁⲧ	VSTAT	-
ϣⲁⲃⲟⲗ	ADV	-
ϣⲁⲉϩⲣⲁⲓ	ADV	-
ϣⲁⲉⲛⲉϩ	ADV	-
ϣⲁⲓⲣⲉ	N	-
ϣⲁⲗⲛⲃⲏⲧ	N	-
ϣⲁⲛϩⲏⲧ	N	-
ϣⲁⲛⲁϩⲧⲏϥ	N	-
ϣⲁⲛⲧ	ALIM	-
ϣⲁⲛⲧ	N	-
ϣⲁⲛⲧⲉ	ALIM	-
ϣⲁⲛⲧⲉⲟⲩϣⲱⲡⲉ	ADV	-
ϣⲁⲡⲉⲓⲙⲁ	ADV	-
ϣⲁⲣⲟ	PREP	-
ϣⲁⲣⲱ	PREP	-
ϣⲁⲥⲱⲛⲧ	N	-
ϣⲁⲧ	V	-
ϣⲁⲧⲛ	PREP	-
ϣⲁⲧⲛⲁⲩ	ADV	-
ϣⲁⲩ	N	-
ϣⲃv	V	-
ϣⲃⲃ	V	-
ϣⲃⲃⲓⲱ	N	-
ϣⲃⲉ	N	-
ϣⲃⲉⲉⲣ	N	-
ϣⲃⲏⲣ	N	-
ϣⲃⲏⲣⲕⲗⲏⲣⲟⲛⲟⲙⲟⲥ	N	-
ϣⲃⲣⲙⲉⲗⲟⲥ	N	-
ϣⲃⲣⲣϩⲱⲃ	N	-
ϣⲃⲧ	V	-
ϣⲃⲱ	N	-
ϣⲉ	N	-
ϣⲉϥ	V	-
ϣⲉⲉⲣⲉ	N	-
ϣⲉⲗⲉⲉⲧ	N	-
ϣⲉⲙϣⲉ	V	-
ϣⲉⲙⲁⲃⲧⲁⲥⲉⲛϣⲉ	N	-
ϣⲉⲙⲛⲧϣⲉ	N	-
ϣⲉⲛⲉ	V	-
ϣⲉⲛⲉϩⲧⲏ	V	-
ϣⲉⲛⲉⲗⲟⲟⲗⲉ	N	-
ϣⲉⲛⲟⲩⲧⲉ	NPROP	-
ϣⲉⲡ	V	-
ϣⲉⲡϣⲡ	V	-
ϣⲉⲡϩⲓⲥⲉ	V	-
ϣⲉⲡϩⲙⲟⲧ	V	-
ϣⲉⲡⲟⲩϫⲁⲓ	PREP	-
ϣⲉⲣϣⲱⲣ	V	-
ϣⲉⲥ	V	-
ϣⲉⲧϣⲱⲧ	VSTAT	-
ϣⲉⲧⲁⲓⲟⲩ	N	-
ϣⲏϣ	VSTAT	-
ϣⲏϥ	VSTAT	-
ϣⲏⲓ	N	-
ϣⲏⲕ	VSTAT	-
ϣⲏⲛ	N	-
ϣⲏⲡ	VSTAT	-
ϣⲏⲣⲉ	N	-
ϣⲏⲣⲉϣⲏⲙ	N	-
ϣⲏⲣⲉⲕⲟⲩⲓ	N	-
ϣⲏⲧ	N	-
ϣⲓ	N	-
ϣⲓⲃⲉ	V	-
ϣⲓⲏ	N	-
ϣⲓⲏⲧ	NPROP	-
ϣⲓⲕⲉ	V	-
ϣⲓⲛⲉ	V	-
ϣⲓⲛⲉⲛⲥⲁ	V	-
ϣⲓⲡⲉ	N	-
ϣⲓⲧⲉ	V	-
ϣⲕⲁⲕ	N	-
ϣⲕⲉⲗⲕⲉⲗ	V	-
ϣⲕⲟⲗ	N	-
ϣⲗⲏⲗ	V	-
ϣⲗⲗ	V	-
ϣⲗⲟϥ	N	-
ϣⲙϣⲉ	V	-
ϣⲙϣⲉⲉⲓⲇⲱⲗⲟⲛ	V	-
ϣⲙⲁ	V	-
ϣⲙⲙⲟ	N	-
ϣⲙⲟⲩⲛ	N	-
ϣⲙⲟⲩⲛⲛϣⲟ	N	-
ϣⲛⲉ	N	-
ϣⲛⲏⲩ	N	-
ϣⲛⲥ	N	-
ϣⲟ	N	-
ϣⲟϣ	N	-
ϣⲟϣⲧ	N	-
ϣⲟϫⲛⲉ	N	-
ϣⲟⲃⲉ	VSTAT	-
ϣⲟⲉⲓϣ	N	-
ϣⲟⲉⲓϫ	N	-
ϣⲟⲗϥ	V	-
ϣⲟⲗϩ	VSTAT	-
ϣⲟⲗⲉ	V	-
ϣⲟⲗⲉⲥ	N	-
ϣⲟⲗⲕ	V	-
ϣⲟⲗⲛ	V	-
ϣⲟⲗⲟⲩ	V	-
ϣⲟⲗⲥ	V	-
ϣⲟⲙⲉⲛⲧ	N	-
ϣⲟⲙⲉⲧ	N	-
ϣⲟⲙⲛⲧ	N	-
ϣⲟⲙⲛⲧ	NUM	-
ϣⲟⲙⲧ	N	-
ϣⲟⲙⲧⲉ	N	-
ϣⲟⲛϣ	N	-
ϣⲟⲛϥ	V	-
ϣⲟⲛⲧⲉ	N	-
ϣⲟⲟⲛ	V	-
ϣⲟⲟⲡ	VSTAT	-
ϣⲟⲟⲥ	N	-
ϣⲟⲟⲥⲉ	N	-
ϣⲟⲟⲩⲉ	V	-
ϣⲟⲡ	V	-
ϣⲟⲣϣⲣ	V	-
ϣⲟⲣⲡ	N	-
ϣⲟⲣⲡⲉ	N	-
ϣⲟⲧⲙ	VSTAT	-
ϣⲟⲩ	N	-
ϣⲟⲩϣⲟⲩ	V	-
ϣⲟⲩϣⲧ	N	-
ϣⲟⲩϩⲏⲛⲉ	N	-
ϣⲟⲩⲉ	V	-
ϣⲟⲩⲉⲓⲧ	VSTAT	-
ϣⲟⲩⲙⲉⲣⲓⲧ	N	-
ϣⲟⲩⲙⲟⲩⲧⲉ	N	-
ϣⲟⲩⲟ	V	-
ϣⲟⲩⲟⲉⲓⲧ	VSTAT	-
ϣⲟⲩⲣⲡⲉⲥⲙⲉⲉⲩⲉ	N	-
ϣⲟⲩⲧⲙⲧⲁⲩⲉ	N	-
ϣⲟⲩⲱⲟⲩ	VSTAT	-
ϣⲡ	V	-
ϣⲡϩⲓⲥⲉ	V	-
ϣⲡϩⲙⲟⲧ	V	-
ϣⲡⲉⲛϣⲱⲡ	N	-
ϣⲡⲏⲣⲉ	N	-
ϣⲡⲟⲛ	V	-
ϣⲡⲧⲱⲣⲉ	V	-
ϣⲣϣⲱⲣ	V	-
ϣⲣϣⲱⲣ	VSTAT	-
ϣⲣⲡ	V	-
ϣⲣⲡϣⲁϫⲉ	V	-
ϣⲣⲡⲙⲓⲥⲉ	N	-
ϣⲣⲡⲙⲙⲓⲥⲉ	N	-
ϣⲣⲡⲛ	N	-
ϣⲣⲡⲧⲁⲙⲟ	V	-
ϣⲥⲛⲕⲱⲣⲁⲝ	N	-
ϣⲥⲛⲟⲩⲟϭⲉ	N	-
ϣⲧⲁⲙ	V	-
ϣⲧⲉⲕⲟ	N	-
ϣⲧⲉⲣⲧⲱⲣ	V	-
ϣⲧⲏⲛ	N	-
ϣⲧⲙⲟⲩⲱⲛ	N	-
ϣⲧⲟⲙ	V	-
ϣⲧⲟⲣⲧⲉⲣ	V	-
ϣⲧⲟⲣⲧⲣ	V	-
ϣⲧⲣⲧⲣ	V	-
ϣⲧⲣⲧⲱⲣ	V	-
ϣⲧⲣⲧⲱⲣ	VSTAT	-
ϣⲱ	N	-
ϣⲱϣ	V	-
ϣⲱϥ	V	-
ϣⲱϥⲧ	V	-
ϣⲱϫⲡ	V	-
ϣⲱⲗ	V	-
ϣⲱⲗϩ	V	-
ϣⲱⲗⲙ	V	-
ϣⲱⲙ	N	-
ϣⲱⲙⲉ	N	-
ϣⲱⲛⲉ	V	-
ϣⲱⲛⲧ	V	-
ϣⲱⲡ	V	-
ϣⲱⲡⲉ	V	-
ϣⲱⲣⲡ	V	-
ϣⲱⲥ	N	-
ϣⲱⲥⲙ	N	-
ϣⲱⲱⲧ	V	-
ϣⲱⲱⲧⲛⲉⲓⲇⲱⲗⲟⲛ	N	-
ϥ	PPERO	-
ϥ	PPERS	-
ϥⲁⲓϣⲓⲛⲉ	N	-
ϥⲁⲓⲉⲧⲡⲱ	N	-
ϥⲁⲓⲕⲗⲟⲙ	N	-
ϥⲉϭ	V	-
ϥⲓ	V	-
ϥⲓϩⲣⲁⲩ	V	-
ϥⲓⲡⲣⲟⲟⲩϣ	V	-
ϥⲓⲧ	V	-
ϥⲟϭ	V	-
ϥⲟⲗ	V	-
ϥⲟⲧ	V	-
ϥⲧⲟ	N	-
ϥⲧⲟⲟⲩ	N	-
ϥⲱ	N	-
ϥⲱϭⲉ	V	-
ϥⲱⲧⲉ	V	-
ϥⲱⲱⲣⲉ	V	-
ϩⲁ	PREP	-
ϩⲁϩ	N	-
ϩⲁϩⲛⲥⲟⲡ	ADV	-
ϩⲁϩⲧⲏ	PREP	-
ϩⲁϩⲧⲙ	PREP	-
ϩⲁϩⲧⲛ	PREP	-
ϩⲁϭⲉ	NPROP	-
ϩⲁⲅⲓⲟⲥ	N	-
ϩⲁⲅⲓⲟⲥⲩⲛⲏ	N	-
ϩⲁⲅⲓⲟⲧⲁⲧⲟⲥ	N	-
ϩⲁⲅⲓⲱⲥⲩⲛⲏ	N	-
ϩⲁⲅⲓⲱⲧⲁⲧⲟⲥ	N	-
ϩⲁⲉⲓⲁⲧ	PREP	-
ϩⲁⲉⲓⲃⲉⲥ	N	-
ϩⲁⲉⲓⲃⲥ	N	-
ϩⲁⲉⲓⲙ	N	-
ϩⲁⲏ	N	-
ϩⲁⲑⲏ	ADV	-
ϩⲁⲓ	N	-
ϩⲁⲓⲃⲉⲥ	N	-
ϩⲁⲓⲃⲥ	N	-
ϩⲁⲓⲣⲁⲓⲧⲓⲕⲟⲥ	N	-
ϩⲁⲓⲣⲉⲥⲓⲥ	N	-
ϩⲁⲓⲣⲉⲧⲓⲕⲟⲥ	N	-
ϩⲁⲓⲣⲏⲥⲓⲥ	N	-
ϩⲁⲓⲣⲏⲧⲓⲕⲟⲥ	N	-
ϩⲁⲕ	N	-
ϩⲁⲗⲁⲁⲧⲉ	N	-
ϩⲁⲗⲁⲧⲉ	N	-
ϩⲁⲗⲉ	N	-
ϩⲁⲗⲏⲧ	N	-
ϩⲁⲗⲱⲙ	N	-
ϩⲁⲗⲱⲙⲁ	N	-
ϩⲁⲙⲁ	CONJ	-
ϩⲁⲙⲏⲛ	PTC	-
ϩⲁⲙⲕⲉⲗⲗⲉ	N	-
ϩⲁⲙⲕⲗⲗⲉ	N	-
ϩⲁⲙⲱⲥ	NPROP	-
ϩⲁⲡ	N	-
ϩⲁⲡⲉⲥⲏⲧ	ADV	-
ϩⲁⲡⲗⲟⲩⲥ	N	-
ϩⲁⲡⲗⲱⲥ	ADV	-
ϩⲁⲡⲥ	VBD	-
ϩⲁⲣϣϩⲏⲧ	N	-
ϩⲁⲣⲁⲧ	PREP	-
ϩⲁⲣⲉϣϩⲏⲧ	N	-
ϩⲁⲣⲉϩ	V	-
ϩⲁⲣⲓϩⲁⲣⲟ	PREP	-
ϩⲁⲣⲙⲁ	N	-
ϩⲁⲣⲙⲉⲛⲓⲟⲥ	N	-
ϩⲁⲣⲙⲏⲛⲓⲟⲥ	N	-
ϩⲁⲣⲟ	PREP	-
ϩⲁⲣⲡⲁⲍⲉ	V	-
ϩⲁⲣⲱ	PREP	-
ϩⲁⲥⲉ	N	-
ϩⲁⲥⲓⲉ	N	-
ϩⲁⲧ	N	-
ϩⲁⲧⲃⲉⲥ	N	-
ϩⲁⲧⲉ	PREP	-
ϩⲁⲧⲉ	V	-
ϩⲁⲧⲏ	PREP	-
ϩⲁⲧⲏ	PREP_PPERO	-
ϩⲁⲧⲏⲣ	N	-
ϩⲁⲧⲙ	PREP	-
ϩⲁⲧⲛ	PREP	-
ϩⲁⲧⲟⲟⲧ	PREP	-
ϩⲃⲁ	N	-
ϩⲃⲏⲟⲩⲉ	N	-
ϩⲃⲏⲩⲉ	N	-
ϩⲃⲟⲩⲣ	N	-
ϩⲃⲥⲱ	N	-
ϩⲉ	N	-
ϩⲉ	V	-
ϩⲉϫϩⲱϫ	V	-
ϩⲉⲃⲇⲟⲙⲁⲥ	N	-
ϩⲉⲃⲣⲁⲓⲟⲥ	N	-
ϩⲉⲃⲥ	V	-
ϩⲉⲃⲥⲱ	N	-
ϩⲉⲃⲱⲱⲛ	N	-
ϩⲉⲅⲉⲙⲱⲛ	N	-
ϩⲉⲅⲏⲙⲱⲛ	N	-
ϩⲉⲉϩⲣⲁⲓ	V	-
ϩⲉⲑⲛⲟⲥ	N	-
ϩⲉⲑⲟⲥ	N	-
ϩⲉⲓⲉⲓⲃ	N	-
ϩⲉⲓⲣⲉⲥⲓⲥ	N	-
ϩⲉⲓⲣⲉⲧⲓⲕⲟⲥ	N	-
ϩⲉⲓⲣⲏⲥⲓⲥ	N	-
ϩⲉⲓⲣⲏⲧⲓⲕⲟⲥ	N	-
ϩⲉⲗⲗⲏⲛ	N	-
ϩⲉⲗⲡⲓⲍⲉ	V	-
ϩⲉⲗⲡⲓⲥ	N	-
ϩⲉⲙϩⲁⲗ	N	-
ϩⲉⲛ	ART	-
ϩⲉⲛ	PREP	-
ϩⲉⲛϯⲙⲓⲛⲉ	none	-
ϩⲉⲛⲉⲉⲧⲉ	N	-
ϩⲉⲛⲟⲩϣⲉⲡϩⲙⲟⲧ	ADV	-
ϩⲉⲛⲟⲩϣⲡϩⲙⲟⲧ	ADV	-
ϩⲉⲛⲟⲩϩⲙⲟⲧ	ADV	-
ϩⲉⲛⲟⲩϩⲱⲡ	ADV	-
ϩⲉⲛⲟⲩϫⲱⲕ	ADV	-
ϩⲉⲛⲟⲩϭⲉⲡⲏ	ADV	-
ϩⲉⲛⲟⲩⲡⲉⲑⲏⲡ	ADV	-
ϩⲉⲛⲥⲟⲡ	ADV	-
ϩⲉⲡ	V	-
ϩⲉⲣⲙⲏⲛⲉⲩⲉ	V	-
ϩⲉⲣⲙⲏⲛⲉⲩⲧⲏⲥ	N	-
ϩⲉⲣⲙⲏⲛⲓⲁ	N	-
ϩⲉⲣⲙⲏⲥ	NPROP	-
ϩⲉⲣⲙⲟⲅⲉⲛⲏⲥ	NPROP	-
ϩⲉⲧϩⲱⲧ	V	-
ϩⲉⲧⲃ	V	-
ϩⲏ	N	-
ϩⲏϣ	VSTAT	-
ϩⲏⲃⲉ	N	-
ϩⲏⲃⲥ	N	-
ϩⲏⲅⲉⲙⲱⲛ	N	-
ϩⲏⲅⲏⲙⲱⲛ	N	-
ϩⲏⲇⲟⲛⲏ	N	-
ϩⲏⲕⲉ	N	-
ϩⲏⲗⲉⲓ	NPROP	-
ϩⲏⲗⲉⲓⲁⲥ	NPROP	-
ϩⲏⲗⲏⲕⲓⲁ	N	-
ϩⲏⲗⲓ	NPROP	-
ϩⲏⲗⲓⲁⲥ	NPROP	-
ϩⲏⲗⲓⲕⲓⲁ	N	-
ϩⲏⲗⲓⲟⲇⲱⲣⲟⲥ	NPROP	-
ϩⲏⲗⲗⲏⲛ	NPROP	-
ϩⲏⲙ	VSTAT	-
ϩⲏⲙⲉⲛⲁⲓⲟⲥ	NPROP	-
ϩⲏⲛ	VSTAT	-
ϩⲏⲛⲉ	N	-
ϩⲏⲛⲧ	VSTAT	-
ϩⲏⲡ	VSTAT	-
ϩⲏⲡⲁⲣ	N	-
ϩⲏⲣⲟⲇⲏⲥ	NPROP	-
ϩⲏⲣⲱⲇⲏⲥ	NPROP	-
ϩⲏⲧ	N	-
ϩⲏⲧϥⲙ	PREP	-
ϩⲏⲧⲛⲟⲩⲱⲧ	N	-
ϩⲏⲩ	N	-
ϩⲓ	PREP	-
ϩⲓϫⲉⲛ	PREP	-
ϩⲓϫⲙ	PREP	-
ϩⲓϫⲛ	PREP	-
ϩⲓϫⲱ	PREP	-
ϩⲓⲃⲟⲗ	ADV	-
ϩⲓⲇⲓⲟⲛ	N	-
ϩⲓⲇⲓⲱⲧⲏⲥ	N	-
ϩⲓⲉⲓⲃ	N	-
ϩⲓⲉⲓⲧ	N	-
ϩⲓⲉⲣⲁϯⲟⲛ	N	-
ϩⲓⲉⲣⲟⲛ	N	-
ϩⲓⲉⲣⲟⲥⲟⲗⲩⲙⲁ	NPROP	-
ϩⲓⲉⲣⲟⲩⲥⲁⲗⲏⲙ	NPROP	-
ϩⲓⲉⲣⲟⲫⲁⲛⲧⲏⲥ	N	-
ϩⲓⲏ	N	-
ϩⲓⲑⲏ	ADV	-
ϩⲓⲕⲁⲛⲟⲥ	N	-
ϩⲓⲕⲱⲛ	N	-
ϩⲓⲗⲁ	V	-
ϩⲓⲛⲁⲓ	ADV	-
ϩⲓⲛⲏⲃ	V	-
ϩⲓⲟⲙⲉ	N	-
ϩⲓⲟⲟⲩⲉ	N	-
ϩⲓⲟⲩⲉ	V	-
ϩⲓⲟⲩⲥⲟⲡ	ADV	-
ϩⲓⲡⲉⲥⲏⲧ	ADV	-
ϩⲓⲣ	N	-
ϩⲓⲣⲏⲛⲉ	N	-
ϩⲓⲣⲏⲛⲏ	N	-
ϩⲓⲣⲙ	PREP	-
ϩⲓⲣⲛ	PREP	-
ϩⲓⲣⲱ	PREP	-
ϩⲓⲥⲁⲅⲅⲉⲗⲟⲥ	V	-
ϩⲓⲥⲁⲩⲣⲟⲥ	N	-
ϩⲓⲥⲇⲟⲣⲓⲍⲉ	V	-
ϩⲓⲥⲇⲱⲣⲓⲍⲉ	V	-
ϩⲓⲥⲉ	N	-
ϩⲓⲥⲟⲛ	N	-
ϩⲓⲥⲧⲟⲣⲓⲁ	N	-
ϩⲓⲥⲧⲟⲣⲓⲍⲉ	V	-
ϩⲓⲥⲧⲱⲣⲓⲁ	N	-
ϩⲓⲥⲧⲱⲣⲓⲍⲉ	V	-
ϩⲓⲧⲉ	PREP	-
ϩⲓⲧⲉⲙ	PREP	-
ϩⲓⲧⲙ	PREP	-
ϩⲓⲧⲛ	PREP	-
ϩⲓⲧⲟⲟ	PREP	-
ϩⲓⲧⲟⲟⲧ	PREP	-
ϩⲓⲧⲟⲟⲧ	V	-
ϩⲓⲧⲟⲩⲱ	PREP	-
ϩⲓⲱ	PREP	-
ϩⲓⲱⲛⲉ	V	-
ϩⲓⲱⲧ	PREP	-
ϩⲓⲱⲱ	PREP	-
ϩⲕⲁⲉⲓⲧ	VSTAT	-
ϩⲕⲟ	V	-
ϩⲗⲗⲏⲛ	N	-
ϩⲗⲗⲟ	N	-
ϩⲗⲗⲱ	N	-
ϩⲗⲟϭ	V	-
ϩⲗⲟⲟⲗⲉ	N	-
ϩⲗⲟⲥⲧⲛ	VSTAT	-
ϩⲙ	PREP	-
ϩⲙϩⲁⲗ	N	-
ϩⲙϫ	N	-
ϩⲙⲉ	N	-
ϩⲙⲏ	N	-
ϩⲙⲙⲁⲛⲓⲙ	ADV	-
ϩⲙⲙⲉ	V	-
ϩⲙⲟⲙ	N	-
ϩⲙⲟⲙ	VSTAT	-
ϩⲙⲟⲟⲥ	V	-
ϩⲙⲟⲧ	N	-
ϩⲙⲟⲩ	N	-
ϩⲙⲡⲉϩⲟⲟⲩⲙⲛⲧⲉⲩϣⲏ	ADV	-
ϩⲙⲡⲉⲓⲙⲁ	ADV	-
ϩⲙⲡⲉⲓⲟⲩⲟⲉⲓϣ	ADV	-
ϩⲙⲡⲉⲟⲩⲟⲉⲓϣⲉⲧⲙⲙⲁⲩ	ADV	-
ϩⲙⲡⲓⲟⲩⲟⲉⲓϣ	ADV	-
ϩⲙⲡⲙⲁⲉⲧⲙⲙⲁⲩ	ADV	-
ϩⲙⲡⲥⲁⲥⲛⲁⲩ	ADV	-
ϩⲛ	PREP	-
ϩⲛⲁ	N	-
ϩⲛⲁ	VBD	-
ϩⲛⲁⲁⲩ	N	-
ϩⲛⲁⲁⲩⲛⲕⲁⲥⲟⲧⲉ	N	-
ϩⲛⲁⲩ	N	-
ϩⲛⲁⲩⲛⲕⲁⲥⲟⲧⲉ	N	-
ϩⲛⲉ	VBD	-
ϩⲛⲕⲉⲙⲁ	ADV	-
ϩⲛⲛⲉϩⲟⲟⲩⲛ	PREP	-
ϩⲛⲟ	N	-
ϩⲛⲟⲩϣⲉⲡϩⲙⲟⲧ	ADV	-
ϩⲛⲟⲩϣⲡϩⲙⲟⲧ	ADV	-
ϩⲛⲟⲩϣⲡⲉⲛϣⲱⲡ	ADV	-
ϩⲛⲟⲩϣⲡⲛϣⲱⲡ	ADV	-
ϩⲛⲟⲩϩⲙⲟⲧ	ADV	-
ϩⲛⲟⲩϩⲱⲡ	ADV	-
ϩⲛⲟⲩϫⲱⲕ	ADV	-
ϩⲛⲟⲩϭⲉⲡⲏ	ADV	-
ϩⲛⲟⲩⲙⲉ	ADV	-
ϩⲛⲟⲩⲟⲩⲱⲛϩⲉⲃⲟⲗ	ADV	-
ϩⲛⲟⲩⲡⲉⲑⲏⲡ	ADV	-
ϩⲛⲧⲉⲩϣⲏ	ADV	-
ϩⲛⲧⲉⲩⲛⲟⲩ	ADV	-
ϩⲛⲧⲉⲩⲛⲟⲩⲉⲧⲙⲙⲁⲩ	ADV	-
ϩⲛⲧⲙⲏⲧⲉⲙ	PREP	-
ϩⲛⲧⲙⲏⲧⲉⲛ	PREP	-
ϩⲟ	N	-
ϩⲟϥ	N	-
ϩⲟϫϩϫ	V	-
ϩⲟϫϩⲉϫ	V	-
ϩⲟⲃⲟⲗⲟⲥ	N	-
ϩⲟⲃⲥ	V	-
ϩⲟⲉⲓⲙ	N	-
ϩⲟⲉⲓⲛⲉ	N	-
ϩⲟⲉⲓⲧⲉ	N	-
ϩⲟⲓⲛⲉ	N	-
ϩⲟⲓⲧⲉ	N	-
ϩⲟⲕ	V	-
ϩⲟⲗϭ	VSTAT	-
ϩⲟⲗⲟⲕⲟⲧϯⲛⲟⲥ	N	-
ϩⲟⲗⲟⲕⲟⲧⲧⲓⲛⲟⲥ	N	-
ϩⲟⲗⲟⲥ	ADV	-
ϩⲟⲗⲟⲥⲉⲣⲓⲕⲟⲛ	N	-
ϩⲟⲗⲱⲥ	ADV	-
ϩⲟⲙⲉⲗⲓⲁ	N	-
ϩⲟⲙⲏⲗⲉⲓ	V	-
ϩⲟⲙⲏⲗⲓⲁ	N	-
ϩⲟⲙⲏⲣⲟⲥ	N	-
ϩⲟⲙⲓⲗⲓⲁ	N	-
ϩⲟⲙⲛⲧ	N	-
ϩⲟⲙⲟⲓⲱⲥ	ADV	-
ϩⲟⲙⲟⲗⲓⲁ	N	-
ϩⲟⲙⲟⲗⲟⲅⲉⲓ	V	-
ϩⲟⲙⲟⲗⲟⲅⲓⲁ	N	-
ϩⲟⲙⲟⲛⲟⲓⲁ	N	-
ϩⲟⲙⲟⲟⲩⲥⲓⲟⲛ	N	-
ϩⲟⲙⲟⲟⲩⲥⲓⲟⲥ	N	-
ϩⲟⲙⲱⲥ	ADV	-
ϩⲟⲛ	V	-
ϩⲟⲟⲩ	N	-
ϩⲟⲟⲩ	VSTAT	-
ϩⲟⲟⲩⲧ	N	-
ϩⲟⲡ	V	-
ϩⲟⲡⲗⲟⲛ	N	-
ϩⲟⲣ	V	-
ϩⲟⲣϣ	VSTAT	-
ϩⲟⲣⲁⲙⲁ	N	-
ϩⲟⲣⲙⲁⲕⲏ	N	-
ϩⲟⲣⲙⲏ	N	-
ϩⲟⲣⲟⲙⲁ	N	-
ϩⲟⲣⲟⲥ	N	-
ϩⲟⲥⲉ	VSTAT	-
ϩⲟⲥⲉⲙ	NPROP	-
ϩⲟⲧ	N	-
ϩⲟⲧϩⲉⲧ	V	-
ϩⲟⲧϩⲧ	V	-
ϩⲟⲧⲁⲛ	CONJ	-
ϩⲟⲧⲃ	V	-
ϩⲟⲧⲃⲉ	V	-
ϩⲟⲧⲉ	N	-
ϩⲟⲧⲣ	VSTAT	-
ϩⲟⲩⲉ	ADV	-
ϩⲟⲩⲉⲓⲧⲉ	N	-
ϩⲟⲩⲙⲡⲉ	N	-
ϩⲟⲩⲛ	N	-
ϩⲟⲩⲟ	N	-
ϩⲣⲁⲃⲃⲉⲓ	N	-
ϩⲣⲁⲃⲃⲓ	N	-
ϩⲣⲁⲃⲇⲟⲥ	N	-
ϩⲣⲁⲉⲓ	ADV	-
ϩⲣⲁⲓ	ADV	-
ϩⲣⲁⲓϩⲙ	PREP	-
ϩⲣⲁⲓϩⲛ	PREP	-
ϩⲣⲃ	N	-
ϩⲣⲉ	N	-
ϩⲣⲉⲙⲙⲁ	N	-
ϩⲣⲏⲣⲉ	N	-
ϩⲣⲏⲥⲓⲥ	N	-
ϩⲣⲏⲧⲟⲛ	N	-
ϩⲣⲏⲧⲱⲣ	N	-
ϩⲣⲟϣ	V	-
ϩⲣⲟⲃⲟⲁⲙ	NPROP	-
ϩⲣⲟⲕ	V	-
ϩⲣⲟⲕⲛϩⲏⲧ	N	-
ϩⲣⲟⲟⲩ	N	-
ϩⲣⲟⲩⲃⲃⲁⲓ	N	-
ϩⲣⲱ	N	-
ϩⲣⲱⲙⲁⲓⲟⲥ	N	-
ϩⲣⲱⲙⲁⲓⲱⲥ	N	-
ϩⲣⲱⲙⲁⲛⲟⲥ	NPROP	-
ϩⲣⲱⲙⲏ	NPROP	-
ϩⲧⲉⲙⲧⲟⲙⲧ	VSTAT	-
ϩⲧⲉⲙⲧⲱⲙ	VSTAT	-
ϩⲧⲏ	N	-
ϩⲧⲙⲧⲟⲙⲧ	VSTAT	-
ϩⲧⲙⲧⲱⲙ	VSTAT	-
ϩⲧⲟ	N	-
ϩⲧⲟⲙⲧⲉⲙ	V	-
ϩⲧⲟⲙⲧⲙ	V	-
ϩⲧⲟⲟⲩⲉ	N	-
ϩⲧⲟⲡ	N	-
ϩⲧⲟⲣ	N	-
ϩⲧⲱⲱⲣ	N	-
ϩⲩⲗⲓⲕⲟⲛ	N	-
ϩⲩⲙⲉⲛⲁⲓⲟⲥ	NPROP	-
ϩⲩⲡⲁⲣ	N	-
ϩⲩⲡⲁⲣⲭⲟⲛⲧⲁ	N	-
ϩⲩⲡⲉⲣⲉⲓⲧⲉⲓ	V	-
ϩⲩⲡⲉⲣⲉⲧⲉⲓ	V	-
ϩⲩⲡⲉⲣⲏⲧⲉⲓ	V	-
ϩⲩⲡⲉⲣⲏⲧⲏⲥ	N	-
ϩⲩⲡⲉⲣⲓⲭⲟⲥ	NPROP	-
ϩⲩⲡⲟⲅⲟⲣⲉⲩⲉ	V	-
ϩⲩⲡⲟⲅⲣⲁⲫⲉ	V	-
ϩⲩⲡⲟⲅⲣⲁⲫⲏ	V	-
ϩⲩⲡⲟⲇⲓⲁⲕⲟⲛⲟⲥ	N	-
ϩⲩⲡⲟⲕⲓⲥⲑⲁⲓ	V	-
ϩⲩⲡⲟⲕⲓⲥⲑⲉ	V	-
ϩⲩⲡⲟⲕⲣⲓⲛⲉ	V	-
ϩⲩⲡⲟⲕⲣⲓⲥⲓⲥ	N	-
ϩⲩⲡⲟⲕⲣⲓⲧⲏⲥ	N	-
ϩⲩⲡⲟⲙⲉⲓⲛⲉ	V	-
ϩⲩⲡⲟⲙⲓⲛⲉ	V	-
ϩⲩⲡⲟⲙⲛⲏⲙⲁ	N	-
ϩⲩⲡⲟⲙⲟⲛⲏ	N	-
ϩⲩⲡⲟⲡⲟⲇⲓⲟⲛ	N	-
ϩⲩⲡⲟⲥⲧⲁⲥⲓⲥ	N	-
ϩⲩⲡⲟⲧⲁⲅⲏ	N	-
ϩⲩⲡⲟⲧⲁⲥⲥⲉ	V	-
ϩⲱ	IMOD	-
ϩⲱ	V	-
ϩⲱϣ	V	-
ϩⲱϥⲧ	V	-
ϩⲱϭⲃ	V	-
ϩⲱⲃ	N	-
ϩⲱⲃⲛⲓⲙ	N	-
ϩⲱⲃⲥ	V	-
ϩⲱⲕ	V	-
ϩⲱⲗ	V	-
ϩⲱⲗⲟⲥ	ADV	-
ϩⲱⲗⲱⲥ	ADV	-
ϩⲱⲙ	V	-
ϩⲱⲙⲟⲓⲱⲥ	ADV	-
ϩⲱⲛ	V	-
ϩⲱⲛⲧ	V	-
ϩⲱⲟⲩ	V	-
ϩⲱⲡ	V	-
ϩⲱⲣϭ	V	-
ϩⲱⲣⲃ	V	-
ϩⲱⲣⲓⲅⲉⲛⲏⲥ	NPROP	-
ϩⲱⲣⲡ	V	-
ϩⲱⲣⲥⲓⲉⲥⲓⲟⲥ	NPROP	-
ϩⲱⲣⲥⲓⲏⲥⲓⲟⲥ	NPROP	-
ϩⲱⲥ	CONJ	-
ϩⲱⲥ	N	-
ϩⲱⲥⲇⲉ	CONJ	-
ϩⲱⲥⲧⲉ	CONJ	-
ϩⲱⲧⲃ	V	-
ϩⲱⲧⲡ	V	-
ϩⲱⲱ	IMOD	-
ϫⲁϩⲙ	V	-
ϫⲁϩⲙ	VSTAT	-
ϫⲁϫ	N	-
ϫⲁϫⲉ	N	-
ϫⲁϫⲱ	VSTAT	-
ϫⲁⲉⲓⲉ	N	-
ϫⲁⲓⲉ	N	-
ϫⲁⲓⲏ	N	-
ϫⲁⲥⲓϩⲏⲧ	N	-
ϫⲁⲥⲧ	V	-
ϫⲁⲥⲧⲉ	V	-
ϫⲁⲧϥⲉ	N	-
ϫⲁⲧⲃⲉ	N	-
ϫⲁⲩⲙⲟⲉⲓⲧ	N	-
ϫⲁⲩⲙⲟⲓⲧ	N	-
ϫⲉ	CONJ	-
ϫⲉ	V	-
ϫⲉϭⲟⲗ	V	-
ϫⲉⲕ	V	-
ϫⲉⲕϫⲓⲕ	V	-
ϫⲉⲕⲁⲁⲥ	CONJ	-
ϫⲉⲕⲁⲥ	CONJ	-
ϫⲉⲛⲙⲙⲟⲛ	CONJ	-
ϫⲉⲟⲩⲁ	V	-
ϫⲉⲡ	N	-
ϫⲉⲣⲟ	V	-
ϫⲉⲣⲱ	V	-
ϫⲉⲣⲱϥ	V	-
ϫⲉⲩ	V	-
ϫⲏϩ	VSTAT	-
ϫⲏⲕ	VSTAT	-
ϫⲏⲣ	VSTAT	-
ϫⲏⲩⲛϭⲟⲛⲥ	VSTAT	-
ϫⲓ	ADV	-
ϫⲓ	PREP	-
ϫⲓ	V	-
ϫⲓϣⲓⲡⲉ	V	-
ϫⲓϣⲕⲁⲕⲉⲃⲟⲗ	V	-
ϫⲓϩ	N	-
ϫⲓϩⲁⲡ	V	-
ϫⲓϩⲟ	V	-
ϫⲓϩⲣⲃ	V	-
ϫⲓϫⲉⲉⲩⲉ	N	-
ϫⲓϫⲉⲩⲉ	N	-
ϫⲓϭⲟⲗ	V	-
ϫⲓϯ	N	-
ϫⲓϯⲡⲉ	V	-
ϫⲓⲁⲉⲓⲕ	N	-
ϫⲓⲕⲃⲁ	N	-
ϫⲓⲙⲟⲉⲓⲧ	V	-
ϫⲓⲛ	ADV	-
ϫⲓⲛ	PREP	-
ϫⲓⲛϣⲟⲣⲡ	ADV	-
ϫⲓⲛϭⲟⲛⲥ	N	-
ϫⲓⲛⲉ	PREP	-
ϫⲓⲛⲉⲡⲉⲩⲟⲉⲓϣ	ADV	-
ϫⲓⲛⲉⲡⲉⲩⲟⲉⲓϣⲉⲧⲙⲙⲁⲩ	ADV	-
ϫⲓⲛⲙ	PREP	-
ϫⲓⲛⲙⲙⲟⲛ	CONJ	-
ϫⲓⲛⲛ	PREP	-
ϫⲓⲛⲛϣⲟⲣⲡ	ADV	-
ϫⲓⲛⲧⲁ	CONJ	-
ϫⲓⲛⲧⲉⲛⲟⲩ	ADV	-
ϫⲓⲟⲟⲣ	V	-
ϫⲓⲟⲩⲁ	V	-
ϫⲓⲟⲩⲉ	V	-
ϫⲓⲡⲟⲩⲱ	V	-
ϫⲓⲥϩⲓⲙⲉ	V	-
ϫⲓⲥⲃⲱ	V	-
ϫⲓⲥⲉ	V	-
ϫⲓⲥⲉⲛϩⲏⲧ	V	-
ϫⲓⲥⲙⲟⲩ	V	-
ϫⲓⲥⲱϣ	V	-
ϫⲓⲧ	V	-
ϫⲓⲧⲓⲡⲉ	V	-
ϫⲓⲧⲟ	V	-
ϫⲛⲁⲁⲩ	N	-
ϫⲛⲉ	V	-
ϫⲛⲙⲙⲟⲛ	CONJ	-
ϫⲛⲟⲩ	V	-
ϫⲟ	V	-
ϫⲟⲉⲓ	N	-
ϫⲟⲉⲓⲥ	N	-
ϫⲟⲉⲓⲧ	N	-
ϫⲟⲓ	N	-
ϫⲟⲕ	V	-
ϫⲟⲕⲉⲣ	V	-
ϫⲟⲕⲣ	V	-
ϫⲟⲛⲧ	VSTAT	-
ϫⲟⲟ	V	-
ϫⲟⲟⲃⲉ	V	-
ϫⲟⲟⲗⲉⲥ	N	-
ϫⲟⲟⲣ	V	-
ϫⲟⲟⲣ	VSTAT	-
ϫⲟⲟⲣⲉ	V	-
ϫⲟⲟⲣⲉ	VSTAT	-
ϫⲟⲟⲩ	V	-
ϫⲟⲟⲩⲉⲣⲁⲧ	V	-
ϫⲟⲟⲩⲧ	N	-
ϫⲟⲥⲉ	VSTAT	-
ϫⲟⲩϩⲉ	V	-
ϫⲟⲩⲥⲛⲟⲟⲩⲥ	N	-
ϫⲟⲩⲧ	N	-
ϫⲟⲩⲧⲁϥⲧⲉ	N	-
ϫⲟⲩⲧⲏ	N	-
ϫⲟⲩⲧⲥⲛⲟⲟⲩⲥ	N	-
ϫⲟⲩⲱⲧⲉ	N	-
ϫⲟⲩⲱⲧⲛϣⲉ	N	-
ϫⲡ	N	-
ϫⲡⲉ	V	-
ϫⲡⲓⲉ	V	-
ϫⲡⲓⲟ	V	-
ϫⲡⲟ	N	-
ϫⲡⲟ	V	-
ϫⲣⲁⲉⲓⲧ	VSTAT	-
ϫⲣⲟ	V	-
ϫⲣⲟⲉⲓⲧ	VSTAT	-
ϫⲣⲟⲡ	N	-
ϫⲧⲟ	V	-
ϫⲱ	N	-
ϫⲱ	V	-
ϫⲱϩ	V	-
ϫⲱϩⲙ	N	-
ϫⲱϩⲙ	V	-
ϫⲱϭⲉ	V	-
ϫⲱⲕ	V	-
ϫⲱⲕⲉⲃⲟⲗ	V	-
ϫⲱⲕⲙ	V	-
ϫⲱⲕⲣ	V	-
ϫⲱⲗϫ	V	-
ϫⲱⲙⲙⲟⲟⲩ	V	-
ϫⲱⲛⲧ	V	-
ϫⲱⲣ	V	-
ϫⲱⲣⲉⲙ	V	-
ϫⲱⲣⲙ	V	-
ϫⲱⲧⲉ	V	-
ϫⲱⲱⲙⲉ	N	-
ϫⲱⲱⲣⲉ	V	-
ϭⲁⲗⲉ	V	-
ϭⲁⲗⲱⲟⲩ	VSTAT	-
ϭⲁⲗⲱⲱ	V	-
ϭⲁⲙⲟⲩⲗ	N	-
ϭⲃϣⲁ	N	-
ϭⲃⲃⲉ	V	-
ϭⲃⲟⲉⲓ	N	-
ϭⲃⲟⲓ	N	-
ϭⲉ	ART	-
ϭⲉⲃ	V	-
ϭⲉⲃⲃⲉ	V	-
ϭⲉⲉⲧ	VSTAT	-
ϭⲉⲗⲉ	V	-
ϭⲉⲗⲙⲁⲓ	N	-
ϭⲉⲗⲡ	V	-
ϭⲉⲛ	V	-
ϭⲉⲛⲑⲉⲛ	V	-
ϭⲉⲛⲧ	V	-
ϭⲉⲡ	V	-
ϭⲉⲡⲏ	V	-
ϭⲉⲣⲁϭⲉ	N	-
ϭⲉⲣⲱϥ	N	-
ϭⲉⲣⲱⲃ	N	-
ϭⲏⲡ	VSTAT	-
ϭⲏⲩ	VSTAT	-
ϭⲓϫ	N	-
ϭⲓⲃⲱⲧⲟⲥ	N	-
ϭⲓⲏⲛⲃⲁⲁⲙⲡⲉ	N	-
ϭⲓⲙⲙⲟⲟϣⲉ	N	-
ϭⲓⲛϣⲁϫⲉ	N	-
ϭⲓⲛϣⲙϣⲉ	N	-
ϭⲓⲛϩⲉ	N	-
ϭⲓⲛϭⲱⲣ	N	-
ϭⲓⲛⲃⲱⲕ	N	-
ϭⲓⲛⲉ	V	-
ϭⲓⲛⲉⲓ	N	-
ϭⲓⲛⲉⲙⲡϣⲓⲛⲉ	V	-
ϭⲓⲛⲉⲣϩⲱⲃ	N	-
ϭⲓⲛⲙⲓϣⲉ	N	-
ϭⲓⲛⲟⲩⲱⲙ	N	-
ϭⲓⲛⲟⲩⲱⲱⲙ	N	-
ϭⲓⲛⲣϩⲱⲃ	N	-
ϭⲓⲛⲥϩⲁⲓ	N	-
ϭⲓⲛⲥⲁⲁⲛϣ	N	-
ϭⲓⲛⲥⲩⲛⲁⲅⲉ	N	-
ϭⲓⲛⲥⲱ	N	-
ϭⲓⲛⲱ	N	-
ϭⲓⲛⲱϣ	N	-
ϭⲓⲛⲱⲛϩ	N	-
ϭⲗⲙⲁⲓ	N	-
ϭⲗⲟⲙⲗⲉⲙ	N	-
ϭⲗⲟⲙⲗⲙ	N	-
ϭⲗⲟⲟϭⲉ	N	-
ϭⲗⲟⲟⲧⲉ	N	-
ϭⲗⲟⲧⲉ	N	-
ϭⲗⲡ	V	-
ϭⲗⲱⲱⲧ	N	-
ϭⲙ	V	-
ϭⲙϭⲟⲙ	V	-
ϭⲙⲡϣⲓⲛⲉ	V	-
ϭⲛ	V	-
ϭⲛⲁⲣⲓⲕⲉ	V	-
ϭⲛⲑⲉⲙ	V	-
ϭⲛⲑⲉⲛ	V	-
ϭⲛⲟⲛ	V	-
ϭⲛⲣⲁⲧ	V	-
ϭⲛⲧ	V	-
ϭⲟϫϥ	VSTAT	-
ϭⲟϫϭⲉϫ	V	-
ϭⲟϫⲃ	VSTAT	-
ϭⲟⲉⲓⲗⲉ	V	-
ϭⲟⲓⲗⲉ	V	-
ϭⲟⲗ	N	-
ϭⲟⲗϫ	V	-
ϭⲟⲗⲡ	V	-
ϭⲟⲗⲡ	VSTAT	-
ϭⲟⲙ	N	-
ϭⲟⲙϭⲉⲙ	V	-
ϭⲟⲙϭⲙ	V	-
ϭⲟⲛⲥ	N	-
ϭⲟⲛⲧ	VSTAT	-
ϭⲟⲟⲗⲉ	V	-
ϭⲟⲟⲗⲉ	VSTAT	-
ϭⲟⲟⲙ	N	-
ϭⲟⲟⲙⲉ	N	-
ϭⲟⲟⲩⲛⲉ	N	-
ϭⲟⲡ	V	-
ϭⲟⲣϣ	V	-
ϭⲟⲣϭⲥ	N	-
ϭⲟⲥⲙ	VSTAT	-
ϭⲟⲧ	N	-
ϭⲣⲏⲡⲉ	N	-
ϭⲣⲟϭ	N	-
ϭⲣⲟⲙⲡⲉ	N	-
ϭⲣⲟⲛⲟⲥ	N	-
ϭⲣⲟⲟϭ	N	-
ϭⲣⲟⲟⲙⲡⲉ	N	-
ϭⲣⲱϩ	N	-
ϭⲱ	V	-
ϭⲱϣⲧ	V	-
ϭⲱϫⲃ	V	-
ϭⲱⲃ	N	-
ϭⲱⲗⲡ	V	-
ϭⲱⲛⲧ	N	-
ϭⲱⲟⲩ	V	-
ϭⲱⲡⲉ	V	-
ϭⲱⲡⲧ	V	-
ϭⲱⲣϣ	V	-
ϭⲱⲣϭ	V	-
ϭⲱⲧϩ	V	-
ϭⲱⲧⲡ	V	-
ϭⲱⲧⲣ	V	-
ϭⲱⲱⲃⲉ	V	-
ϭⲱⲱⲙⲉ	V	-
ϯ	N	-
ϯ	PDEM	-
ϯ	PPERS	-
ϯ	V	-
ϯϩⲉ	V	-
ϯϩⲧⲏ	V	-
ϯϭⲟⲙ	V	-
ϯⲁⲕⲱⲛⲉⲓ	V	-
ϯⲉ	N	-
ϯⲉⲓϥⲧ	V	-
ϯⲉⲟⲟⲩ	V	-
ϯⲑⲉ	V	-
ϯⲗⲟⲅⲟⲥ	V	-
ϯⲙⲉ	N	-
ϯⲙⲡⲉϥⲟⲩⲟⲉⲓ	V	-
ϯⲙⲡⲉϥⲟⲩⲟⲓ	V	-
ϯⲙⲡⲉⲕⲟⲩⲟⲉⲓ	V	-
ϯⲙⲡⲉⲕⲟⲩⲟⲓ	V	-
ϯⲙⲡⲉⲛⲟⲩⲟⲉⲓ	V	-
ϯⲙⲡⲉⲛⲟⲩⲟⲓ	V	-
ϯⲙⲡⲉⲥⲟⲩⲟⲉⲓ	V	-
ϯⲙⲡⲉⲥⲟⲩⲟⲓ	V	-
ϯⲙⲡⲉⲩⲟⲩⲟⲉⲓ	V	-
ϯⲙⲡⲉⲩⲟⲩⲟⲓ	V	-
ϯⲙⲧⲟⲛ	V	-
ϯⲛⲁⲁⲕⲉ	V	-
ϯⲛⲟⲩϭⲥ	V	-
ϯⲟⲩ	N	-
ϯⲟⲩⲃⲉ	V	-
ϯⲟⲩⲛϣⲉ	N	-
ϯⲟⲩⲛϣⲟ	N	-
ϯⲟⲩⲟⲉⲓ	V	-
ϯⲟⲩⲟⲓ	V	-
ϯⲟⲩⲱ	V	-
ϯⲡⲁⲟⲩⲟⲓ	V	-
ϯⲡⲉ	N	-
ϯⲡⲓ	V	-
ϯⲣⲁⲛ	V	-
ϯⲣⲏⲛⲏ	N	-
ϯⲥⲃⲱ	V	-
ϯⲥⲟ	V	-
ϯⲧⲟⲟⲧ	V	-
ϯⲧⲟⲟⲧⲟⲩ	V	-
ϯⲧⲱⲛ	N	-
ϯⲱⲛϩ	V	-
ϯⲱⲧⲉ	N	-
ⲁ	APST	-
ⲁ	FUT	-
ⲁϣ	PINT	-
ⲁϣⲁϩⲟⲙ	N	-
ⲁϣⲉ	VSTAT	-
ⲁϣⲏ	N	-
ⲁϣⲟⲉⲓϣ	N	-
ⲁϣⲧ	V	-
ⲁϥ	N	-
ⲁϩⲉ	V	-
ⲁϩⲉⲣⲁⲧ	V	-
ⲁϩⲟⲣⲁⲧⲟⲥ	N	-
ⲁϩⲣⲟ	VBD	-
ⲁϩⲣⲱ	VBD	-
ⲁϩⲱⲙ	N	-
ⲁϩⲱⲱⲣ	N	-
ⲁϫⲓ	VIMP	-
ⲁϫⲙ	PREP	-
ⲁϫⲛ	PREP	-
ⲁϫⲛⲧ	PREP	-
ⲁϫⲛⲱϫⲛ	ADV	-
ⲁϭⲃⲉⲥ	N	-
ⲁϭⲃⲥ	N	-
ⲁϭⲣⲏⲛ	N	-
ⲁⲁ	V	-
ⲁⲁϥ	V	-
ⲁⲁⲣⲱⲛ	NPROP	-
ⲁⲃⲁⲅⲟⲩⲙ	NPROP	-
ⲁⲃⲁⲕⲟⲩⲙ	NPROP	-
ⲁⲃⲃⲁ	N	-
ⲁⲃⲉⲛⲛⲏⲣ	NPROP	-
ⲁⲃⲓⲁ	NPROP	-
ⲁⲃⲓⲁⲥ	NPROP	-
ⲁⲃⲓⲙⲉⲗⲉⲭ	NPROP	-
ⲁⲃⲓⲟⲩⲇ	NPROP	-
ⲁⲃⲓⲣⲱⲛ	NPROP	-
ⲁⲃⲓⲥⲁⲗⲱⲙ	NPROP	-
ⲁⲃⲟⲟⲩⲉ	N	-
ⲁⲃⲣⲁϩⲁⲙ	NPROP	-
ⲁⲃⲱ	N	-
ⲁⲃⲱⲕ	N	-
ⲁⲅⲁⲅⲓⲟⲥ	NPROP	-
ⲁⲅⲁⲑⲟⲛ	N	-
ⲁⲅⲁⲑⲟⲛⲓⲕⲟⲥ	NPROP	-
ⲁⲅⲁⲑⲟⲥ	N	-
ⲁⲅⲁⲑⲱⲛⲓⲕⲟⲥ	NPROP	-
ⲁⲅⲁⲕⲓⲟⲥ	NPROP	-
ⲁⲅⲁⲗⲙⲁ	N	-
ⲁⲅⲁⲡⲏ	N	-
ⲁⲅⲅⲉⲗⲟⲥ	N	-
ⲁⲅⲅⲓⲟⲛ	N	-
ⲁⲅⲉⲗⲏ	N	-
ⲁⲅⲉⲛⲛⲏⲧⲟⲥ	N	-
ⲁⲅⲓⲟⲛ	N	-
ⲁⲅⲕⲩⲣⲁ	NPROP	-
ⲁⲅⲙⲏ	N	-
ⲁⲅⲟⲛⲓⲁ	N	-
ⲁⲅⲟⲣⲁ	N	-
ⲁⲅⲣⲓⲟⲛ	N	-
ⲁⲅⲣⲓⲟⲥ	N	-
ⲁⲅⲣⲓⲡⲡⲁⲥ	NPROP	-
ⲁⲅⲱⲅⲏ	N	-
ⲁⲅⲱⲛ	N	-
ⲁⲅⲱⲛⲓⲍⲉ	V	-
ⲁⲇⲁⲙ	NPROP	-
ⲁⲇⲓⲕⲉⲓ	V	-
ⲁⲇⲓⲕⲟⲛ	N	-
ⲁⲇⲓⲕⲟⲥ	N	-
ⲁⲉⲓⲕ	N	-
ⲁⲍⲱⲣⲁ	NPROP	-
ⲁⲍⲱⲣⲁⲥ	NPROP	-
ⲁⲏⲣ	N	-
ⲁⲑⲁⲛⲁⲥⲓⲟⲥ	NPROP	-
ⲁⲑⲉⲧⲉⲓ	V	-
ⲁⲑⲏⲧ	N	-
ⲁⲑⲱⲣ	NPROP	-
ⲁⲓⲛⲓⲅⲙⲁ	N	-
ⲁⲓⲥⲑⲁⲛⲉ	V	-
ⲁⲓⲥⲑⲏⲧⲏⲣⲓⲟⲛ	N	-
ⲁⲓⲧⲉⲓ	V	-
ⲁⲓⲧⲏⲙⲁ	N	-
ⲁⲓⲧⲓⲁ	N	-
ⲁⲓⲧⲓⲟⲥ	N	-
ⲁⲓⲭⲙⲁⲗⲟⲧⲓⲍⲉ	V	-
ⲁⲓⲭⲙⲁⲗⲟⲧⲟⲥ	N	-
ⲁⲓⲭⲙⲁⲗⲱⲥⲓⲁ	N	-
ⲁⲓⲭⲙⲁⲗⲱⲧⲓⲍⲉ	V	-
ⲁⲓⲭⲙⲁⲗⲱⲧⲟⲥ	N	-
ⲁⲓⲱⲛ	N	-
ⲁⲓⲱⲛⲓⲟⲛ	N	-
ⲁⲕⲁⲅⲓⲟⲥ	NPROP	-
ⲁⲕⲁⲑⲁⲣⲥⲓⲁ	N	-
ⲁⲕⲁⲑⲁⲣⲧⲟⲛ	N	-
ⲁⲕⲁⲑⲁⲣⲧⲟⲥ	N	-
ⲁⲕⲁⲓⲣⲟⲛ	N	-
ⲁⲕⲁⲕⲓⲟⲥ	NPROP	-
ⲁⲕⲁⲛⲁⲕⲧⲓ	V	-
ⲁⲕⲉⲗⲇⲁⲙⲁⲭ	NPROP	-
ⲁⲕⲉⲗⲧⲁⲙⲁⲭ	NPROP	-
ⲁⲕⲓⲛⲏⲧⲟⲛ	N	-
ⲁⲕⲣⲓⲃⲓⲁ	N	-
ⲁⲕⲣⲓⲟⲛ	N	-
ⲁⲕⲣⲟⲁⲧⲏⲥ	N	-
ⲁⲕⲣⲱⲁⲧⲏⲥ	N	-
ⲁⲕⲧⲓⲛ	N	-
ⲁⲗⲉ	V	-
ⲁⲗⲉⲝⲁⲛⲇⲣⲉⲩⲥ	N	-
ⲁⲗⲉⲝⲁⲛⲇⲣⲟⲥ	NPROP	-
ⲁⲗⲏⲑⲉⲓⲁ	N	-
ⲁⲗⲏⲑⲓⲛⲏ	N	-
ⲁⲗⲏⲑⲓⲛⲟⲛ	N	-
ⲁⲗⲏⲑⲱⲥ	ADV	-
ⲁⲗⲏⲩ	VSTAT	-
ⲁⲗⲓⲑⲓⲛⲏ	N	-
ⲁⲗⲕⲥ	N	-
ⲁⲗⲗⲁ	CONJ	-
ⲁⲗⲗⲏⲅⲟⲣⲉⲓ	V	-
ⲁⲗⲟⲟⲩⲉ	N	-
ⲁⲗⲟⲩ	N	-
ⲁⲗⲱⲧ	VIMP	-
ⲁⲙⲁϩⲧⲉ	V	-
ⲁⲙⲉⲗⲉⲓ	V	-
ⲁⲙⲉⲗⲉⲓⲁ	N	-
ⲁⲙⲉⲗⲓ	V	-
ⲁⲙⲉⲗⲓⲁ	N	-
ⲁⲙⲏⲉⲓ	VIMP	-
ⲁⲙⲏⲉⲓⲛ	VIMP	-
ⲁⲙⲏⲉⲓⲧⲛ	VIMP	-
ⲁⲙⲏⲓ	VIMP	-
ⲁⲙⲏⲓⲧⲛ	VIMP	-
ⲁⲙⲓⲛⲁⲇⲁⲃ	NPROP	-
ⲁⲙⲙⲱⲧⲓⲟⲛ	NPROP	-
ⲁⲙⲛⲧⲉ	N	-
ⲁⲙⲟⲩ	VIMP	-
ⲁⲙⲟⲩⲧⲉ	VIMP	-
ⲁⲙⲫⲓⲁⲍⲉ	V	-
ⲁⲙⲱⲛⲁ	NPROP	-
ⲁⲛ	NEG	-
ⲁⲛϩⲁⲗⲓⲥⲕⲉ	V	-
ⲁⲛϩⲟⲗⲟⲙⲁ	N	-
ⲁⲛϩⲟⲥⲓⲟⲥ	N	-
ⲁⲛϫⲱϫ	N	-
ⲁⲛϯⲛⲱⲟⲩ	NPROP	-
ⲁⲛⲁϣ	N	-
ⲁⲛⲁⲅⲕⲁⲍⲉ	V	-
ⲁⲛⲁⲅⲕⲁⲓⲟⲛ	N	-
ⲁⲛⲁⲅⲕⲏ	N	-
ⲁⲛⲁⲅⲛⲱⲥⲧⲏⲥ	N	-
ⲁⲛⲁⲅⲛⲱⲥⲧⲓⲕⲟⲛ	N	-
ⲁⲛⲁⲑⲉⲙⲁ	N	-
ⲁⲛⲁⲑⲉⲙⲁⲧⲓⲍⲉ	V	-
ⲁⲛⲁⲑⲏⲙⲁ	N	-
ⲁⲛⲁⲕⲁⲗⲉⲓ	V	-
ⲁⲛⲁⲛⲉⲩⲉ	V	-
ⲁⲛⲁⲡⲁⲩⲥⲓⲥ	N	-
ⲁⲛⲁⲥⲧⲁⲥⲓⲥ	N	-
ⲁⲛⲁⲥⲧⲣⲉⲫⲩ	V	-
ⲁⲛⲁⲥⲧⲣⲟⲫⲏ	N	-
ⲁⲛⲁⲧⲟⲗⲏ	NPROP	-
ⲁⲛⲁⲧⲟⲗⲓⲟⲥ	NPROP	-
ⲁⲛⲁⲩ	VIMP	-
ⲁⲛⲁⲫⲟⲣⲁ	N	-
ⲁⲛⲁⲭⲟⲣⲉⲓ	V	-
ⲁⲛⲁⲭⲱⲣⲉⲓ	V	-
ⲁⲛⲁⲭⲱⲣⲏⲥⲓⲥ	N	-
ⲁⲛⲁⲭⲱⲣⲏⲧⲏⲥ	N	-
ⲁⲛⲁⲭⲱⲣⲓ	V	-
ⲁⲛⲁⲭⲱⲣⲓⲧⲏⲥ	N	-
ⲁⲛⲅ	PPERI	-
ⲁⲛⲇⲓⲕⲉⲓⲙⲉⲛⲟⲥ	N	-
ⲁⲛⲇⲓⲕⲓⲙⲉⲛⲟⲥ	N	-
ⲁⲛⲇⲣⲉⲁⲥ	NPROP	-
ⲁⲛⲉⲭⲉ	V	-
ⲁⲛⲍⲏⲃ	N	-
ⲁⲛⲍⲏⲃⲉ	N	-
ⲁⲛⲑⲓⲙⲟⲥ	NPROP	-
ⲁⲛⲓ	VIMP	-
ⲁⲛⲓⲭⲉ	V	-
ⲁⲛⲛⲱⲛⲁ	N	-
ⲁⲛⲟⲏⲧⲟⲥ	N	-
ⲁⲛⲟⲕ	PPERI	-
ⲁⲛⲟⲙⲓⲁ	N	-
ⲁⲛⲟⲙⲟⲛ	N	-
ⲁⲛⲟⲙⲟⲥ	N	-
ⲁⲛⲟⲛ	PPERI	-
ⲁⲛⲟⲭⲏ	N	-
ⲁⲛⲧⲓ	PREP	-
ⲁⲛⲧⲓϩⲣⲏⲥⲓⲥ	N	-
ⲁⲛⲧⲓⲅⲣⲁⲫⲟⲛ	N	-
ⲁⲛⲧⲓⲕⲉⲓⲙⲉⲛⲟⲥ	N	-
ⲁⲛⲧⲓⲕⲓⲙⲉⲛⲟⲥ	N	-
ⲁⲛⲧⲓⲗⲉⲅⲉ	V	-
ⲁⲛⲧⲓⲗⲟⲅⲓⲁ	N	-
ⲁⲛⲧⲓⲛⲟⲟⲩ	NPROP	-
ⲁⲛⲧⲓⲟⲭⲓⲁ	NPROP	-
ⲁⲛⲧⲓⲭⲣⲓⲥⲧⲟⲥ	N	-
ⲁⲛⲧⲱⲛⲓⲟⲥ	NPROP	-
ⲁⲝⲓⲟⲥⲁⲝⲓⲟⲥⲁⲝⲓⲟⲥ	N	-
ⲁⲝⲓⲟⲩ	V	-
ⲁⲝⲓⲱⲙⲁ	N	-
ⲁⲝⲓⲱⲙⲁⲧⲓⲕⲟⲥ	N	-
ⲁⲝⲟⲛ	N	-
ⲁⲟⲩⲏⲧ	N	-
ⲁⲡϩⲟⲩ	NPROP	-
ⲁⲡⲁ	N	-
ⲁⲡⲁⲅⲅⲉⲓⲗⲉ	V	-
ⲁⲡⲁⲑⲏⲥ	N	-
ⲁⲡⲁⲓⲧⲉⲓ	V	-
ⲁⲡⲁⲛⲧⲁ	V	-
ⲁⲡⲁⲛⲧⲏⲙⲁ	N	-
ⲁⲡⲁⲣⲭⲏ	N	-
ⲁⲡⲁⲧⲁ	V	-
ⲁⲡⲁⲧⲏ	N	-
ⲁⲡⲉ	N	-
ⲁⲡⲉⲓⲗⲏ	N	-
ⲁⲡⲏⲩⲉ	N	-
ⲁⲡⲓⲥⲧⲓⲁ	N	-
ⲁⲡⲓⲥⲧⲟⲛ	N	-
ⲁⲡⲓⲥⲧⲟⲥ	N	-
ⲁⲡⲟⲅⲣⲁⲫⲟⲛ	N	-
ⲁⲡⲟⲅⲣⲩⲫⲟⲛ	N	-
ⲁⲡⲟⲇⲉⲓⲝⲓⲥ	N	-
ⲁⲡⲟⲇⲉⲝⲓⲥ	N	-
ⲁⲡⲟⲇⲏⲅⲙⲁ	N	-
ⲁⲡⲟⲇⲏⲙⲉⲓ	V	-
ⲁⲡⲟⲕⲁⲑⲓⲥⲧⲁ	V	-
ⲁⲡⲟⲕⲟⲗⲗⲁ	V	-
ⲁⲡⲟⲕⲣⲁⲫⲟⲛ	N	-
ⲁⲡⲟⲕⲣⲓⲛⲉⲥⲑⲁⲓ	V	-
ⲁⲡⲟⲕⲣⲓⲥⲓⲥ	N	-
ⲁⲡⲟⲕⲣⲩⲫⲟⲛ	N	-
ⲁⲡⲟⲗⲁⲩⲉ	V	-
ⲁⲡⲟⲗⲁⲩⲥⲓⲥ	N	-
ⲁⲡⲟⲗⲗⲟⲛ	NPROP	-
ⲁⲡⲟⲗⲗⲱ	NPROP	-
ⲁⲡⲟⲗⲗⲱⲛ	NPROP	-
ⲁⲡⲟⲗⲟⲅⲓⲁ	N	-
ⲁⲡⲟⲗⲟⲅⲓⲍⲉ	V	-
ⲁⲡⲟⲙⲉⲣⲟⲩⲥ	ADV	-
ⲁⲡⲟⲥⲧⲏⲑⲓⲍⲉ	V	-
ⲁⲡⲟⲥⲧⲏⲑⲟⲩⲥ	ADV	-
ⲁⲡⲟⲥⲧⲟⲗⲓⲕⲏ	N	-
ⲁⲡⲟⲥⲧⲟⲗⲓⲕⲟⲛ	N	-
ⲁⲡⲟⲥⲧⲟⲗⲓⲕⲟⲥ	N	-
ⲁⲡⲟⲥⲧⲟⲗⲟⲥ	N	-
ⲁⲡⲟⲧ	N	-
ⲁⲡⲟⲧⲁⲥⲥⲉ	V	-
ⲁⲡⲟⲫⲁⲥⲓⲥ	N	-
ⲁⲡⲣⲁⲅⲓⲁ	N	-
ⲁⲡⲱⲗⲗⲟⲛ	NPROP	-
ⲁⲡⲱⲗⲗⲱ	NPROP	-
ⲁⲡⲱⲗⲗⲱⲛ	NPROP	-
ⲁⲣ	APST_PPERS	-
ⲁⲣϣⲓⲛ	N	-
ⲁⲣⲁ	CONJ	-
ⲁⲣⲁⲙ	NPROP	-
ⲁⲣⲅⲟⲛ	N	-
ⲁⲣⲉⲥⲕⲉ	V	-
ⲁⲣⲉⲧⲏ	N	-
ⲁⲣⲏⲃ	N	-
ⲁⲣⲏⲩ	CONJ	-
ⲁⲣⲓ	VIMP	-
ⲁⲣⲓⲁⲛⲟⲥ	N	-
ⲁⲣⲓⲑⲙⲟⲥ	N	-
ⲁⲣⲓⲕⲉ	N	-
ⲁⲣⲓⲟⲥ	NPROP	-
ⲁⲣⲓⲣⲉ	VIMP	-
ⲁⲣⲓⲥⲧⲁ	V	-
ⲁⲣⲓⲥⲧⲟⲇⲉⲗⲏⲥ	NPROP	-
ⲁⲣⲓⲥⲧⲟⲛ	N	-
ⲁⲣⲓⲥⲧⲟⲧⲉⲗⲏⲥ	NPROP	-
ⲁⲣⲓⲫⲟⲣⲟⲥ	NPROP	-
ⲁⲣⲕⲁⲇⲓⲟⲥ	NPROP	-
ⲁⲣⲛⲁ	V	-
ⲁⲣⲝ	N	-
ⲁⲣⲟϣ	N	-
ⲁⲣⲟⲟⲩⲉ	N	-
ⲁⲣⲥⲉⲛⲓⲟⲥ	NPROP	-
ⲁⲣⲥⲩⲛⲓⲟⲥ	NPROP	-
ⲁⲣⲭⲁⲅⲅⲉⲗⲟⲥ	N	-
ⲁⲣⲭⲁⲓⲟⲥ	N	-
ⲁⲣⲭⲉⲓ	V	-
ⲁⲣⲭⲉⲥⲑⲁⲓ	V	-
ⲁⲣⲭⲏ	N	-
ⲁⲣⲭⲏⲅⲟⲥ	N	-
ⲁⲣⲭⲏⲉⲡⲓⲥⲕⲟⲡⲟⲥ	N	-
ⲁⲣⲭⲏⲗⲁⲟⲥ	NPROP	-
ⲁⲣⲭⲏⲙⲁⲛⲇⲣⲓⲧⲏⲥ	N	-
ⲁⲣⲭⲏⲡⲣⲉⲥⲃⲩⲧⲉⲣⲟⲥ	N	-
ⲁⲣⲭⲓⲇⲁⲓⲙⲱⲛ	N	-
ⲁⲣⲭⲓⲇⲓⲁⲕⲟⲛⲟⲥ	N	-
ⲁⲣⲭⲓⲉⲡⲓⲥⲕⲟⲡⲟⲥ	N	-
ⲁⲣⲭⲓⲉⲣⲉⲩⲥ	N	-
ⲁⲣⲭⲓⲉⲣⲟⲥⲩⲛⲏ	N	-
ⲁⲣⲭⲓⲙⲁⲛⲇⲣⲓⲧⲏⲥ	N	-
ⲁⲣⲭⲓⲥⲑⲁⲓ	V	-
ⲁⲣⲭⲱⲛ	N	-
ⲁⲣⲱⲛ	NPROP	-
ⲁⲥ	N	-
ⲁⲥⲁⲫ	NPROP	-
ⲁⲥⲉⲃⲏⲥ	N	-
ⲁⲥⲉⲛⲛⲉⲑ	NPROP	-
ⲁⲥⲑⲉⲛⲏⲥ	N	-
ⲁⲥⲕⲉⲓ	V	-
ⲁⲥⲕⲏⲥⲓⲥ	N	-
ⲁⲥⲕⲏⲧⲏⲥ	N	-
ⲁⲥⲕⲏⲧⲓⲕⲟⲛ	N	-
ⲁⲥⲕⲩⲧⲏⲥ	N	-
ⲁⲥⲡⲁⲍⲉ	V	-
ⲁⲥⲡⲉ	N	-
ⲁⲥⲥⲩⲣⲓⲟⲥ	N	-
ⲁⲥⲧⲉⲓⲟⲥ	N	-
ⲁⲥⲧⲏⲣ	N	-
ⲁⲥⲧⲣⲟⲗⲟⲅⲟⲥ	N	-
ⲁⲥⲧⲣⲟⲛⲟⲙⲓⲁ	N	-
ⲁⲥⲩⲛⲑⲉⲧⲟⲥ	N	-
ⲁⲥⲫⲁⲗⲓⲍⲉ	V	-
ⲁⲥⲭⲏⲙⲟⲛⲉⲓ	V	-
ⲁⲥⲭⲏⲙⲟⲥⲩⲛⲏ	N	-
ⲁⲥⲱⲙⲁⲧⲟⲥ	N	-
ⲁⲥⲱⲟⲩ	VSTAT	-
ⲁⲧϣⲁϫⲉ	N	-
ⲁⲧϣⲁⲩ	N	-
ⲁⲧϣⲉⲡϩⲙⲟⲧ	N	-
ⲁⲧϣⲓⲡⲉ	N	-
ⲁⲧϣⲓⲧ	N	-
ⲁⲧϣⲡϩⲓⲥⲉ	N	-
ⲁⲧϣⲡϩⲙⲟⲧ	N	-
ⲁⲧϩⲉⲃⲥⲱ	N	-
ⲁⲧϩⲏⲧ	N	-
ⲁⲧϩⲟⲧⲉ	N	-
ⲁⲧϫⲓⲏⲡⲉ	N	-
ⲁⲧϫⲟ	N	-
ⲁⲧϭⲟⲙ	N	-
ⲁⲧϭⲱⲛⲧ	N	-
ⲁⲧϯϣⲓ	N	-
ⲁⲧⲁⲕⲧⲟⲥ	N	-
ⲁⲧⲁⲕⲧⲱⲥ	N	-
ⲁⲧⲁⲣⲏϫ	N	-
ⲁⲧⲃⲉⲥ	N	-
ⲁⲧⲃⲥ	N	-
ⲁⲧⲃⲱⲗⲉⲃⲟⲗ	N	-
ⲁⲧⲉⲓⲙⲉ	N	-
ⲁⲧⲏⲡⲉ	N	-
ⲁⲧⲕⲁⲣⲡⲟⲥ	N	-
ⲁⲧⲕⲓⲙ	N	-
ⲁⲧⲙⲟⲟⲩ	N	-
ⲁⲧⲙⲟⲩ	N	-
ⲁⲧⲛⲁ	N	-
ⲁⲧⲛⲁϩⲧⲉ	N	-
ⲁⲧⲛⲁⲩ	N	-
ⲁⲧⲛⲟⲃⲉ	N	-
ⲁⲧⲛⲟⲉⲓ	N	-
ⲁⲧⲛⲟⲩⲧⲉ	N	-
ⲁⲧⲟⲛⲉⲓ	V	-
ⲁⲧⲟⲡⲟⲛ	N	-
ⲁⲧⲟⲩⲉⲓⲛⲉ	N	-
ⲁⲧⲥⲃⲱ	N	-
ⲁⲧⲥⲟⲟⲩⲛ	N	-
ⲁⲧⲥⲱⲧⲙ	N	-
ⲁⲧⲧⲁϩⲟ	N	-
ⲁⲧⲧⲁⲕⲟ	N	-
ⲁⲧⲧⲁⲗϭⲟ	N	-
ⲁⲧⲧⲁⲩⲟ	N	-
ⲁⲧⲧⲛⲧⲱⲛ	N	-
ⲁⲧⲧⲱⲗⲙ	N	-
ⲁⲩⲁⲛ	N	-
ⲁⲩⲅⲟⲩⲥⲧⲁⲗⲓⲟⲥ	N	-
ⲁⲩⲅⲟⲩⲥⲧⲟⲥ	N	-
ⲁⲩⲉⲓⲥ	PTC	-
ⲁⲩⲏⲧ	N	-
ⲁⲩⲕⲟⲩⲥⲧⲟⲥ	V	-
ⲁⲩⲗⲏ	N	-
ⲁⲩⲗⲏⲣⲓⲁⲛⲟⲥ	NPROP	-
ⲁⲩⲝⲁⲛⲉ	V	-
ⲁⲩⲧⲟⲅⲉⲛⲏⲥ	N	-
ⲁⲩⲧⲱⲕⲣⲁⲧⲱⲣ	N	-
ⲁⲩⲱ	CONJ	-
ⲁⲫⲉⲗⲗⲏⲥ	N	-
ⲁⲫⲟⲣⲙⲏ	N	-
ⲁⲫⲟⲩ	NPROP	-
ⲁⲫⲩⲗⲗⲏⲥ	N	-
ⲁⲭⲁⲁⲃ	NPROP	-
ⲁⲭⲁⲃ	NPROP	-
ⲁⲭⲉⲓⲙ	NPROP	-
ⲁⲭⲉⲣⲟⲩⲥⲓⲁ	NPROP	-
ⲁⲭⲓⲗⲗⲁⲥ	NPROP	-
ⲁⲭⲓⲧⲱⲃⲉⲗ	NPROP	-
ⲃⲁϣⲟⲣ	N	-
ⲃⲁϣⲟⲩⲣ	N	-
ⲃⲁϩⲁⲗ	NPROP	-
ⲃⲁⲁⲙⲡⲉ	N	-
ⲃⲁⲃⲉⲣⲱⲙⲉ	N	-
ⲃⲁⲃⲩⲗⲱⲛ	NPROP	-
ⲃⲁⲃⲱⲱ	V	-
ⲃⲁⲓϣⲓⲛⲉ	N	-
ⲃⲁⲕⲧⲏⲣⲓⲁ	N	-
ⲃⲁⲗ	N	-
ⲃⲁⲗϩⲏⲧ	N	-
ⲃⲁⲗⲟⲧ	N	-
ⲃⲁⲙⲡⲉ	N	-
ⲃⲁⲛⲓⲡⲉ	N	-
ⲃⲁⲡϯⲥⲙⲁ	N	-
ⲃⲁⲡϯⲥⲧⲏⲣⲓⲟⲛ	N	-
ⲃⲁⲡⲧⲏⲥⲧⲏⲥ	N	-
ⲃⲁⲡⲧⲓⲍⲉ	V	-
ⲃⲁⲡⲧⲓⲍⲉⲛ	V	-
ⲃⲁⲡⲧⲓⲥⲙⲁ	N	-
ⲃⲁⲡⲧⲓⲥⲧⲏⲣⲓⲟⲛ	N	-
ⲃⲁⲡⲧⲓⲥⲧⲏⲥ	N	-
ⲃⲁⲣⲃⲁⲣⲟⲥ	N	-
ⲃⲁⲣⲃⲁⲣⲟⲩⲥ	N	-
ⲃⲁⲣⲕⲁⲃⲁⲛ	NPROP	-
ⲃⲁⲣⲕⲱⲃ	NPROP	-
ⲃⲁⲣⲱⲧ	N	-
ⲃⲁⲥⲁⲛⲟⲥ	N	-
ⲃⲁⲥⲓⲗⲉⲓⲟⲥ	NPROP	-
ⲃⲁⲥⲓⲗⲓⲟⲥ	NPROP	-
ⲃⲁⲥⲓⲗⲓⲥⲕⲟⲥ	NPROP	-
ⲃⲁⲥⲓⲗⲓⲧⲏⲥ	NPROP	-
ⲃⲁⲥⲓⲥ	N	-
ⲃⲉⲃⲉ	V	-
ⲃⲉⲍⲁⲛⲧⲓⲟⲛ	NPROP	-
ⲃⲉⲕⲉ	N	-
ⲃⲉⲕⲏ	N	-
ⲃⲉⲗ	V	-
ⲃⲉⲗϫⲉ	N	-
ⲃⲉⲗⲃⲓⲗⲉ	N	-
ⲃⲉⲛⲓⲡⲉ	N	-
ⲃⲉⲣⲉⲇⲁⲣⲓⲟⲥ	N	-
ⲃⲉⲣⲉⲧⲱⲥ	ADV	-
ⲃⲉⲥⲁⲛⲧⲓⲟⲛ	NPROP	-
ⲃⲉⲧ	V	-
ⲃⲏϭ	NPROP	-
ⲃⲏⲕ	VSTAT	-
ⲃⲏⲗ	VSTAT	-
ⲃⲏⲙⲁ	N	-
ⲃⲏⲧ	VSTAT	-
ⲃⲓⲕⲧⲱⲣ	NPROP	-
ⲃⲓⲕⲧⲱⲣⲓⲁ	N	-
ⲃⲓⲟⲥ	N	-
ⲃⲓⲣ	N	-
ⲃⲓⲱⲧⲓⲕⲟⲥ	N	-
ⲃⲗϫⲉ	N	-
ⲃⲗⲁⲡⲧⲉⲓ	V	-
ⲃⲗⲁⲥⲫⲏⲙⲓⲁ	N	-
ⲃⲗⲃⲓⲗⲉ	N	-
ⲃⲗⲗⲉ	N	-
ⲃⲟϣ	V	-
ⲃⲟϭ	V	-
ⲃⲟⲉⲥ	NPROP	-
ⲃⲟⲏⲑⲉⲓ	V	-
ⲃⲟⲏⲑⲉⲓⲁ	N	-
ⲃⲟⲏⲑⲟⲥ	N	-
ⲃⲟⲗ	N	-
ⲃⲟⲗ	V	-
ⲃⲟⲛⲧⲉ	N	-
ⲃⲟⲟⲣ	V	-
ⲃⲟⲧ	V	-
ⲃⲟⲧⲉ	N	-
ⲃⲟⲩⲗⲉⲩⲧⲏⲣⲓⲟⲛ	N	-
ⲃⲟⲩⲗⲉⲩⲧⲏⲥ	N	-
ⲃⲟⲩⲛⲟⲥ	N	-
ⲃⲣⲃⲣ	V	-
ⲃⲣⲣⲉ	N	-
ⲃⲩⲍⲁⲛⲧⲓⲟⲛ	NPROP	-
ⲃⲩⲥⲁⲛⲧⲓⲟⲛ	NPROP	-
ⲃⲱϣ	V	-
ⲃⲱⲓⲑⲓⲁ	N	-
ⲃⲱⲕ	V	-
ⲃⲱⲗ	V	-
ⲃⲱⲛⲉⲗⲟⲟⲗⲉ	N	-
ⲃⲱⲛⲕⲛⲧⲉ	N	-
ⲃⲱⲱⲣⲉ	V	-
ⲅ	PPERS	-
ⲅⲁⲃⲣⲓⲏⲗ	NPROP	-
ⲅⲁⲅⲅⲣⲁⲓⲛⲁ	N	-
ⲅⲁⲍⲟⲫⲩⲗⲁⲅⲓⲟⲛ	N	-
ⲅⲁⲍⲟⲫⲩⲗⲁⲕⲓⲟⲛ	N	-
ⲅⲁⲓⲟⲥ	NPROP	-
ⲅⲁⲗⲁⲧⲓⲁ	NPROP	-
ⲅⲁⲗⲉⲓⲗⲁⲓⲁ	NPROP	-
ⲅⲁⲗⲉⲓⲗⲁⲓⲟⲥ	N	-
ⲅⲁⲗⲓⲗⲁⲓⲁ	NPROP	-
ⲅⲁⲗⲓⲗⲁⲓⲟⲥ	N	-
ⲅⲁⲙⲟⲥ	N	-
ⲅⲁⲛⲟⲛ	N	-
ⲅⲁⲣ	PTC	-
ⲅⲉϩⲉⲛⲛⲁ	N	-
ⲅⲉⲇⲉⲱⲛ	NPROP	-
ⲅⲉⲛⲉⲁ	N	-
ⲅⲉⲛⲉⲥⲓⲥ	N	-
ⲅⲉⲛⲏⲙⲁ	N	-
ⲅⲉⲛⲓⲁ	N	-
ⲅⲉⲛⲛⲁⲓⲟⲥ	N	-
ⲅⲉⲛⲛⲏⲧⲟⲥ	N	-
ⲅⲉⲛⲟⲥ	N	-
ⲅⲉⲟⲙⲏⲉⲧⲣⲓⲁ	N	-
ⲅⲉⲟⲙⲏⲧⲣⲓⲁ	N	-
ⲅⲉⲱⲙⲏⲧⲣⲓⲁ	N	-
ⲅⲉⲱⲣⲅⲓⲟⲥ	NPROP	-
ⲅⲓⲅⲁⲥ	N	-
ⲅⲗⲱⲥⲥⲟⲕⲟⲙⲟⲛ	N	-
ⲅⲛⲱⲙⲏ	N	-
ⲅⲛⲱⲥⲧⲓⲕⲟⲥ	N	-
ⲅⲟⲙⲟⲣⲣⲁ	NPROP	-
ⲅⲣⲁⲙⲙⲁϯⲕⲟⲥ	N	-
ⲅⲣⲁⲙⲙⲁⲧⲉⲩⲥ	N	-
ⲅⲣⲁⲙⲙⲁⲧⲓⲕⲟⲥ	N	-
ⲅⲣⲁⲫⲏ	N	-
ⲅⲣⲏⲅⲟⲣⲓⲟⲥ	NPROP	-
ⲅⲣⲏⲅⲟⲣⲟⲥ	N	-
ⲅⲩⲙⲛⲁⲍⲉ	V	-
ⲅⲩⲙⲛⲁⲥⲓⲁ	N	-
ⲇⲁⲑⲁⲛ	NPROP	-
ⲇⲁⲓⲙⲟⲛⲓⲟⲛ	N	-
ⲇⲁⲓⲙⲱⲛ	N	-
ⲇⲁⲓⲙⲱⲛⲓⲟⲛ	N	-
ⲇⲁⲙⲁⲥⲕⲟⲥ	NPROP	-
ⲇⲁⲛⲓⲏⲗ	NPROP	-
ⲇⲁⲩⲉⲓⲇ	NPROP	-
ⲇⲁⲩⲓⲇ	NPROP	-
ⲇⲉ	PTC	-
ⲇⲉⲓⲡⲛⲉⲩⲉ	V	-
ⲇⲉⲓⲡⲛⲟⲛ	N	-
ⲇⲉⲕⲁⲛⲟⲥ	N	-
ⲇⲉⲕⲓⲟⲥ	NPROP	-
ⲇⲉⲩⲧⲉⲣⲟⲛⲟⲙⲓⲟⲛ	N	-
ⲇⲏⲗⲟⲩ	V	-
ⲇⲏⲙⲁⲅⲱⲅⲟⲥ	N	-
ⲇⲏⲙⲁⲥ	NPROP	-
ⲇⲏⲙⲏⲅⲟⲣⲉⲓ	V	-
ⲇⲏⲙⲏⲧⲣⲓⲟⲥ	NPROP	-
ⲇⲏⲙⲓⲟⲩⲣⲅⲓⲁ	N	-
ⲇⲏⲙⲓⲟⲩⲣⲅⲟⲥ	N	-
ⲇⲏⲙⲟⲥ	N	-
ⲇⲏⲙⲟⲥⲓⲁ	N	-
ⲇⲏⲙⲟⲥⲓⲟⲛ	N	-
ⲇⲏⲙⲟⲧⲓⲥⲧⲏⲥ	N	-
ⲇⲓⲁⲃⲟⲗⲟⲥ	NPROP	-
ⲇⲓⲁⲇⲉⲭⲉ	V	-
ⲇⲓⲁⲇⲟⲭⲟⲥ	N	-
ⲇⲓⲁⲑⲏⲕⲏ	N	-
ⲇⲓⲁⲑⲩⲕⲏ	N	-
ⲇⲓⲁⲕⲟⲛⲉⲓ	V	-
ⲇⲓⲁⲕⲟⲛⲓ	V	-
ⲇⲓⲁⲕⲟⲛⲓⲁ	N	-
ⲇⲓⲁⲕⲟⲛⲟⲥ	N	-
ⲇⲓⲁⲕⲣⲏⲥⲓⲥ	N	-
ⲇⲓⲁⲕⲣⲓⲛⲉ	V	-
ⲇⲓⲁⲕⲣⲓⲥⲓⲥ	N	-
ⲇⲓⲁⲕⲣⲓⲧⲓⲕⲟⲥ	N	-
ⲇⲓⲁⲕⲱⲛ	N	-
ⲇⲓⲁⲗⲉⲅⲉ	V	-
ⲇⲓⲁⲗⲟⲅⲟⲥ	N	-
ⲇⲓⲁⲡⲉⲣⲁ	V	-
ⲇⲓⲁⲥⲧⲏⲙⲁ	N	-
ⲇⲓⲁⲧⲟⲩⲧⲟ	CONJ	-
ⲇⲓⲁⲧⲟⲭⲟⲥ	N	-
ⲇⲓⲁⲫⲟⲣⲁ	N	-
ⲇⲓⲁⲯⲁⲗⲙⲁ	N	-
ⲇⲓⲇⲁⲥⲕⲁⲗⲓⲁ	N	-
ⲇⲓⲇⲁⲥⲕⲉ	V	-
ⲇⲓⲇⲁⲥⲕⲉⲓ	V	-
ⲇⲓⲏⲅⲏⲙⲁ	N	-
ⲇⲓⲏⲅⲏⲥⲓⲥ	N	-
ⲇⲓⲏⲕⲏⲥⲓⲥ	N	-
ⲇⲓⲕⲁⲓⲟⲛ	N	-
ⲇⲓⲕⲁⲓⲟⲥ	N	-
ⲇⲓⲕⲁⲓⲟⲥⲩⲛⲏ	N	-
ⲇⲓⲕⲁⲓⲱⲥ	ADV	-
ⲇⲓⲕⲁⲥⲧⲏⲣⲓⲟⲛ	N	-
ⲇⲓⲕⲁⲥⲧⲏⲥ	N	-
ⲇⲓⲕⲏ	N	-
ⲇⲓⲙⲏⲧⲣⲓⲟⲥ	NPROP	-
ⲇⲓⲙⲟⲑⲉⲟⲥ	NPROP	-
ⲇⲓⲙⲟⲧⲓⲥⲧⲏⲥ	N	-
ⲇⲓⲟⲅⲙⲟⲥ	N	-
ⲇⲓⲟⲓⲕⲉⲓ	V	-
ⲇⲓⲟⲓⲕⲏⲥⲓⲥ	N	-
ⲇⲓⲟⲕⲗⲏⲧⲓⲁⲛⲟⲥ	NPROP	-
ⲇⲓⲟⲛⲏⲥⲓⲟⲥ	NPROP	-
ⲇⲓⲟⲛⲩⲥⲓⲟⲥ	NPROP	-
ⲇⲓⲟⲣⲑⲟⲩ	V	-
ⲇⲓⲟⲥⲕⲟⲣⲟⲥ	NPROP	-
ⲇⲓⲡⲗⲟⲩⲛ	N	-
ⲇⲓⲡⲛⲉⲩⲉ	V	-
ⲇⲓⲱⲅⲙⲟⲥ	N	-
ⲇⲓⲱⲕⲉ	V	-
ⲇⲓⲱⲕⲉⲓ	V	-
ⲇⲓⲱⲕⲧⲏⲥ	N	-
ⲇⲟⲅⲙⲁ	N	-
ⲇⲟⲅⲙⲁⲧⲓⲍⲉ	V	-
ⲇⲟⲕⲉⲓ	V	-
ⲇⲟⲕⲓⲙⲁⲍⲉ	V	-
ⲇⲟⲕⲓⲙⲁⲥⲧⲏⲥ	N	-
ⲇⲟⲙⲛⲟⲥ	NPROP	-
ⲇⲟⲩⲝ	N	-
ⲇⲣⲁⲕⲱⲛ	N	-
ⲇⲣⲟⲙⲟⲥ	N	-
ⲇⲩⲙⲓⲟⲩⲣⲅⲟⲥ	N	-
ⲇⲩⲙⲟⲥ	N	-
ⲇⲩⲛⲁⲙⲓⲥ	N	-
ⲇⲩⲛⲁⲧⲟⲥ	N	-
ⲇⲩⲣⲁⲛⲛⲟⲥ	N	-
ⲇⲩⲣⲁⲛⲟⲥ	NPROP	-
ⲇⲱⲣⲉⲁ	N	-
ⲇⲱⲣⲟⲑⲉⲟⲥ	NPROP	-
ⲇⲱⲣⲟⲛ	N	-
ⲉ	CCIRC	-
ⲉ	CFOC	-
ⲉ	CREL	-
ⲉ	PPERO	-
ⲉ	PREP	-
ⲉ[.....]	UNKNOWN	-
ⲉϣ	V	-
ⲉϣϣⲉ	V	-
ⲉϣϫⲉ	CONJ	-
ⲉϣⲁⲩ	N	-
ⲉϣⲗⲟⲩⲗⲁⲓ	V	-
ⲉϣⲧ	V	-
ⲉϣⲱ	N	-
ⲉϣⲱⲡⲉ	CONJ	-
ⲉϥϣⲁⲛ	ACOND_PPERS	-
ⲉϥⲉ	AOPT_PPERS	-
ⲉϥⲧ	V	-
ⲉϩⲉ	N	-
ⲉϩⲛⲁ	VBD	-
ⲉϩⲛⲉ	VBD	-
ⲉϩⲟⲩⲉ	ADV	-
ⲉϩⲟⲩⲛ	ADV	-
ⲉϩⲣⲁ	PREP	-
ⲉϩⲣⲁⲓ	ADV	-
ⲉϩⲣⲁⲓⲉ	PREP	-
ⲉϩⲣⲁⲓⲉϫⲙ	PREP	-
ⲉϩⲣⲁⲓⲉϫⲛ	PREP	-
ⲉϩⲣⲁⲓⲉϫⲱ	PREP	-
ⲉϩⲧⲱⲱⲣ	N	-
ⲉϫ	V	-
ⲉϫⲏⲩ	N	-
ⲉϫⲙ	PREP	-
ⲉϫⲛ	PREP	-
ⲉϫⲛϩⲉ	PREP	-
ⲉϫⲛⲧⲉ	PREP	-
ⲉϫⲱ	PREP	-
ⲉϫⲱ	PREP_PPERO	-
ⲉϭⲟⲟϣ	NPROP	-
ⲉϭⲱϣ	N	-
ⲉϭⲱⲱϣ	N	-
ⲉⲃ[........]	UNKNOWN	-
ⲉⲃⲓⲏⲛ	N	-
ⲉⲃⲓⲱ	N	-
ⲉⲃⲟⲗ	ADV	-
ⲉⲃⲟⲧ	N	-
ⲉⲃⲣⲁ	N	-
ⲉⲃⲣⲏϭⲉ	N	-
ⲉⲅⲅⲟⲙⲓⲁⲍⲉ	V	-
ⲉⲅⲅⲱⲙⲓⲁⲍⲉ	V	-
ⲉⲅⲕⲁⲕⲉⲓ	V	-
ⲉⲅⲕⲁⲕⲓ	V	-
ⲉⲅⲕⲟⲙⲓⲁⲍⲉ	V	-
ⲉⲅⲕⲣⲁⲧⲉⲩⲉ	V	-
ⲉⲅⲕⲣⲁⲧⲏⲥ	N	-
ⲉⲅⲕⲱⲙⲓⲁⲍⲉ	V	-
ⲉⲅⲕⲱⲙⲓⲟⲛ	N	-
ⲉⲍⲉⲅⲓⲏⲗ	NPROP	-
ⲉⲍⲉⲕⲉⲓⲁⲥ	NPROP	-
ⲉⲍⲉⲕⲓⲁⲥ	NPROP	-
ⲉⲍⲉⲕⲓⲏⲗ	NPROP	-
ⲉⲑⲏ	ADV	-
ⲉⲓ	V	-
ⲉⲓϣⲁⲛ	ACOND_PPERS	-
ⲉⲓϣⲉ	V	-
ⲉⲓϥⲧ	N	-
ⲉⲓⲁ	N	-
ⲉⲓⲁⲃⲉ	N	-
ⲉⲓⲁⲗ	N	-
ⲉⲓⲁⲧⲟⲟⲧ	V	-
ⲉⲓⲃⲉ	V	-
ⲉⲓⲇⲟⲥ	N	-
ⲉⲓⲇⲱⲗⲟⲛ	N	-
ⲉⲓⲉ	AOPT_PPERS	-
ⲉⲓⲉ	PTC	-
ⲉⲓⲉϩⲣⲁⲓ	V	-
ⲉⲓⲉⲃⲧ	N	-
ⲉⲓⲉⲓⲃ	N	-
ⲉⲓⲉⲡⲛⲟⲩⲃ	N	-
ⲉⲓⲉⲡⲥⲁ	N	-
ⲉⲓⲉⲣⲉⲛⲛⲁⲓⲟⲥ	NPROP	-
ⲉⲓⲉⲣⲟ	N	-
ⲉⲓⲙⲉ	V	-
ⲉⲓⲙⲏⲧⲉⲓ	CONJ	-
ⲉⲓⲙⲏⲧⲓ	CONJ	-
ⲉⲓⲛⲉ	V	-
ⲉⲓⲟⲙ	N	-
ⲉⲓⲟⲟⲣ	N	-
ⲉⲓⲟⲟⲧⲉ	N	-
ⲉⲓⲟⲡⲉ	N	-
ⲉⲓⲟⲧⲉ	N	-
ⲉⲓⲟⲩⲗ	N	-
ⲉⲓⲣⲉ	V	-
ⲉⲓⲣⲏⲛⲏ	N	-
ⲉⲓⲣⲏⲛⲏⲕⲟⲛ	N	-
ⲉⲓⲣⲏⲛⲓⲕⲟⲛ	N	-
ⲉⲓⲣⲣⲱⲟⲩ	N	-
ⲉⲓⲥ	PTC	-
ⲉⲓⲥϩⲏⲏⲧⲉ	PTC	-
ⲉⲓⲥⲧⲟⲛⲥⲧⲁⲩⲣⲟⲛ	NPROP	-
ⲉⲓⲧⲁ	CONJ	-
ⲉⲓⲧⲉ	CONJ	-
ⲉⲓⲧⲛ	N	-
ⲉⲓⲱ	N	-
ⲉⲓⲱϩⲉ	N	-
ⲉⲓⲱⲣϩ	V	-
ⲉⲓⲱⲣⲉ	N	-
ⲉⲓⲱⲣⲙ	V	-
ⲉⲓⲱⲧ	N	-
ⲉⲓⲱⲧⲉ	N	-
ⲉⲕϣⲁⲛ	ACOND_PPERS	-
ⲉⲕⲓⲃⲉ	N	-
ⲉⲕⲕⲗⲏⲥⲓⲁ	N	-
ⲉⲕⲕⲗⲏⲥⲓⲁⲥⲧⲓⲕⲟⲛ	N	-
ⲉⲕⲕⲗⲩⲥⲓⲁ	N	-
ⲉⲕⲗⲟⲅⲓⲥⲧⲓⲁ	N	-
ⲉⲕⲥⲧⲁⲥⲓⲥ	N	-
ⲉⲗϩⲏⲙ	V	-
ⲉⲗϩⲱⲃ	V	-
ⲉⲗⲁⲣⲓⲭⲟⲥ	NPROP	-
ⲉⲗⲁⲭⲉⲓⲥⲧⲟⲛ	N	-
ⲉⲗⲁⲭⲓⲥⲧⲟⲛ	N	-
ⲉⲗⲁⲭⲓⲥⲧⲟⲥ	N	-
ⲉⲗⲉⲁⲍⲁⲣ	NPROP	-
ⲉⲗⲉⲅⲭⲉ	V	-
ⲉⲗⲉⲥⲁⲓⲟⲥ	NPROP	-
ⲉⲗⲏⲩ	VSTAT	-
ⲉⲗⲓⲁⲃ	NPROP	-
ⲉⲗⲓⲁⲕⲓⲙ	NPROP	-
ⲉⲗⲓⲟⲩⲇ	NPROP	-
ⲉⲗⲓⲥⲁⲓⲟⲥ	NPROP	-
ⲉⲗⲓⲥⲥⲁⲓⲟⲥ	NPROP	-
ⲉⲗⲕⲥϣⲁ	N	-
ⲉⲗⲗⲏⲃ	N	-
ⲉⲗⲗⲟⲅⲓⲙⲟⲥ	N	-
ⲉⲗⲟⲟⲗⲉ	N	-
ⲉⲗⲩⲥⲁⲓⲟⲥ	NPROP	-
ⲉⲙ	V	-
ⲉⲙϩⲓⲧ	N	-
ⲉⲙⲁϣⲟ	ADV	-
ⲉⲙⲁⲧⲉ	ADV	-
ⲉⲙⲁⲩ	ADV	-
ⲉⲙⲉⲛⲧ	N	-
ⲉⲙⲏϣ	N	-
ⲉⲙⲙⲁⲛⲟⲩⲏⲗ	V	-
ⲉⲙⲛⲧ	N	-
ⲉⲙⲡϣⲁ	V	-
ⲉⲙⲡⲟⲣⲟⲥ	N	-
ⲉⲙⲧⲟⲛ	V	-
ⲉⲛϣⲁⲛ	ACOND_PPERS	-
ⲉⲛⲅⲟⲙⲓⲁⲍⲉ	V	-
ⲉⲛⲅⲱⲙⲓⲁⲍⲉ	V	-
ⲉⲛⲉ	CONJ	-
ⲉⲛⲉϩ	ADV	-
ⲉⲛⲉϩ	N	-
ⲉⲛⲉⲣⲅⲉⲓ	V	-
ⲉⲛⲉⲣⲅⲉⲓⲁ	N	-
ⲉⲛⲉⲣⲅⲓⲁ	N	-
ⲉⲛⲕⲟⲙⲓⲁⲍⲉ	V	-
ⲉⲛⲕⲟⲧⲕ	V	-
ⲉⲛⲕⲣⲁⲧⲱⲣ	NPROP	-
ⲉⲛⲕⲱⲙⲓⲁⲍⲉ	V	-
ⲉⲛⲟⲭⲗⲉⲓ	V	-
ⲉⲛⲟⲭⲟⲥ	N	-
ⲉⲛⲧ	CREL	-
ⲉⲛⲧⲉⲣ	ATEMP	-
ⲉⲛⲧⲏϭ	N	-
ⲉⲛⲧⲟⲗⲏ	N	-
ⲉⲛⲱⲭ	NPROP	-
ⲉⲛⲱⲭⲗⲉⲓ	V	-
ⲉⲝⲁⲡⲁⲧⲁ	V	-
ⲉⲝⲉⲅⲏⲥⲓⲥ	N	-
ⲉⲝⲉⲥⲧⲁⲓ	V	-
ⲉⲝⲉⲥⲧⲉⲓ	V	-
ⲉⲝⲉⲥⲧⲓ	V	-
ⲉⲝⲉⲧⲁⲍⲉ	V	-
ⲉⲝⲉⲫⲣⲁⲥⲉ	V	-
ⲉⲝⲏⲅⲉⲓ	V	-
ⲉⲝⲏⲅⲉⲓⲥⲑⲁⲓ	V	-
ⲉⲝⲏⲅⲏⲥⲓⲥ	N	-
ⲉⲝⲏⲅⲓⲥⲓⲥ	N	-
ⲉⲝⲟⲇⲟⲥ	N	-
ⲉⲝⲟⲙⲟⲗⲟⲅⲉⲓ	V	-
ⲉⲝⲟⲙⲟⲗⲟⲅⲓ	V	-
ⲉⲝⲟⲙⲟⲗⲱⲅⲉⲓ	V	-
ⲉⲝⲟⲙⲱⲗⲟⲅⲉⲓ	V	-
ⲉⲝⲟⲙⲱⲗⲱⲅⲉⲓ	V	-
ⲉⲝⲟⲣⲏⲥⲧⲓⲁ	N	-
ⲉⲝⲟⲣⲓⲍⲉ	V	-
ⲉⲝⲟⲣⲓⲥⲧⲓⲁ	N	-
ⲉⲝⲟⲩⲥⲓⲁ	N	-
ⲉⲝⲱⲙⲟⲗⲟⲅⲉⲓ	V	-
ⲉⲝⲱⲙⲟⲗⲱⲅⲉⲓ	V	-
ⲉⲝⲱⲙⲱⲗⲟⲅⲉⲓ	V	-
ⲉⲝⲱⲙⲱⲗⲱⲅⲉⲓ	V	-
ⲉⲝⲱⲣⲏⲥⲧⲓⲁ	N	-
ⲉⲝⲱⲣⲓⲥⲧⲓⲁ	N	-
ⲉⲟⲟⲩ	N	-
ⲉⲡ	V	-
ⲉⲡϩⲁⲉ	ADV	-
ⲉⲡϫⲓⲛϫⲏ	ADV	-
ⲉⲡⲁϩⲟⲩ	ADV	-
ⲉⲡⲁⲓⲛⲟⲩ	V	-
ⲉⲡⲁⲣⲭⲓⲁ	N	-
ⲉⲡⲁⲣⲭⲟⲥ	N	-
ⲉⲡⲉϩⲟⲩⲟ	ADV	-
ⲉⲡⲉⲑⲩⲙⲉⲓ	V	-
ⲉⲡⲉⲓ	CONJ	-
ⲉⲡⲉⲓⲇⲏ	CONJ	-
ⲉⲡⲉⲓⲑⲩⲙⲓⲁ	N	-
ⲉⲡⲉⲓⲕⲁⲗⲉⲓ	V	-
ⲉⲡⲉⲓⲥⲁⲙⲛⲡⲁⲓ	ADV	-
ⲉⲡⲉⲓⲥⲧⲏⲙⲉⲓ	V	-
ⲉⲡⲉⲥⲏⲧ	ADV	-
ⲉⲡⲏⲑⲩⲙⲓⲁ	N	-
ⲉⲡⲏⲡ	NPROP	-
ⲉⲡⲏⲧⲏⲙⲓⲁ	N	-
ⲉⲡⲓⲃⲟⲗⲏ	N	-
ⲉⲡⲓⲃⲟⲩⲗⲉⲩⲉ	V	-
ⲉⲡⲓⲇⲏ	CONJ	-
ⲉⲡⲓⲑⲩⲙⲉⲓ	V	-
ⲉⲡⲓⲑⲩⲙⲓⲁ	N	-
ⲉⲡⲓⲕⲁⲗⲉⲓ	V	-
ⲉⲡⲓⲕⲁⲗⲓ	V	-
ⲉⲡⲓⲡ	NPROP	-
ⲉⲡⲓⲥⲕⲟⲡⲏ	N	-
ⲉⲡⲓⲥⲕⲟⲡⲓⲟⲛ	N	-
ⲉⲡⲓⲥⲕⲟⲡⲟⲥ	N	-
ⲉⲡⲓⲥⲧⲏⲙⲉⲓ	V	-
ⲉⲡⲓⲥⲧⲏⲙⲏ	N	-
ⲉⲡⲓⲥⲧⲟⲗⲏ	N	-
ⲉⲡⲓⲧⲁⲥⲥⲉ	V	-
ⲉⲡⲓⲧⲓⲙⲁ	V	-
ⲉⲡⲓⲧⲓⲙⲓⲁ	N	-
ⲉⲡⲓⲧⲣⲟⲡⲟⲥ	N	-
ⲉⲡⲓⲭⲉⲓⲣⲉⲓ	V	-
ⲉⲡⲙⲁⲙ	PREP	-
ⲉⲡⲙⲁⲛ	PREP	-
ⲉⲡⲣⲁ	N	-
ⲉⲡⲧⲏⲣϥ	ADV	-
ⲉⲣ	CCIRC_PPERS	-
ⲉⲣ	CFOC_PPERS	-
ⲉⲣ	V	-
ⲉⲣϣⲁⲛ	ACOND	-
ⲉⲣϣⲁⲛ	ACOND_PPERS	-
ⲉⲣϣⲙⲙⲟ	V	-
ⲉⲣϣⲡⲏⲣⲉ	V	-
ⲉⲣϥⲛⲧ	V	-
ⲉⲣϩⲛⲁ	V	-
ⲉⲣϩⲟⲧⲉ	V	-
ⲉⲣⲁ	PREP	-
ⲉⲣⲁⲛⲁ	V	-
ⲉⲣⲁⲛⲁⲓ	V	-
ⲉⲣⲁⲧ	PREP	-
ⲉⲣⲁⲧⲟⲩ	PREP	-
ⲉⲣⲃ	V	-
ⲉⲣⲅⲁⲥⲓⲁ	N	-
ⲉⲣⲅⲁⲧⲏⲥ	N	-
ⲉⲣⲉ	AOPT	-
ⲉⲣⲉ	CCIRC	-
ⲉⲣⲉ	CCIRC_PPERS	-
ⲉⲣⲏⲙⲟⲥ	N	-
ⲉⲣⲏⲧ	V	-
ⲉⲣⲙ	PREP	-
ⲉⲣⲙⲛⲧⲣⲉ	V	-
ⲉⲣⲛ	PREP	-
ⲉⲣⲛⲟⲃⲉ	V	-
ⲉⲣⲟ	PREP	-
ⲉⲣⲟ	PREP_PPERO	-
ⲉⲣⲡⲃⲟⲗ	V	-
ⲉⲣⲣⲱⲟⲩ	N	-
ⲉⲣⲩⲑⲣⲁ	N	-
ⲉⲣⲱ	PREP	-
ⲉⲣⲱⲟⲩ	N	-
ⲉⲣⲱⲧⲉ	N	-
ⲉⲥϣⲁⲛ	ACOND_PPERS	-
ⲉⲥⲉ	AOPT_PPERS	-
ⲉⲥⲓⲇⲟⲣⲟⲥ	NPROP	-
ⲉⲥⲟⲟⲩ	N	-
ⲉⲥⲣⲱⲙ	NPROP	-
ⲉⲥⲩⲭⲓⲁ	N	-
ⲉⲧ	CREL	-
ⲉⲧⲃⲉ	PREP	-
ⲉⲧⲃⲉⲡⲁⲓ	CONJ	-
ⲉⲧⲃⲏⲏ	PREP	-
ⲉⲧⲃⲏⲏⲧ	PREP	-
ⲉⲧⲉ	CREL	-
ⲉⲧⲉϩⲛⲁ	N	-
ⲉⲧⲉⲛⲁⲓⲛⲉ	CONJ	-
ⲉⲧⲉⲡⲁⲓⲡⲉ	CONJ	-
ⲉⲧⲉⲣⲉ	CREL	-
ⲉⲧⲉⲣⲉ	CREL_PPERS	-
ⲉⲧⲉⲧⲁⲓⲧⲉ	ADV	-
ⲉⲧⲉⲧⲁⲓⲧⲉ	CONJ	-
ⲉⲧⲓ	ADV	-
ⲉⲧⲓⲟⲥ	N	-
ⲉⲧⲙⲏⲧⲉⲛ	PREP	-
ⲉⲧⲟⲟⲧ	PREP	-
ⲉⲧⲡⲱ	N	-
ⲉⲩϣⲁⲛ	ACOND_PPERS	-
ⲉⲩⲁⲅⲅⲉⲗⲓⲟⲛ	N	-
ⲉⲩⲁⲅⲅⲉⲗⲓⲥⲧⲏⲥ	N	-
ⲉⲩⲁⲅⲣⲓⲟⲥ	NPROP	-
ⲉⲩⲅⲉⲛⲏⲥ	N	-
ⲉⲩⲉ	AOPT_PPERS	-
ⲉⲩⲉⲣⲅⲉⲧⲉⲓ	V	-
ⲉⲩⲕⲧⲏⲣⲓⲟⲛ	N	-
ⲉⲩⲗⲁⲃⲉⲓⲁ	N	-
ⲉⲩⲗⲁⲃⲏⲥ	N	-
ⲉⲩⲗⲁⲃⲓⲁ	N	-
ⲉⲩⲗⲟⲅⲱⲥ	ADV	-
ⲉⲩⲛⲟⲙⲟⲥ	NPROP	-
ⲉⲩⲡⲟⲣⲉⲓ	V	-
ⲉⲩⲥⲉⲃⲏⲥ	N	-
ⲉⲩⲥⲉⲃⲓⲟⲥ	NPROP	-
ⲉⲩⲥⲧⲁⲑⲓⲁⲛⲟⲥ	NPROP	-
ⲉⲩⲥⲧⲁⲑⲓⲟⲥ	NPROP	-
ⲉⲩⲥⲧⲟⲭⲓⲟⲥ	NPROP	-
ⲉⲩⲧⲏⲗⲉⲥ	N	-
ⲉⲩⲧⲏⲗⲓⲟⲩ	V	-
ⲉⲩⲧⲏⲭⲓⲁⲛⲟⲥ	NPROP	-
ⲉⲩⲧⲣⲟⲡⲓⲟⲥ	NPROP	-
ⲉⲩⲧⲩⲭⲏⲥ	NPROP	-
ⲉⲩⲫⲏⲙⲓⲁ	NPROP	-
ⲉⲩⲫⲣⲁⲛⲉ	V	-
ⲉⲩⲫⲣⲟⲥⲩⲛⲏ	N	-
ⲉⲩⲭⲁⲣⲓⲍⲉ	V	-
ⲉⲩⲭⲁⲣⲓⲥⲧⲉⲓ	V	-
ⲉⲩⲭⲁⲣⲓⲥⲧⲓ	V	-
ⲉⲩⲭⲁⲣⲓⲥⲧⲟⲩ	V	-
ⲉⲩⲱ	N	-
ⲉⲫⲉⲥⲟⲥ	NPROP	-
ⲉⲫⲟⲥⲟⲛ	CONJ	-
ⲍⲁⲃⲟⲩⲗⲟⲛ	NPROP	-
ⲍⲁⲭⲁⲓⲟⲥ	NPROP	-
ⲍⲁⲭⲁⲣⲓⲁⲥ	NPROP	-
ⲍⲉⲇⲉⲕⲓⲁⲥ	NPROP	-
ⲍⲉⲩⲥ	NPROP	-
ⲍⲏⲛⲱⲛ	NPROP	-
ⲍⲏⲧⲏⲙⲁ	N	-
ⲍⲏⲧⲏⲥⲓⲥ	N	-
ⲍⲟⲇⲓⲟⲛ	N	-
ⲍⲟⲣⲟⲃⲁⲃⲉⲗ	NPROP	-
ⲍⲱⲅⲣⲁⲫⲓ	V	-
ⲍⲱⲇⲓⲟⲛ	N	-
ⲍⲱⲕⲣⲁⲧⲱⲥ	NPROP	-
ⲍⲱⲟⲛ	N	-
ⲏ	CONJ	-
ⲏⲉⲓ	N	-
ⲏⲓ	N	-
ⲏⲗⲓⲥⲥⲁⲓⲟⲥ	NPROP	-
ⲏⲡ	VSTAT	-
ⲏⲡⲉ	N	-
ⲏⲣⲡ	N	-
ⲏⲥⲁⲓⲁⲥ	NPROP	-
ⲏⲥⲩⲭⲁⲍⲉ	V	-
ⲏⲥⲩⲭⲓⲁ	N	-
ⲑⲁⲃ	N	-
ⲑⲁⲏ	N	-
ⲑⲁⲓⲃⲉⲥ	N	-
ⲑⲁⲗⲁⲥⲥⲁ	N	-
ⲑⲁⲗⲡⲉⲓ	V	-
ⲑⲁⲣⲉⲓ	V	-
ⲑⲁⲣⲙⲉⲛⲓⲁ	NPROP	-
ⲑⲁⲣⲙⲏⲛⲓⲁ	NPROP	-
ⲑⲁⲣⲣⲉⲓ	V	-
ⲑⲁⲣⲥⲟⲥ	N	-
ⲑⲁⲩⲙⲁⲍⲉ	V	-
ⲑⲁⲯⲓⲥ	N	-
ⲑⲃⲃⲓⲉ	V	-
ⲑⲃⲃⲓⲏⲩ	VSTAT	-
ⲑⲃⲃⲓⲟ	V	-
ⲑⲉⲁⲧⲣⲟⲛ	N	-
ⲑⲉⲃⲁⲥⲓⲁ	NPROP	-
ⲑⲉⲓⲙⲁⲣⲙⲉⲛⲏ	N	-
ⲑⲉⲗⲡⲓⲥ	N	-
ⲑⲉⲟⲇⲟⲣⲓⲭⲟⲥ	NPROP	-
ⲑⲉⲟⲇⲟⲥⲓⲟⲥ	NPROP	-
ⲑⲉⲟⲇⲟⲣⲟⲥ	NPROP	-
ⲑⲉⲟⲇⲱⲣⲟⲥ	NPROP	-
ⲑⲉⲟⲇⲱⲥⲓⲟⲥ	NPROP	-
ⲑⲉⲟⲣⲉⲓ	V	-
ⲑⲉⲟⲧⲟⲕⲟⲥ	N	-
ⲑⲉⲟⲫⲓⲗⲉⲥⲧⲁⲧⲟⲥ	N	-
ⲑⲉⲟⲫⲓⲗⲟⲥ	NPROP	-
ⲑⲉⲟⲫⲩⲗⲟⲥ	NPROP	-
ⲑⲉⲣⲁⲡⲉⲩⲉ	V	-
ⲑⲉⲣⲙⲏⲛⲓⲁ	N	-
ⲑⲉⲱⲇⲟⲥⲓⲟⲥ	NPROP	-
ⲑⲉⲱⲇⲱⲣⲟⲥ	NPROP	-
ⲑⲉⲱⲇⲱⲥⲓⲟⲥ	NPROP	-
ⲑⲉⲱⲣⲉⲓ	V	-
ⲑⲉⲱⲣⲓ	V	-
ⲑⲉⲱⲣⲓⲁ	N	-
ⲑⲉⲱⲫⲓⲗⲟⲥ	NPROP	-
ⲑⲏ	N	-
ⲑⲏⲃⲁⲉⲓⲥ	NPROP	-
ⲑⲏⲃⲁⲓⲥ	NPROP	-
ⲑⲏⲇⲟⲛⲏ	N	-
ⲑⲏⲣⲁⲡⲉⲩⲉ	V	-
ⲑⲏⲣⲓⲟⲛ	N	-
ⲑⲏⲥⲁⲩⲣⲓⲁ	NPROP	-
ⲑⲏⲥⲁⲩⲣⲟⲥ	N	-
ⲑⲏⲥⲓⲁⲥⲧⲏⲣⲓⲟⲛ	N	-
ⲑⲓⲉⲣⲟⲩⲥⲁⲗⲏⲙ	NPROP	-
ⲑⲓⲕⲱⲛ	N	-
ⲑⲓⲙⲁⲣⲙⲉⲛⲏ	N	-
ⲑⲓⲥⲁⲩⲣⲓⲁ	NPROP	-
ⲑⲗⲓⲃⲉ	V	-
ⲑⲗⲓⲯⲓⲥ	N	-
ⲑⲙⲕⲉ	V	-
ⲑⲙⲕⲟ	V	-
ⲑⲙⲙⲉ	N	-
ⲑⲙⲟⲩⲓ	NPROP	-
ⲑⲙⲥⲟ	V	-
ⲑⲟ	V	-
ⲑⲟⲟⲩⲧ	NPROP	-
ⲑⲟⲣⲁⲥⲓⲥ	N	-
ⲑⲟⲧⲉ	N	-
ⲑⲡⲟ	V	-
ⲑⲣϣⲟ	V	-
ⲑⲣⲁⲝ	NPROP	-
ⲑⲣⲉⲥⲕⲓⲁ	N	-
ⲑⲣⲏⲥⲕⲓⲁ	N	-
ⲑⲣⲟⲛⲟⲥ	N	-
ⲑⲩⲗⲏ	N	-
ⲑⲩⲙⲉⲗⲓⲕⲏ	N	-
ⲑⲩⲙⲟⲥ	N	-
ⲑⲩⲡⲟⲧⲁⲅⲏ	N	-
ⲑⲩⲣⲉⲟⲛ	N	-
ⲑⲩⲣⲓⲟⲛ	N	-
ⲑⲩⲥⲓⲁ	N	-
ⲑⲩⲥⲓⲁⲍⲉ	V	-
ⲑⲩⲥⲓⲁⲥⲧⲏⲣⲓⲟⲛ	N	-
ⲑⲩⲥⲓⲁⲥⲧⲩⲣⲓⲟⲛ	N	-
ⲓ	PPERO	-
ⲓ	PPERS	-
ⲓ	V	-
ⲓⲁⲕⲟⲃⲟⲥ	NPROP	-
ⲓⲁⲕⲱⲃ	NPROP	-
ⲓⲁⲕⲱⲃⲟⲥ	NPROP	-
ⲓⲁⲙⲃⲣⲏⲥ	NPROP	-
ⲓⲁⲛⲛϩⲥ	NPROP	-
ⲓⲁⲛⲛⲏⲥ	NPROP	-
ⲓⲃⲉ	V	-
ⲓⲉⲃⲉⲧ	N	-
ⲓⲉⲍⲁ	NPROP	-
ⲓⲉⲣⲉⲙⲓⲁ	NPROP	-
ⲓⲉⲣⲉⲙⲓⲁⲥ	NPROP	-
ⲓⲉⲣⲉⲩⲥ	N	-
ⲓⲉⲣⲏⲙⲓⲁⲥ	NPROP	-
ⲓⲉⲣⲏⲛⲛⲁⲓⲟⲥ	NPROP	-
ⲓⲉⲣⲟ	N	-
ⲓⲉⲣⲱⲟⲩ	N	-
ⲓⲉⲥⲥⲁⲓ	NPROP	-
ⲓⲉⲭⲟⲛⲓⲁⲥ	NPROP	-
ⲓⲏⲥⲟⲩⲥ	NPROP	-
ⲓⲛⲇⲓⲁ	NPROP	-
ⲓⲟⲃⲉⲛⲛⲁⲗⲓⲟⲥ	NPROP	-
ⲓⲟⲃⲓⲁⲛⲟⲥ	NPROP	-
ⲓⲟⲣⲇⲁⲛⲏⲥ	NPROP	-
ⲓⲟⲧⲉ	N	-
ⲓⲟⲩ	NPROP	-
ⲓⲟⲩⲃⲉⲛⲁⲗⲓⲟⲥ	NPROP	-
ⲓⲟⲩⲃⲉⲛⲛⲁⲗⲓⲟⲥ	NPROP	-
ⲓⲟⲩⲃⲓⲁⲛⲟⲥ	NPROP	-
ⲓⲟⲩⲇⲁ	NPROP	-
ⲓⲟⲩⲇⲁⲓ	N	-
ⲓⲟⲩⲇⲁⲥ	NPROP	-
ⲓⲟⲩⲗⲓⲁⲛⲟⲥ	NPROP	-
ⲓⲟⲩⲗⲓⲟⲥ	NPROP	-
ⲓⲟⲩⲥϯⲛⲟⲥ	NPROP	-
ⲓⲟⲩⲥⲧⲓⲛⲟⲥ	NPROP	-
ⲓⲣⲉ	V	-
ⲓⲣⲏⲛⲏ	N	-
ⲓⲣⲏⲛⲏⲕⲟⲛ	N	-
ⲓⲣⲏⲛⲓⲕⲟⲛ	N	-
ⲓⲥⲁⲁⲕ	NPROP	-
ⲓⲥⲓⲇⲱⲣⲟⲥ	NPROP	-
ⲓⲥⲣⲁⲏⲗ	NPROP	-
ⲓⲥⲣⲁⲏⲗⲓⲧⲏⲥ	N	-
ⲓⲥⲧⲟⲣⲓⲁ	N	-
ⲓⲥⲧⲱⲣⲓⲁ	N	-
ⲓⲱϩⲁⲛⲛⲏⲥ	NPROP	-
ⲓⲱⲁⲑⲁⲙ	NPROP	-
ⲓⲱⲁⲕⲓⲙ	V	-
ⲓⲱⲃ	NPROP	-
ⲓⲱⲃⲏⲇ	NPROP	-
ⲓⲱⲛⲁⲑⲁⲙ	NPROP	-
ⲓⲱⲣⲁⲙ	NPROP	-
ⲓⲱⲥⲁⲫⲁⲧ	NPROP	-
ⲓⲱⲥⲏⲡⲡⲟⲥ	NPROP	-
ⲓⲱⲥⲏⲫ	NPROP	-
ⲓⲱⲥⲓⲁⲥ	NPROP	-
ⲓⲱⲧ	N	-
ⲕ	PPERO	-
ⲕ	PPERS	-
ⲕⲁ	V	-
ⲕⲁϣ	N	-
ⲕⲁϩ	N	-
ⲕⲁϩⲏⲩ	ADV	-
ⲕⲁϩⲕϩ	V	-
ⲕⲁϩⲕⲉϩ	V	-
ⲕⲁϩⲧⲏ	V	-
ⲕⲁϯⲭⲉ	V	-
ⲕⲁⲁ	V	-
ⲕⲁⲃⲁⲗⲗⲉⲩⲥ	N	-
ⲕⲁⲉⲓⲛ	NPROP	-
ⲕⲁⲍⲟⲫⲩⲗⲁⲅⲓⲟⲛ	N	-
ⲕⲁⲍⲟⲫⲩⲗⲁⲕⲓⲟⲛ	N	-
ⲕⲁⲑⲁⲓⲣⲉⲥⲓⲥ	N	-
ⲕⲁⲑⲁⲓⲣⲏⲥⲓⲥ	N	-
ⲕⲁⲑⲁⲣⲓⲍⲉ	V	-
ⲕⲁⲑⲉⲇⲣⲁ	N	-
ⲕⲁⲑⲉⲣⲉⲥⲓⲥ	N	-
ⲕⲁⲑⲉⲣⲏⲥⲓⲥ	N	-
ⲕⲁⲑⲏⲅⲉⲓ	V	-
ⲕⲁⲑⲏⲕⲉⲓ	V	-
ⲕⲁⲑⲓⲥⲧⲁ	V	-
ⲕⲁⲑⲟⲗⲓⲕϩ	N	-
ⲕⲁⲑⲟⲗⲓⲕⲏ	N	-
ⲕⲁⲓ	CONJ	-
ⲕⲁⲓⲅⲁⲣ	CONJ	-
ⲕⲁⲓⲉ	N	-
ⲕⲁⲓⲙⲏⲛ	CONJ	-
ⲕⲁⲓⲛ	NPROP	-
ⲕⲁⲓⲛⲏ	N	-
ⲕⲁⲓⲡⲉⲣ	CONJ	-
ⲕⲁⲓⲣⲟⲥ	N	-
ⲕⲁⲓⲥⲁⲣⲉⲓⲁ	NPROP	-
ⲕⲁⲓⲥⲁⲣⲓⲁ	NPROP	-
ⲕⲁⲓⲥⲁⲣⲓⲟⲥ	NPROP	-
ⲕⲁⲓⲥⲉ	N	-
ⲕⲁⲓⲧⲟⲓ	CONJ	-
ⲕⲁⲓⲫⲁⲗⲁⲓⲟⲛ	N	-
ⲕⲁⲓⲫⲁⲥ	NPROP	-
ⲕⲁⲕⲉ	N	-
ⲕⲁⲕⲓⲁ	N	-
ⲕⲁⲕⲱⲥ	ADV	-
ⲕⲁⲗⲁϩⲏ	N	-
ⲕⲁⲗⲉⲓ	V	-
ⲕⲁⲗⲗⲓⲡⲁ	NPROP	-
ⲕⲁⲗⲟⲥ	ADV	-
ⲕⲁⲗⲩⲃⲏ	N	-
ⲕⲁⲗⲱⲥ	ADV	-
ⲕⲁⲙⲁ	V	-
ⲕⲁⲙⲓⲥⲓⲟⲛ	N	-
ⲕⲁⲛ	CONJ	-
ⲕⲁⲛⲇⲁⲕⲏ	NPROP	-
ⲕⲁⲛⲇⲓⲇⲓⲁⲛⲟⲥ	NPROP	-
ⲕⲁⲛⲇⲓⲧⲓⲁⲛⲟⲥ	NPROP	-
ⲕⲁⲛⲟⲛ	N	-
ⲕⲁⲛⲟⲡⲟⲥ	NPROP	-
ⲕⲁⲛⲱⲛ	N	-
ⲕⲁⲡⲏⲗⲉⲩⲉ	V	-
ⲕⲁⲡⲛⲟⲥ	N	-
ⲕⲁⲡⲡⲁⲇⲟⲕⲓⲁ	NPROP	-
ⲕⲁⲡⲡⲁⲇⲟⲝ	N	-
ⲕⲁⲣⲁⲧ	V	-
ⲕⲁⲣⲓⲛⲟⲥ	NPROP	-
ⲕⲁⲣⲙⲏⲗⲟⲥ	NPROP	-
ⲕⲁⲣⲟⲥ	NPROP	-
ⲕⲁⲣⲡⲟⲥ	N	-
ⲕⲁⲣⲡⲱⲕⲣⲁⲧⲱⲣ	NPROP	-
ⲕⲁⲣⲭⲏⲇⲱⲛ	NPROP	-
ⲕⲁⲣⲱ	V	-
ⲕⲁⲥ	N	-
ⲕⲁⲥⲓⲥ	N	-
ⲕⲁⲥⲕⲉⲥ	V	-
ⲕⲁⲥⲕⲥ	V	-
ⲕⲁⲥⲧⲣⲟⲛ	N	-
ⲕⲁⲥⲧⲱⲣ	NPROP	-
ⲕⲁⲧⲁ	PREP	-
ⲕⲁⲧⲁϩⲣⲁⲕⲧⲏⲥ	N	-
ⲕⲁⲧⲁⲃⲟⲗⲏ	N	-
ⲕⲁⲧⲁⲅⲓⲟⲛ	N	-
ⲕⲁⲧⲁⲇⲓⲕⲁⲍⲉ	V	-
ⲕⲁⲧⲁⲇⲓⲕⲟⲥ	N	-
ⲕⲁⲧⲁⲑⲉ	CONJ	-
ⲕⲁⲧⲁⲑⲉⲉⲧⲥⲏϩ	ADV	-
ⲕⲁⲧⲁⲑⲉⲧⲥⲏϩ	ADV	-
ⲕⲁⲧⲁⲓⲱϩⲁⲛⲛⲏⲥ	NPROP	-
ⲕⲁⲧⲁⲕⲁⲓⲣⲟⲥ	ADV	-
ⲕⲁⲧⲁⲕⲗⲉⲓⲥⲙⲟⲥ	N	-
ⲕⲁⲧⲁⲕⲗⲩⲥⲙⲟⲥ	N	-
ⲕⲁⲧⲁⲗⲁⲗⲉⲓ	V	-
ⲕⲁⲧⲁⲗⲁⲗⲓⲁ	N	-
ⲕⲁⲧⲁⲗⲟⲩⲕⲁⲥ	NPROP	-
ⲕⲁⲧⲁⲗⲩ	V	-
ⲕⲁⲧⲁⲙⲁ	ADV	-
ⲕⲁⲧⲁⲙⲁⲑⲑⲁⲓⲟⲥ	NPROP	-
ⲕⲁⲧⲁⲙⲁⲣⲕⲟⲥ	NPROP	-
ⲕⲁⲧⲁⲙⲁⲧⲑⲁⲓⲟⲥ	NPROP	-
ⲕⲁⲧⲁⲛⲟⲉⲓ	V	-
ⲕⲁⲧⲁⲛⲟⲓ	V	-
ⲕⲁⲧⲁⲛⲧⲁ	V	-
ⲕⲁⲧⲁⲡϣⲓ	ADV	-
ⲕⲁⲧⲁⲡⲉⲉⲧⲥⲏϩ	ADV	-
ⲕⲁⲧⲁⲡⲉⲧⲁⲥⲙⲁ	N	-
ⲕⲁⲧⲁⲡⲉⲧⲥⲏϩ	ADV	-
ⲕⲁⲧⲁⲡⲟⲛⲧⲓⲍⲉ	V	-
ⲕⲁⲧⲁⲡⲱⲛⲧⲓⲍⲉ	V	-
ⲕⲁⲧⲁⲣⲅⲉⲓ	V	-
ⲕⲁⲧⲁⲣⲟ	PREP	-
ⲕⲁⲧⲁⲣⲱ	PREP	-
ⲕⲁⲧⲁⲥⲧⲁⲥⲓⲥ	N	-
ⲕⲁⲧⲁⲥⲧⲣⲉⲫⲉ	V	-
ⲕⲁⲧⲁⲥⲧⲣⲟⲫⲏ	N	-
ⲕⲁⲧⲁⲥⲧⲩⲗⲉ	V	-
ⲕⲁⲧⲁⲧⲓⲕⲏ	N	-
ⲕⲁⲧⲁⲫⲣⲟⲛⲉⲓ	V	-
ⲕⲁⲧⲉⲭⲉ	V	-
ⲕⲁⲧⲏⲅⲟⲣⲉⲓ	V	-
ⲕⲁⲧⲏⲅⲟⲣⲓⲁ	N	-
ⲕⲁⲧⲏⲭⲉⲓ	V	-
ⲕⲁⲧⲏⲭⲉⲥⲓⲥ	N	-
ⲕⲁⲧⲓⲭⲉ	V	-
ⲕⲁⲧⲟⲟⲧ	V	-
ⲕⲁⲧⲟⲣⲑⲱⲙⲁ	N	-
ⲕⲁⲧⲟⲣⲑⲱⲥⲓⲥ	N	-
ⲕⲁⲩⲙⲁ	N	-
ⲕⲁⲩⲥⲟⲛ	N	-
ⲕⲁⲩⲥⲱⲛ	N	-
ⲕⲁⲫⲁⲣⲛⲁⲟⲩⲙ	NPROP	-
ⲕⲃⲁ	N	-
ⲕⲃⲟ	V	-
ⲕⲇⲏⲥⲓⲥ	N	-
ⲕⲉ	ART	-
ⲕⲉ	N	-
ⲕⲉⲃⲉⲣⲛⲁ	V	-
ⲕⲉⲃⲉⲣⲛⲏⲧⲏⲥ	N	-
ⲕⲉⲇⲣⲟⲥ	N	-
ⲕⲉⲉⲥ	N	-
ⲕⲉⲓⲙⲏⲗⲓⲟⲛ	N	-
ⲕⲉⲓⲙⲓⲗⲓⲟⲛ	N	-
ⲕⲉⲓⲱⲟⲩ	VSTAT	-
ⲕⲉⲗⲉⲃⲓⲛ	N	-
ⲕⲉⲗⲉⲥϯⲛⲟⲥ	NPROP	-
ⲕⲉⲗⲉⲩⲉ	V	-
ⲕⲉⲗⲉⲩⲥⲓⲥ	N	-
ⲕⲉⲗⲗⲉ	N	-
ⲕⲉⲙⲧⲟ	N	-
ⲕⲉⲛⲇⲉⲛⲁⲣⲓⲟⲛ	N	-
ⲕⲉⲛⲇⲓⲛⲁⲣⲓⲟⲛ	N	-
ⲕⲉⲛⲉⲁ	N	-
ⲕⲉⲛⲟⲇⲟⲝⲓⲁ	N	-
ⲕⲉⲛⲧⲉⲛⲁⲣⲓⲟⲛ	N	-
ⲕⲉⲛⲧⲓⲛⲁⲣⲓⲟⲛ	N	-
ⲕⲉⲟⲙⲏⲧⲣⲓⲁ	N	-
ⲕⲉⲟⲩⲁ	N	-
ⲕⲉⲣⲁⲙⲉⲩⲥ	N	-
ⲕⲉⲣⲁⲥⲧⲏⲥ	N	-
ⲕⲉⲣⲉ	V	-
ⲕⲉⲣⲙⲉⲥ	N	-
ⲕⲉⲥⲁⲣⲉⲓⲁ	NPROP	-
ⲕⲉⲥⲁⲣⲓⲁ	NPROP	-
ⲕⲉⲥⲉⲉⲡⲉ	N	-
ⲕⲉⲥⲏⲏⲡⲉ	N	-
ⲕⲉⲧ	N	-
ⲕⲉⲧ	V	-
ⲕⲉⲫⲁⲗⲁⲓⲟⲛ	N	-
ⲕⲉⲫⲁⲗⲏ	N	-
ⲕⲏ	VSTAT	-
ⲕⲏⲃ	VSTAT	-
ⲕⲏⲕⲁϩⲏⲩ	VSTAT	-
ⲕⲏⲙⲉ	NPROP	-
ⲕⲏⲛⲇⲉⲛⲁⲣⲓⲟⲛ	N	-
ⲕⲏⲛⲇⲓⲛⲁⲣⲓⲟⲛ	N	-
ⲕⲏⲛⲧⲉⲛⲁⲣⲓⲟⲛ	N	-
ⲕⲏⲛⲧⲓⲛⲁⲣⲓⲟⲛ	N	-
ⲕⲏⲡⲉ	N	-
ⲕⲏⲡⲟⲥ	N	-
ⲕⲏⲣⲓⲁⲕⲏ	N	-
ⲕⲏⲣⲓⲥⲥⲉ	V	-
ⲕⲏⲣⲩⲅⲙⲁ	N	-
ⲕⲏⲣⲩⲝ	N	-
ⲕⲏⲣⲩⲥⲥⲉ	V	-
ⲕⲏⲧ	VSTAT	-
ⲕⲓⲃⲟⲇⲟⲥ	N	-
ⲕⲓⲃⲟⲧⲟⲥ	N	-
ⲕⲓⲃⲱⲧⲟⲥ	N	-
ⲕⲓⲗⲓⲕⲓⲁ	N	-
ⲕⲓⲗⲓⲕⲓⲱⲧⲏⲥ	N	-
ⲕⲓⲙ	V	-
ⲕⲓⲛⲇⲏⲛⲉⲩⲉ	V	-
ⲕⲓⲛⲇⲩⲛⲟⲥ	N	-
ⲕⲓⲛⲛⲁⲙⲱⲙⲟⲛ	N	-
ⲕⲓⲣⲁ	N	-
ⲕⲓⲣⲓⲁ	N	-
ⲕⲓⲱⲟⲩ	VSTAT	-
ⲕⲗϫ	N	-
ⲕⲗϫⲉ	N	-
ⲕⲗⲁϥⲧ	N	-
ⲕⲗⲁⲃⲧ	N	-
ⲕⲗⲁⲇⲟⲥ	N	-
ⲕⲗⲁⲩⲇⲓⲟⲥ	NPROP	-
ⲕⲗⲉⲟⲡⲁ	V	-
ⲕⲗⲉⲱⲡⲁ	V	-
ⲕⲗⲏⲣⲓⲕⲟⲥ	N	-
ⲕⲗⲏⲣⲟⲛⲟⲙⲉⲓ	V	-
ⲕⲗⲏⲣⲟⲛⲟⲙⲓⲁ	N	-
ⲕⲗⲏⲣⲟⲛⲟⲙⲟⲥ	N	-
ⲕⲗⲏⲣⲟⲥ	N	-
ⲕⲗⲏⲣⲟⲩ	V	-
ⲕⲗⲗⲉ	N	-
ⲕⲗⲟⲙ	N	-
ⲕⲗⲟⲟⲗⲉ	N	-
ⲕⲗⲩⲣⲓⲕⲟⲥ	N	-
ⲕⲗⲩⲣⲟⲛⲟⲙⲉⲓ	V	-
ⲕⲗⲩⲣⲟⲛⲟⲙⲓⲁ	N	-
ⲕⲙⲟⲙ	N	-
ⲕⲙⲧⲟ	N	-
ⲕⲛⲛⲉ	V	-
ⲕⲛⲧⲉ	N	-
ⲕⲟⲉⲓϩ	N	-
ⲕⲟⲉⲓⲥ	NPROP	-
ⲕⲟⲓⲗⲓⲁ	N	-
ⲕⲟⲓⲙⲏⲧⲏⲣⲓⲟⲛ	N	-
ⲕⲟⲓⲛⲟⲛⲉⲓ	V	-
ⲕⲟⲓⲛⲟⲛⲓⲁ	N	-
ⲕⲟⲓⲛⲱⲃⲓⲟⲛ	N	-
ⲕⲟⲓⲛⲱⲛⲉⲓ	V	-
ⲕⲟⲓⲛⲱⲛⲓⲁ	N	-
ⲕⲟⲓⲛⲱⲛⲟⲥ	N	-
ⲕⲟⲓⲧⲱⲛ	N	-
ⲕⲟⲗϫ	V	-
ⲕⲟⲗⲁⲍⲉ	V	-
ⲕⲟⲗⲁⲥⲓⲥ	N	-
ⲕⲟⲗⲏ	V	-
ⲕⲟⲗⲓ	V	-
ⲕⲟⲗⲓⲉ	V	-
ⲕⲟⲗⲗⲩⲕⲓⲟⲛ	N	-
ⲕⲟⲗⲩ	V	-
ⲕⲟⲗⲩⲉ	V	-
ⲕⲟⲗⲩⲙⲃⲏⲑⲣⲁ	N	-
ⲕⲟⲙϣ	V	-
ⲕⲟⲙⲉⲥ	N	-
ⲕⲟⲙⲏⲥ	N	-
ⲕⲟⲙⲓⲥ	N	-
ⲕⲟⲛⲥ	V	-
ⲕⲟⲛⲱⲛ	NPROP	-
ⲕⲟⲟϩ	N	-
ⲕⲟⲟⲛⲥ	V	-
ⲕⲟⲟⲥ	V	-
ⲕⲟⲟⲩ	N	-
ⲕⲟⲟⲩⲉ	N	-
ⲕⲟⲡⲣⲓⲁ	N	-
ⲕⲟⲣⲃⲁⲛⲟⲥ	N	-
ⲕⲟⲥⲕⲉⲥ	V	-
ⲕⲟⲥⲕⲥ	V	-
ⲕⲟⲥⲙⲉⲓ	V	-
ⲕⲟⲥⲙⲏⲥⲓⲥ	N	-
ⲕⲟⲥⲙⲟⲥ	N	-
ⲕⲟⲥⲧⲁⲛⲧⲓⲛⲟⲥ	NPROP	-
ⲕⲟⲥⲧⲁⲥ	NPROP	-
ⲕⲟⲧ	N	-
ⲕⲟⲧ	V	-
ⲕⲟⲧⲕ	N	-
ⲕⲟⲩⲉⲓ	N	-
ⲕⲟⲩⲓ	N	-
ⲕⲟⲩⲓⲛⲉⲣⲱⲧ	NPROP	-
ⲕⲟⲩⲛⲥ	N	-
ⲕⲟⲩⲫⲟⲛ	N	-
ⲕⲣⲁⲛⲓⲟⲛ	V	-
ⲕⲣⲁⲧⲟⲥ	N	-
ⲕⲣⲓⲕⲟⲥ	N	-
ⲕⲣⲓⲙⲁ	N	-
ⲕⲣⲓⲛⲉ	V	-
ⲕⲣⲓⲛⲟⲛ	N	-
ⲕⲣⲓⲥⲓⲥ	N	-
ⲕⲣⲓⲧⲏⲥ	N	-
ⲕⲣⲙⲉⲥ	N	-
ⲕⲣⲙⲣⲱⲙ	VSTAT	-
ⲕⲣⲟ	N	-
ⲕⲣⲟϥ	N	-
ⲕⲣⲟⲙⲣⲉⲙ	V	-
ⲕⲣⲟⲙⲣⲙ	V	-
ⲕⲣⲱⲙ	N	-
ⲕⲣⲱⲟⲩ	VSTAT	-
ⲕⲧⲉ	V	-
ⲕⲧⲏⲙⲁ	N	-
ⲕⲧⲏⲥⲓⲥ	N	-
ⲕⲧⲏⲩ	VSTAT	-
ⲕⲧⲓⲥⲓⲥ	N	-
ⲕⲧⲓⲥⲙⲁ	N	-
ⲕⲧⲟ	V	-
ⲕⲧⲟⲛ	V	-
ⲕⲩⲃⲉⲣⲛⲁ	V	-
ⲕⲩⲃⲉⲣⲛⲏⲧⲉⲩⲉ	V	-
ⲕⲩⲛⲇⲉⲛⲁⲣⲓⲟⲛ	N	-
ⲕⲩⲛⲇⲓⲛⲁⲣⲓⲟⲛ	N	-
ⲕⲩⲛⲇⲩⲛⲟⲥ	N	-
ⲕⲩⲛⲏⲅⲟⲥ	NPROP	-
ⲕⲩⲛⲧⲉⲛⲁⲣⲓⲟⲛ	N	-
ⲕⲩⲛⲧⲓⲛⲁⲣⲓⲟⲛ	N	-
ⲕⲩⲡⲟⲥ	N	-
ⲕⲩⲣⲁ	N	-
ⲕⲩⲣⲏⲥⲥⲉ	V	-
ⲕⲩⲣⲓⲁ	N	-
ⲕⲩⲣⲓⲁⲕⲏ	N	-
ⲕⲩⲣⲓⲗⲗⲟⲥ	NPROP	-
ⲕⲩⲣⲓⲥⲥⲉ	V	-
ⲕⲩⲣⲩⲝ	N	-
ⲕⲩⲣⲩⲥⲥⲉ	V	-
ⲕⲱ	V	-
ⲕⲱϩ	V	-
ⲕⲱϩⲧ	N	-
ⲕⲱⲃ	V	-
ⲕⲱⲗϩ	V	-
ⲕⲱⲗϫ	V	-
ⲕⲱⲗⲁⲥⲓⲥ	N	-
ⲕⲱⲗⲉ	V	-
ⲕⲱⲗⲉⲓ	V	-
ⲕⲱⲗⲏ	V	-
ⲕⲱⲗⲓ	V	-
ⲕⲱⲗⲓⲉ	V	-
ⲕⲱⲗⲡ	V	-
ⲕⲱⲗⲩ	V	-
ⲕⲱⲗⲩⲉ	V	-
ⲕⲱⲙϣ	V	-
ⲕⲱⲙⲁⲣⲓⲟⲛ	N	-
ⲕⲱⲙⲉⲥ	N	-
ⲕⲱⲙⲏⲧⲁⲧⲟⲛ	N	-
ⲕⲱⲙⲓⲥ	N	-
ⲕⲱⲙⲓⲧⲁⲧⲟⲛ	N	-
ⲕⲱⲙⲓⲧⲁⲧⲱⲛ	N	-
ⲕⲱⲛϩⲧⲏ	V	-
ⲕⲱⲛⲓⲁ	N	-
ⲕⲱⲛⲟⲛ	NPROP	-
ⲕⲱⲛⲣⲱ	V	-
ⲕⲱⲛⲥ	V	-
ⲕⲱⲛⲥⲱ	V	-
ⲕⲱⲣϣ	V	-
ⲕⲱⲣⲉϣ	V	-
ⲕⲱⲥ	NPROP	-
ⲕⲱⲥⲧⲁⲛϯⲛⲟⲥ	NPROP	-
ⲕⲱⲥⲧⲁⲛϯⲟⲥ	NPROP	-
ⲕⲱⲥⲧⲁⲛⲧⲓⲛⲟⲥ	NPROP	-
ⲕⲱⲥⲧⲁⲛⲧⲓⲛⲟⲩⲡⲟⲗⲉⲓⲥ	NPROP	-
ⲕⲱⲥⲧⲁⲛⲧⲓⲛⲟⲩⲡⲟⲗⲓⲥ	NPROP	-
ⲕⲱⲥⲧⲁⲛⲧⲓⲟⲥ	NPROP	-
ⲕⲱⲥⲧⲁⲥ	NPROP	-
ⲕⲱⲥⲧⲟⲥ	NPROP	-
ⲕⲱⲧ	V	-
ⲕⲱⲧⲉ	V	-
ⲕⲱⲱⲃⲉ	V	-
ⲕⲱⲱⲗⲉ	V	-
ⲕⲱⲱⲛⲥ	V	-
ⲕⲱⲱⲣⲉ	V	-
ⲕⲱⲱⲥ	V	-
ⲗϩⲏⲙ	V	-
ⲗϩⲱⲃ	V	-
ⲗⲁⲁⲩ	N	-
ⲗⲁⲃⲁⲛ	NPROP	-
ⲗⲁⲍⲁⲣⲟⲥ	NPROP	-
ⲗⲁⲓⲕⲟⲥ	N	-
ⲗⲁⲕⲉⲙ	N	-
ⲗⲁⲕⲙ	N	-
ⲗⲁⲕⲱⲛ	N	-
ⲗⲁⲙϫⲁⲧⲡ	N	-
ⲗⲁⲙⲡⲁⲥ	N	-
ⲗⲁⲙⲡⲉⲩⲉ	V	-
ⲗⲁⲙⲡⲣⲟⲛ	N	-
ⲗⲁⲟⲇⲓⲕⲓⲁ	NPROP	-
ⲗⲁⲟⲥ	N	-
ⲗⲁⲥ	N	-
ⲗⲁⲧⲟⲙⲟⲥ	N	-
ⲗⲉϥⲗⲱϥ	VSTAT	-
ⲗⲉⲃⲓⲧⲱⲛ	N	-
ⲗⲉⲓⲧⲟⲩⲣⲅⲉⲓ	V	-
ⲗⲉⲓⲧⲟⲩⲣⲅⲓⲁ	N	-
ⲗⲉⲓⲧⲟⲩⲣⲅⲟⲥ	N	-
ⲗⲉⲝⲓⲥ	N	-
ⲗⲉⲡⲧⲟⲇⲏⲙⲟⲥ	NPROP	-
ⲗⲉⲡⲧⲟⲇⲩⲙⲟⲥ	NPROP	-
ⲗⲉⲱⲛ	NPROP	-
ⲗⲏϭ	VSTAT	-
ⲗⲏⲙⲏⲛ	N	-
ⲗⲏⲡⲉ	V	-
ⲗⲏⲡⲉⲓ	V	-
ⲗⲏⲥⲧⲏⲥ	N	-
ⲗⲓⲃⲁⲛⲟⲥ	NPROP	-
ⲗⲓⲃⲉ	V	-
ⲗⲓⲃⲉⲣⲓⲟⲥ	NPROP	-
ⲗⲓⲃⲓⲧⲟⲛ	N	-
ⲗⲓⲃⲓⲧⲟⲩ	N	-
ⲗⲓⲃⲓⲧⲱⲛ	N	-
ⲗⲓⲅⲓⲕⲟⲛ	N	-
ⲗⲓⲕⲓⲕⲟⲛ	N	-
ⲗⲓⲙⲏⲛ	N	-
ⲗⲓⲙⲛⲏ	N	-
ⲗⲓⲥⲧⲏⲥ	N	-
ⲗⲓⲧⲟⲩⲣⲅⲉⲓ	V	-
ⲗⲓⲧⲟⲩⲣⲅⲓⲁ	N	-
ⲗⲓⲧⲟⲩⲣⲅⲟⲥ	N	-
ⲗⲕϣⲁ	N	-
ⲗⲕⲥϣⲁ	N	-
ⲗⲗⲏⲃ	N	-
ⲗⲟ	V	-
ⲗⲟϥⲗϥ	V	-
ⲗⲟϥⲗⲉϥ	V	-
ⲗⲟϫϩ	V	-
ⲗⲟϫⲗϫ	V	-
ⲗⲟϫⲗⲉϫ	V	-
ⲗⲟϫⲧ	VSTAT	-
ⲗⲟⲃϣ	VSTAT	-
ⲗⲟⲃⲉ	VSTAT	-
ⲗⲟⲅⲓⲍⲉ	V	-
ⲗⲟⲅⲓⲕⲟⲥ	N	-
ⲗⲟⲅⲓⲟⲥ	N	-
ⲗⲟⲅⲓⲥⲙⲟⲥ	N	-
ⲗⲟⲅⲟⲥ	N	-
ⲗⲟⲅⲭⲏ	N	-
ⲗⲟⲅⲭⲓⲍⲉ	V	-
ⲗⲟⲉⲓϩⲉ	N	-
ⲗⲟⲉⲓϭⲉ	N	-
ⲗⲟⲓϩⲉ	N	-
ⲗⲟⲓϭⲉ	N	-
ⲗⲟⲓⲙⲟⲥ	N	-
ⲗⲟⲓⲡⲟⲛ	CONJ	-
ⲗⲟⲕⲥ	V	-
ⲗⲟⲕⲥ	VSTAT	-
ⲗⲟⲙⲥ	VSTAT	-
ⲗⲟⲩⲕⲁⲥ	NPROP	-
ⲗⲟⲩⲕⲓⲟⲥ	NPROP	-
ⲗⲟⲩⲗⲁⲓ	V	-
ⲗⲩⲃⲓⲧⲟⲛ	N	-
ⲗⲩⲃⲓⲧⲱⲛ	N	-
ⲗⲩⲅⲓⲕⲟⲛ	N	-
ⲗⲩⲕⲓⲕⲟⲛ	N	-
ⲗⲩⲡⲉⲓ	V	-
ⲗⲩⲡⲏ	V	-
ⲗⲩⲥⲧⲏⲥ	N	-
ⲗⲩⲭⲛⲓⲁ	N	-
ⲗⲱϩⲉⲙ	V	-
ⲗⲱϩⲙ	V	-
ⲗⲱϭϫ	V	-
ⲗⲱϭⲉ	V	-
ⲗⲱⲃϣ	V	-
ⲗⲱⲕϣ	N	-
ⲗⲱⲕⲥ	V	-
ⲗⲱⲙⲉⲥ	V	-
ⲗⲱⲙⲥ	V	-
ⲗⲱⲧ	NPROP	-
ⲗⲱⲱⲙ	V	-
ⲗⲱⲱⲙⲉ	V	-
ⲙ	ART	-
ⲙ	PREP	-
ⲙϣⲁ	V	-
ⲙϩⲁⲁⲩ	N	-
ⲙϩⲓⲧ	N	-
ⲙⲁ	N	-
ⲙⲁϩ	V	-
ⲙⲁϩⲉ	N	-
ⲙⲁϩⲧ	N	-
ⲙⲁⲁϫⲉ	N	-
ⲙⲁⲁⲃ	N	-
ⲙⲁⲁⲃⲉⲙⲛϣⲟⲙⲧⲉ	N	-
ⲙⲁⲁⲃⲧⲏ	N	-
ⲙⲁⲁⲩ	N	-
ⲙⲁⲃⲧⲏ	N	-
ⲙⲁⲅⲇⲁⲗⲓⲁ	NPROP	-
ⲙⲁⲅⲇⲁⲗⲓⲛⲏ	NPROP	-
ⲙⲁⲅⲉⲓⲁ	N	-
ⲙⲁⲅⲓⲁ	N	-
ⲙⲁⲅⲓⲥⲧⲣⲓⲁⲛⲟⲥ	N	-
ⲙⲁⲅⲟⲥ	N	-
ⲙⲁⲉⲓⲛ	N	-
ⲙⲁⲉⲧϣϣⲉ	N	-
ⲙⲁⲉⲧⲉϣϣⲉ	N	-
ⲙⲁⲑⲏⲧⲏⲥ	N	-
ⲙⲁⲓϣⲙⲙⲟ	N	-
ⲙⲁⲓϩⲏⲕⲉ	N	-
ⲙⲁⲓϩⲏⲩ	N	-
ⲙⲁⲓϫⲁⲓⲉ	N	-
ⲙⲁⲓϯⲧⲱⲛ	N	-
ⲙⲁⲓⲛⲟⲩⲧⲉ	N	-
ⲙⲁⲓⲡⲉⲭⲣⲓⲥⲧⲟⲥ	N	-
ⲙⲁⲓⲣⲱⲙⲉ	N	-
ⲙⲁⲓⲥⲃⲱ	N	-
ⲙⲁⲓⲥⲱⲧⲙ	N	-
ⲙⲁⲓⲧⲟⲛϩⲟⲩⲟ	N	-
ⲙⲁⲕϩ	N	-
ⲙⲁⲕⲁⲣⲓⲟⲥ	N	-
ⲙⲁⲕⲁⲣⲓⲥⲙⲟⲥ	N	-
ⲙⲁⲕⲇⲁⲗⲓⲁ	NPROP	-
ⲙⲁⲗⲁⲭⲓⲁⲥ	NPROP	-
ⲙⲁⲗⲓⲥⲧⲁ	ADV	-	CONJ	-
ⲙⲁⲗⲗⲟⲛ	ADV	-
ⲙⲁⲙⲙⲟⲟⲛⲉ	N	-
ⲙⲁⲙⲡⲱⲧ	N	-
ⲙⲁⲛϣⲁ	N	-
ⲙⲁⲛϣⲉⲗⲉⲉⲧ	N	-
ⲙⲁⲛϣⲓⲛⲉ	N	-
ⲙⲁⲛϣⲱⲡⲉ	N	-
ⲙⲁⲛϩⲁⲣⲉϩ	N	-
ⲙⲁⲛϩⲱⲧⲡ	N	-
ⲙⲁⲛϫⲁⲓⲉ	N	-
ⲙⲁⲛⲁⲥⲥⲉ	NPROP	-
ⲙⲁⲛⲁⲥⲥⲏ	NPROP	-
ⲙⲁⲛⲉⲗⲟⲟⲗⲉ	N	-
ⲙⲁⲛⲏ	NPROP	-
ⲙⲁⲛⲓⲁ	N	-
ⲙⲁⲛⲓⲁⲕⲏⲥ	N	-
ⲙⲁⲛⲙⲧⲟⲛ	N	-
ⲙⲁⲛⲛⲉⲓⲇⲱⲗⲟⲛ	N	-
ⲙⲁⲛⲟⲩⲱϩ	N	-
ⲙⲁⲛⲟⲩⲱⲙ	N	-
ⲙⲁⲛⲥⲁⲕⲏⲧⲏⲥ	NPROP	-
ⲙⲁⲛⲥⲓⲕⲏⲧⲏⲥ	NPROP	-
ⲙⲁⲛⲱⲧⲡⲉϩⲟⲩⲛ	N	-
ⲙⲁⲝⲓⲙⲓⲛⲟⲥ	N	-
ⲙⲁⲡⲡⲁ	N	-
ⲙⲁⲣ	AJUS	-
ⲙⲁⲣⲅⲁⲣⲓⲧⲏⲥ	N	-
ⲙⲁⲣⲇⲟⲭⲁⲓⲟⲥ	NPROP	-
ⲙⲁⲣⲉ	AJUS	-
ⲙⲁⲣⲏⲥ	NPROP	-
ⲙⲁⲣⲑⲁ	NPROP	-
ⲙⲁⲣⲓϩⲁⲙ	NPROP	-
ⲙⲁⲣⲓⲁ	NPROP	-
ⲙⲁⲣⲓⲛⲟⲥ	NPROP	-
ⲙⲁⲣⲓⲥ	NPROP	-
ⲙⲁⲣⲕⲉⲗⲗⲓⲁⲛⲟⲥ	NPROP	-
ⲙⲁⲣⲕⲓⲁⲛⲟⲥ	NPROP	-
ⲙⲁⲣⲕⲟⲥ	NPROP	-
ⲙⲁⲣⲕⲩⲁⲛⲟⲥ	NPROP	-
ⲙⲁⲣⲟ	VBD	-
ⲙⲁⲣⲧⲏⲣⲓⲟⲛ	N	-
ⲙⲁⲣⲧⲩⲣⲓⲁ	N	-
ⲙⲁⲣⲧⲩⲣⲓⲟⲛ	N	-
ⲙⲁⲣⲧⲩⲣⲟⲥ	N	-
ⲙⲁⲥⲅⲝ	NPROP	-
ⲙⲁⲥⲧϩⲏⲧ	N	-
ⲙⲁⲥⲧⲉ	N	-
ⲙⲁⲥⲧⲉⲛⲟⲩⲧⲉ	N	-
ⲙⲁⲥⲧⲓⲅⲝ	N	-
ⲙⲁⲥⲧⲛⲟⲩⲧⲉ	N	-
ⲙⲁⲥⲧⲫⲑⲟⲛⲉⲓ	N	-
ⲙⲁⲧⲁⲙⲟ	VIMP	-
ⲙⲁⲧⲉ	V	-
ⲙⲁⲧⲑⲁⲙ	NPROP	-
ⲙⲁⲧⲟⲓ	N	-
ⲙⲁⲧⲟⲩ	N	-
ⲙⲁⲧⲟⲩϫⲟ	VIMP	-
ⲙⲁⲧⲣⲱⲛⲁ	N	-
ⲙⲁⲩⲁⲁ	IMOD	-
ⲙⲁⲩⲁⲁⲧ	IMOD	-
ⲙⲉ	ANEGAOR	-
ⲙⲉ	N	-
ⲙⲉ	V	-
ⲙⲉϣϣⲉ	V	-
ⲙⲉϣⲁⲕ	ADV	-
ⲙⲉϣⲧ	V	-
ⲙⲉϩ	N	-
ⲙⲉϩ	V	-
ⲙⲉϩ	VSTAT	-
ⲙⲉϩⲣⲟ	N	-
ⲙⲉϩⲣⲱ	V	-
ⲙⲉⲅⲉⲑⲟⲥ	N	-
ⲙⲉⲅⲉⲛⲟⲓⲧⲟ	PTC	-
ⲙⲉⲉⲣⲉ	N	-
ⲙⲉⲉⲩⲉ	N	-
ⲙⲉⲉⲩⲉ	V	-
ⲙⲉⲕⲙⲟⲩⲕ	V	-
ⲙⲉⲗⲉⲧⲁ	V	-
ⲙⲉⲗⲉⲧⲏ	N	-
ⲙⲉⲗⲉⲧⲓⲁⲛⲟⲥ	N	-
ⲙⲉⲗⲓⲧⲓⲁⲛⲟⲥ	N	-
ⲙⲉⲗⲓⲧⲓⲟⲥ	NPROP	-
ⲙⲉⲗⲟⲥ	N	-
ⲙⲉⲗⲭⲓⲥⲉⲇⲉⲕ	NPROP	-
ⲙⲉⲗⲱⲧ	N	-
ⲙⲉⲛ	CONJ	-
ⲙⲉⲛ	EXIST	-
ⲙⲉⲛⲁⲛⲇⲣⲟⲥ	NPROP	-
ⲙⲉⲛⲧⲟⲓⲅⲉ	CONJ	-
ⲙⲉⲣ	V	-
ⲙⲉⲣϩ	N	-
ⲙⲉⲣⲁⲧⲉ	N	-
ⲙⲉⲣⲉ	V	-
ⲙⲉⲣⲉϩ	N	-
ⲙⲉⲣⲓⲥ	N	-
ⲙⲉⲣⲓⲧ	N	-
ⲙⲉⲣⲕⲟⲩⲣⲓⲟⲥ	NPROP	-
ⲙⲉⲣⲟⲉⲓⲧ	NPROP	-
ⲙⲉⲣⲟⲥ	N	-
ⲙⲉⲥⲓⲧⲏⲥ	N	-
ⲙⲉⲥⲧⲉ	V	-
ⲙⲉⲥⲧⲱ	V	-
ⲙⲉⲧⲁⲛⲟⲉⲓ	V	-
ⲙⲉⲧⲁⲛⲟⲓ	V	-
ⲙⲉⲧⲁⲛⲟⲓⲁ	N	-
ⲙⲉⲧⲉⲭⲉ	V	-
ⲙⲉⲩⲉ	V	-
ⲙⲉⲩⲧ	V	-
ⲙⲉⲭⲣⲓ	PREP	-
ⲙⲏ	CONJ	-
ⲙⲏϣⲉ	N	-
ⲙⲏϩ	VSTAT	-
ⲙⲏⲅⲉⲛⲟⲉⲓⲧⲟ	PTC	-
ⲙⲏⲅⲉⲛⲟⲓⲧⲟ	PTC	-
ⲙⲏⲉϣⲁϥ	CONJ	-
ⲙⲏⲏϣⲉ	N	-
ⲙⲏⲏⲛⲉ	N	-
ⲙⲏⲗⲓⲧⲓⲁⲛⲟⲥ	N	-
ⲙⲏⲛ	VSTAT	-
ⲙⲏⲛⲉⲩⲉ	V	-
ⲙⲏⲡⲟⲧⲉ	CONJ	-
ⲙⲏⲣ	VSTAT	-
ⲙⲏⲥⲉ	N	-
ⲙⲏⲥⲧⲏⲣⲓⲟⲛ	N	-
ⲙⲏⲧ	N	-
ⲙⲏⲧϣⲙⲏⲛⲉ	N	-
ⲙⲏⲧⲉ	N	-
ⲙⲏⲧⲉⲓ	CONJ	-
ⲙⲏⲧⲓ	CONJ	-
ⲙⲏⲧⲛϣⲏ	N	-
ⲙⲏⲧⲣⲁ	N	-
ⲙⲏⲧⲣⲟⲡⲟⲗⲓⲥ	N	-
ⲙⲓϣⲉ	V	-
ⲙⲓⲙⲁⲣⲓⲟⲛ	N	-
ⲙⲓⲙⲏⲥⲓⲥ	N	-
ⲙⲓⲛⲉ	N	-
ⲙⲓⲟⲕ	PTC	-
ⲙⲓⲥⲉ	V	-
ⲙⲓⲧⲣⲁ	N	-
ⲙⲓⲭⲁⲏⲗ	NPROP	-
ⲙⲓⲭⲁⲓⲁⲥ	NPROP	-
ⲙⲕⲁϩ	N	-
ⲙⲕⲁϩ	V	-
ⲙⲕⲁϩⲛϩⲏⲧ	V	-
ⲙⲕⲙⲟⲩⲕ	V	-
ⲙⲕⲙⲟⲩⲕⲉ	V	-
ⲙⲗⲁϩ	N	-
ⲙⲙⲁⲧⲉ	ADV	-
ⲙⲙⲁⲩ	ADV	-
ⲙⲙⲏⲛⲉ	ADV	-
ⲙⲙⲓⲛⲉⲙⲓⲛⲉ	ADV	-
ⲙⲙⲓⲛⲙⲙⲟ	IMOD	-
ⲙⲙⲓⲛⲙⲙⲟ	IMOD_PPERO	-
ⲙⲙⲓⲛⲙⲙⲱ	IMOD	-
ⲙⲙⲛ	EXIST	-
ⲙⲙⲛⲧ	EXIST	-
ⲙⲙⲟ	PREP	-
ⲙⲙⲟ	PREP_PPERO	-
ⲙⲙⲟⲛ	CONJ	-
ⲙⲙⲱ	PREP	-
ⲙⲛ	EXIST	-
ⲙⲛ	PREP	-
ⲙⲛⲛⲥⲁ	PREP	-
ⲙⲛⲛⲥⲁⲛⲁⲓ	CONJ	-
ⲙⲛⲛⲥⲱ	PREP	-
ⲙⲛⲟⲩⲧ	N	-
ⲙⲛⲧ	EXIST	-
ⲙⲛⲧϣⲁϥⲧⲉ	N	-
ⲙⲛⲧϣⲁⲛϩⲧⲏϥ	N	-
ⲙⲛⲧϣⲁⲛⲁϩⲧⲏϥ	N	-
ⲙⲛⲧϣⲃⲏⲣ	N	-
ⲙⲛⲧϣⲏⲣⲉ	N	-
ⲙⲛⲧϣⲏⲣⲉϣⲏⲙ	N	-
ⲙⲛⲧϣⲙⲏⲛ	N	-
ⲙⲛⲧϣⲙⲙⲟ	N	-
ⲙⲛⲧϣⲟⲙⲧⲉ	N	-
ⲙⲛⲧϣⲟⲩϣⲟ	N	-
ⲙⲛⲧϣⲱⲥ	N	-
ⲙⲛⲧϥⲁⲓⲣⲟⲟⲩϣ	N	-
ⲙⲛⲧϩⲁⲕ	N	-
ⲙⲛⲧϩⲁⲕⲟ	N	-
ⲙⲛⲧϩⲁⲡⲗⲟⲩⲥ	N	-
ⲙⲛⲧϩⲁⲣϣϩⲏⲧ	N	-
ⲙⲛⲧϩⲉⲃⲣⲁⲓⲟⲥ	N	-
ⲙⲛⲧϩⲉⲗⲗⲏⲛ	N	-
ⲙⲛⲧϩⲏⲕⲉ	N	-
ⲙⲛⲧϩⲗⲗⲏⲛ	N	-
ⲙⲛⲧϩⲗⲗⲟ	N	-
ⲙⲛⲧϩⲗⲗⲱ	N	-
ⲙⲛⲧϩⲙϩⲁⲗ	N	-
ⲙⲛⲧϩⲣⲟⲩⲱ	N	-
ⲙⲛⲧϫⲁϫⲉ	N	-
ⲙⲛⲧϫⲁⲣϩⲏⲧ	N	-
ⲙⲛⲧϫⲁⲥⲓϩⲏⲧ	N	-
ⲙⲛⲧϫⲓⲟⲩⲁ	N	-
ⲙⲛⲧϫⲟⲉⲓⲥ	N	-
ⲙⲛⲧϫⲟⲓⲥ	N	-
ⲙⲛⲧϫⲱⲱⲣⲉ	N	-
ⲙⲛⲧϭⲱⲃ	N	-
ⲙⲛⲧⲁ	EXIST	-
ⲙⲛⲧⲁⲅⲁⲑⲟⲥ	N	-
ⲙⲛⲧⲁⲑⲏⲧ	N	-
ⲙⲛⲧⲁⲕⲁⲑⲁⲣⲧⲟⲥ	N	-
ⲙⲛⲧⲁⲛⲁⲭⲱⲣⲓⲧⲏⲥ	N	-
ⲙⲛⲧⲁⲡⲁⲛⲑⲣⲱⲡⲟⲥ	N	-
ⲙⲛⲧⲁⲡⲓⲥⲧⲟⲥ	N	-
ⲙⲛⲧⲁⲣⲭⲏⲉⲡⲓⲥⲕⲟⲡⲟⲥ	N	-
ⲙⲛⲧⲁⲣⲭⲓⲉⲡⲓⲥⲕⲟⲡⲟⲥ	N	-
ⲙⲛⲧⲁⲣⲭⲓⲉⲣⲉⲩⲥ	N	-
ⲙⲛⲧⲁⲥⲉⲃⲏⲥ	N	-
ⲙⲛⲧⲁⲥⲕⲏⲧⲏⲥ	N	-
ⲙⲛⲧⲁⲥⲥⲉ	N	-
ⲙⲛⲧⲁⲧϣⲓⲡⲉ	N	-
ⲙⲛⲧⲁⲧϣⲟϫⲛⲉ	N	-
ⲙⲛⲧⲁⲧϩⲟⲧⲉ	N	-
ⲙⲛⲧⲁⲧϭⲟⲙ	N	-
ⲙⲛⲧⲁⲧϯⲥⲟ	N	-
ⲙⲛⲧⲁⲧⲃⲁⲗ	N	-
ⲙⲛⲧⲁⲧⲃⲟⲧⲉ	N	-
ⲙⲛⲧⲁⲧⲙⲟⲩ	N	-
ⲙⲛⲧⲁⲧⲛⲁ	N	-
ⲙⲛⲧⲁⲧⲛⲁϩⲧⲉ	N	-
ⲙⲛⲧⲁⲧⲛⲟⲩⲧⲉ	N	-
ⲙⲛⲧⲁⲧⲣⲟⲟⲩϣ	N	-
ⲙⲛⲧⲁⲧⲥⲃⲱ	N	-
ⲙⲛⲧⲁⲧⲥⲉⲓ	N	-
ⲙⲛⲧⲁⲧⲥⲟⲟⲩⲛ	N	-
ⲙⲛⲧⲁⲧⲥⲱⲧⲙ	N	-
ⲙⲛⲧⲁⲧⲧⲱϣ	N	-
ⲙⲛⲧⲃⲁⲗϩⲏⲧ	N	-
ⲙⲛⲧⲇⲓⲕⲁⲓⲟⲥ	N	-
ⲙⲛⲧⲉ	EXIST	-
ⲙⲛⲧⲉϣⲱⲱⲧ	N	-
ⲙⲛⲧⲉⲃⲓⲏⲛ	N	-
ⲙⲛⲧⲉⲓⲱⲧ	N	-
ⲙⲛⲧⲉⲡⲓⲥⲕⲟⲡⲟⲥ	N	-
ⲙⲛⲧⲉⲣⲟ	N	-
ⲙⲛⲧⲉⲣⲱⲟⲩ	N	-
ⲙⲛⲧⲉⲩⲥⲉⲃⲏⲥ	N	-
ⲙⲛⲧⲉⲩⲧⲉⲗⲏⲥ	N	-
ⲙⲛⲧⲏ	N	-
ⲙⲛⲧⲏⲡⲉ	N	-
ⲙⲛⲧⲓⲱⲧ	N	-
ⲙⲛⲧⲕⲁⲑⲁⲣⲟⲥ	N	-
ⲙⲛⲧⲕⲁⲧⲁⲣⲱⲙⲉ	N	-
ⲙⲛⲧⲕⲟⲩⲉⲓ	N	-
ⲙⲛⲧⲕⲟⲩⲓ	N	-
ⲙⲛⲧⲙⲁⲓϣⲏⲣⲉ	N	-
ⲙⲛⲧⲙⲁⲓⲕⲟⲥⲙⲉⲓ	N	-
ⲙⲛⲧⲙⲁⲓⲛⲟⲩⲧⲉ	N	-
ⲙⲛⲧⲙⲁⲓⲣⲱⲙⲉ	N	-
ⲙⲛⲧⲙⲁⲓⲥⲟⲛ	N	-
ⲙⲛⲧⲙⲁⲓⲭⲣⲏⲙⲁ	N	-
ⲙⲛⲧⲙⲁⲕⲁⲣⲓⲟⲥ	N	-
ⲙⲛⲧⲙⲁⲣⲧⲩⲣⲟⲥ	N	-
ⲙⲛⲧⲙⲁⲧⲟⲓ	N	-
ⲙⲛⲧⲙⲉ	N	-
ⲙⲛⲧⲙⲛⲧⲣⲉ	N	-
ⲙⲛⲧⲙⲟⲛⲁⲭⲟⲥ	N	-
ⲙⲛⲧⲙⲟⲛⲟⲭⲟⲥ	N	-
ⲙⲛⲧⲛⲁ	N	-
ⲙⲛⲧⲛⲁϣⲧⲙⲁⲕϩ	N	-
ⲙⲛⲧⲛⲁⲏⲧ	N	-
ⲙⲛⲧⲛⲟϭ	N	-
ⲙⲛⲧⲛⲟⲉⲓⲕ	N	-
ⲙⲛⲧⲛⲟⲩⲧⲉ	N	-
ⲙⲛⲧⲟⲓⲅⲉ	CONJ	-
ⲙⲛⲧⲟⲩⲉ	N	-
ⲙⲛⲧⲟⲩⲏⲏⲃ	N	-
ⲙⲛⲧⲡⲁⲣⲁⲃⲁⲧⲏⲥ	N	-
ⲙⲛⲧⲡⲁⲣⲑⲉⲛⲟⲥ	N	-
ⲙⲛⲧⲡⲉⲣⲓⲉⲣⲅⲟⲥ	N	-
ⲙⲛⲧⲡⲉⲧϣⲟⲩⲉⲓⲧ	N	-
ⲙⲛⲧⲡⲉⲧⲟⲩⲁⲁⲃ	N	-
ⲙⲛⲧⲡⲟⲛⲏⲣⲟⲥ	N	-
ⲙⲛⲧⲣⲉ	N	-
ⲙⲛⲧⲣⲉϥϣⲉⲙϣⲉⲛⲟⲩⲧⲉ	N	-
ⲙⲛⲧⲣⲉϥϣⲙϣⲉⲉⲓⲇⲱⲗⲟⲛ	N	-
ⲙⲛⲧⲣⲉϥϣⲙϣⲉⲛⲟⲩⲧⲉ	N	-
ⲙⲛⲧⲣⲉϥϣⲟⲟⲣ	N	-
ⲙⲛⲧⲣⲉϥϩⲉⲧⲃⲣⲱⲙⲉ	N	-
ⲙⲛⲧⲣⲉϥϫⲓϩⲟ	N	-
ⲙⲛⲧⲣⲉϥϫⲓⲙⲏⲥⲉ	N	-
ⲙⲛⲧⲣⲉϥϫⲓⲛϭⲟⲛⲥ	N	-
ⲙⲛⲧⲣⲉϥϫⲓⲟⲩⲁ	N	-
ⲙⲛⲧⲣⲉϥϫⲛⲁⲁⲩ	N	-
ⲙⲛⲧⲣⲉϥϭⲛⲁⲣⲓⲕⲉ	N	-
ⲙⲛⲧⲣⲉϥϯϭⲱⲛⲧ	N	-
ⲙⲛⲧⲣⲉϥϯⲧⲱⲛ	N	-
ⲙⲛⲧⲣⲉϥⲇⲓⲁⲕⲟⲛⲉⲓ	N	-
ⲙⲛⲧⲣⲉϥⲣϩⲁⲗ	N	-
ⲙⲛⲧⲣⲉϥⲧⲁⲕⲉϩⲏⲧ	N	-
ⲙⲛⲧⲣⲉⲙⲙⲁⲟ	N	-
ⲙⲛⲧⲣⲉⲙⲛϩⲏⲧ	N	-
ⲙⲛⲧⲣⲉⲛⲛⲟⲩϫ	N	-
ⲙⲛⲧⲣⲙϩⲉ	N	-
ⲙⲛⲧⲣⲙⲙⲁⲟ	N	-
ⲙⲛⲧⲣⲙⲛϩⲏⲧ	N	-
ⲙⲛⲧⲣⲙⲣⲁϣ	N	-
ⲙⲛⲧⲣⲣⲟ	N	-
ⲙⲛⲧⲣⲣⲱⲟⲩ	N	-
ⲙⲛⲧⲣⲱⲙⲉ	N	-
ⲙⲛⲧⲥⲁⲃⲉ	N	-
ⲙⲛⲧⲥⲁⲓⲉ	N	-
ⲙⲛⲧⲥⲉⲙⲛⲟⲥ	N	-
ⲙⲛⲧⲥⲛⲟⲟⲩⲥ	N	-
ⲙⲛⲧⲥⲟϭ	N	-
ⲙⲛⲧⲥⲡⲁⲑⲁⲣⲓⲟⲥ	N	-
ⲙⲛⲧⲥⲧⲙⲏⲧ	N	-
ⲙⲛⲧⲥⲧⲣⲁⲧⲏⲗⲁⲧⲏⲥ	N	-
ⲙⲛⲧⲧⲉⲗⲉⲓⲟⲥ	N	-
ⲙⲛⲧⲧⲉⲗⲓⲟⲥ	N	-
ⲙⲛⲧⲧⲟⲗⲙⲏⲣⲟⲥ	N	-
ⲙⲛⲧⲧⲩⲣⲁⲛⲛⲟⲥ	N	-
ⲙⲛⲧⲫⲁⲩⲗⲟⲥ	N	-
ⲙⲛⲧⲭⲣⲏⲥⲧⲟⲥ	N	-
ⲙⲟϫϩ	N	-
ⲙⲟϫϭ	V	-
ⲙⲟϫϭ	VSTAT	-
ⲙⲟϫⲧ	VSTAT	-
ⲙⲟⲅⲓⲥ	ADV	-
ⲙⲟⲉⲓϩⲉ	N	-
ⲙⲟⲉⲓⲧ	N	-
ⲙⲟⲓϩⲉ	N	-
ⲙⲟⲕϩ	VSTAT	-
ⲙⲟⲕϩⲛϩⲏⲧ	V	-
ⲙⲟⲕϩⲥ	VSTAT	-
ⲙⲟⲕⲉϩ	VSTAT	-
ⲙⲟⲕⲉϩⲛϩⲏⲧ	V	-
ⲙⲟⲕⲙⲉⲕ	V	-
ⲙⲟⲕⲙⲕ	V	-
ⲙⲟⲗϩ	V	-
ⲙⲟⲗϩ	VSTAT	-
ⲙⲟⲛⲁⲥⲧⲏⲣⲓⲟⲛ	N	-
ⲙⲟⲛⲁⲭⲏ	N	-
ⲙⲟⲛⲁⲭⲟⲥ	N	-
ⲙⲟⲛⲟⲅⲉⲛⲏⲥ	N	-
ⲙⲟⲛⲟⲕⲉⲣⲱⲥ	N	-
ⲙⲟⲛⲟⲛ	CONJ	-
ⲙⲟⲛⲟⲭⲟⲥ	N	-
ⲙⲟⲟϣⲉ	V	-
ⲙⲟⲟⲛⲉ	V	-
ⲙⲟⲟⲩ	N	-
ⲙⲟⲟⲩⲧ	V	-
ⲙⲟⲟⲩⲧ	VSTAT	-
ⲙⲟⲣ	V	-
ⲙⲟⲣⲧ	N	-
ⲙⲟⲣⲫⲏ	N	-
ⲙⲟⲥⲧⲉ	V	-
ⲙⲟⲧⲉⲛ	VSTAT	-
ⲙⲟⲧⲛ	VSTAT	-
ⲙⲟⲧⲛⲉⲥ	N	-
ⲙⲟⲩ	N	-
ⲙⲟⲩ	V	-
ⲙⲟⲩϣⲧ	V	-
ⲙⲟⲩϩ	V	-
ⲙⲟⲩⲉⲓⲟⲟⲩⲉ	N	-
ⲙⲟⲩⲓ	N	-
ⲙⲟⲩⲓⲟⲟⲩⲉ	N	-
ⲙⲟⲩⲕϩ	V	-
ⲙⲟⲩⲗϩ	V	-
ⲙⲟⲩⲛϩⲱⲟⲩ	N	-
ⲙⲟⲩⲛⲅ	N	-
ⲙⲟⲩⲛⲉⲓⲟⲟⲩⲉ	N	-
ⲙⲟⲩⲛⲕ	N	-
ⲙⲟⲩⲟⲩⲧ	V	-
ⲙⲟⲩⲣ	V	-
ⲙⲟⲩⲥ	N	-
ⲙⲟⲩⲥⲓⲕⲟⲛ	N	-
ⲙⲟⲩⲧ	N	-
ⲙⲟⲩⲧⲉ	V	-
ⲙⲟⲭⲗⲟⲥ	N	-
ⲙⲡ	ANEGPST	-
ⲙⲡϣⲁ	N	-
ⲙⲡϣⲁ	V	-
ⲙⲡϩⲟⲩⲛⲛ	PREP	-
ⲙⲡϩⲣⲉⲙ	PREP	-
ⲙⲡϩⲱⲧⲉⲃⲟⲗⲙ	PREP	-
ⲙⲡϩⲱⲧⲉⲃⲟⲗⲛ	PREP	-
ⲙⲡⲁⲙⲧⲟⲉⲃⲟⲗ	PREP	-
ⲙⲡⲁⲣⲁ	PREP	-
ⲙⲡⲁⲧ	ANY	-
ⲙⲡⲁⲧⲉⲱⲥⲕϣⲱⲡⲉ	ADV	-
ⲙⲡⲃⲟⲗⲛ	PREP	-
ⲙⲡⲉ	ANEGPST	-
ⲙⲡⲉ	ANEGPST_PPERS	-
ⲙⲡⲉ	PTC	-
ⲙⲡⲉϥⲣⲁⲥⲧⲉ	ADV	-
ⲙⲡⲉϩⲟⲟⲩⲙⲛⲧⲉⲩϣⲏ	ADV	-
ⲙⲡⲉⲓⲙⲁ	ADV	-
ⲙⲡⲉⲓⲟⲩⲟⲉⲓϣ	ADV	-
ⲙⲡⲉⲓⲥⲙⲟⲧⲙ	PREP	-
ⲙⲡⲉⲓⲥⲙⲟⲧⲛ	PREP	-
ⲙⲡⲉⲓⲥⲟⲡ	ADV	-
ⲙⲡⲉⲙⲧⲟⲉⲃⲟⲗⲙ	PREP	-
ⲙⲡⲉⲟⲩⲟⲉⲓϣⲉⲧⲙⲙⲁⲩ	ADV	-
ⲙⲡⲉⲥⲏⲧ	ADV	-
ⲙⲡⲉⲥⲙⲟⲧⲙ	PREP	-
ⲙⲡⲉⲥⲙⲟⲧⲛ	PREP	-
ⲙⲡⲉⲥⲛⲁⲩ	ADV	-
ⲙⲡⲉⲩⲟⲉⲓϣⲉⲧⲙⲙⲁⲩ	ADV	-
ⲙⲡⲓⲟⲩⲟⲉⲓϣ	ADV	-
ⲙⲡⲙϩⲓⲧⲛ	PREP	-
ⲙⲡⲙⲧⲟⲉⲃⲟⲗⲙ	PREP	-
ⲙⲡⲙⲧⲟⲉⲃⲟⲗⲛ	PREP	-
ⲙⲡⲛⲁⲩⲉⲧⲙⲙⲁⲩ	ADV	-
ⲙⲡⲛⲁⲩⲙ	PREP	-
ⲙⲡⲛⲁⲩⲙⲡⲟⲩⲟⲉⲓⲛ	ADV	-
ⲙⲡⲛⲁⲩⲛ	PREP	-
ⲙⲡⲛⲁⲩⲛⲙ	PREP	-
ⲙⲡⲟⲟⲩ	ADV	-
ⲙⲡⲟⲩⲉ	ADV	-
ⲙⲡⲣ	VIMP	-
ⲙⲡⲣⲧⲣⲉ	ANEGJUS	-
ⲙⲡⲥⲁⲥⲛⲁⲩ	ADV	-
ⲙⲡⲥⲟⲡ	ADV	-
ⲙⲣⲣⲉ	N	-
ⲙⲣⲱ	N	-
ⲙⲥⲁϩ	N	-
ⲙⲧⲟ	N	-
ⲙⲧⲟⲛ	N	-
ⲙⲧⲟⲛ	V	-
ⲙⲧⲟⲛⲛϩⲏⲧ	N	-
ⲙⲧⲱ	N	-
ⲙⲩⲥⲧⲏⲣⲓⲟⲛ	N	-
ⲙⲱⲅⲓⲥ	ADV	-
ⲙⲱⲙϣ	N	-
ⲙⲱⲩⲥⲏⲥ	NPROP	-
ⲛ	ACONJ	-
ⲛ	ART	-
ⲛ	N	-
ⲛ	NEG	-
ⲛ	PPERO	-
ⲛ	PPERS	-
ⲛ	PREP	-
ⲛ	V	-
ⲛϣⲟⲧ	N	-
ⲛϩⲁϩⲛⲥⲟⲡ	ADV	-
ⲛϩⲏ	PREP	-
ⲛϩⲏⲧ	PREP	-
ⲛϩⲟϩⲓϩⲟ	ADV	-
ⲛϩⲟⲥⲟⲛ	ADV	-
ⲛϩⲟⲧ	VSTAT	-
ⲛϩⲟⲩⲛ	ADV	-
ⲛϩⲟⲩⲟ	ADV	-
ⲛϩⲟⲩⲧ	V	-
ⲛϩⲱⲥⲟⲛ	ADV	-
ⲛϫⲓⲟⲩⲉ	ADV	-
ⲛϭⲓ	PTC	-
ⲛϯⲙⲓⲛⲉ	ADV	-
ⲛⲁ	FUT	-
ⲛⲁ	PPOS	-
ⲛⲁ	PREP	-
ⲛⲁ	V	-
ⲛⲁ	VSTAT	-
ⲛⲁϣⲉ	VBD	-
ⲛⲁϣⲛϩⲉ	ADV	-
ⲛⲁϣⲧ	VSTAT	-
ⲛⲁϣⲧϩⲏⲧ	N	-
ⲛⲁϣⲱ	VBD	-
ⲛⲁϩⲃ	N	-
ⲛⲁϩⲙ	V	-
ⲛⲁϩⲙⲉ	V	-
ⲛⲁϩⲙⲟⲩ	V	-
ⲛⲁϩⲣⲁ	PREP	-
ⲛⲁϩⲣⲉⲙ	PREP	-
ⲛⲁϩⲣⲉⲛ	PREP	-
ⲛⲁϩⲣⲙ	PREP	-
ⲛⲁϩⲣⲛ	PREP	-
ⲛⲁϩⲧ	V	-
ⲛⲁϩⲧⲉ	V	-
ⲛⲁϫϩⲉ	N	-
ⲛⲁⲁϫⲉ	N	-
ⲛⲁⲁⲕⲉ	N	-
ⲛⲁⲁⲥⲥⲱⲛ	NPROP	-
ⲛⲁⲃⲟⲩⲭⲟⲇⲟⲛⲟⲥⲟⲣ	NPROP	-
ⲛⲁⲉⲓⲁⲧ	VBD	-
ⲛⲁⲍⲁⲣⲉⲑ	NPROP	-
ⲛⲁⲍⲱⲣⲁⲓⲟⲥ	N	-
ⲛⲁⲏⲧ	N	-
ⲛⲁⲓ	PDEM	-
ⲛⲁⲓⲁⲧ	VBD	-
ⲛⲁⲓⲙⲁⲛ	NPROP	-
ⲛⲁⲙⲉ	ADV	-
ⲛⲁⲛⲟⲩ	VBD	-
ⲛⲁⲟⲩⲟⲩⲛⲟⲩ	ADV	-
ⲛⲁⲡϣⲁⲩ	ADV	-
ⲛⲁⲩ	N	-
ⲛⲁⲩ	V	-
ⲛⲉ	ART	-
ⲛⲉ	COP	-
ⲛⲉ	CPRET	-
ⲛⲉϥ	PPOS	-
ⲛⲉϩ	N	-
ⲛⲉϩ	V	-
ⲛⲉϩϣⲗϥ	V	-
ⲛⲉϩⲉⲙ	V	-
ⲛⲉϩⲙ	V	-
ⲛⲉϩⲡⲉ	V	-
ⲛⲉϩⲥⲉ	V	-
ⲛⲉϫ	V	-
ⲛⲉϭⲛⲟϭ	V	-
ⲛⲉϭⲛⲟⲩϭ	V	-
ⲛⲉⲁⲡⲟⲗⲉⲓⲥ	NPROP	-
ⲛⲉⲁⲡⲟⲗⲓⲥ	NPROP	-
ⲛⲉⲉⲃⲉ	N	-
ⲛⲉⲑⲏⲡ	N	-
ⲛⲉⲓ	PDEM	-
ⲛⲉⲕ	PPOS	-
ⲛⲉⲕⲣⲟⲥ	N	-
ⲛⲉⲙⲫⲏ	N	-
ⲛⲉⲛ	PPOS	-
ⲛⲉⲛⲉⲣⲏⲟⲩ	N	-
ⲛⲉⲛⲉⲣⲏⲩ	N	-
ⲛⲉⲟⲕⲁⲓⲥⲁⲣⲉⲓⲁ	NPROP	-
ⲛⲉⲣ	CPRET_PPERS	-
ⲛⲉⲣⲉ	CPRET	-
ⲛⲉⲣⲉ	CPRET_PPERS	-
ⲛⲉⲥ	PPOS	-
ⲛⲉⲥϯⲁ	N	-
ⲛⲉⲥⲉⲣⲏⲩ	N	-
ⲛⲉⲥⲧⲉⲟⲩⲉ	V	-
ⲛⲉⲥⲧⲉⲩⲉ	V	-
ⲛⲉⲥⲧⲟⲣⲓⲁⲛⲟⲥ	N	-
ⲛⲉⲥⲧⲟⲣⲓⲟⲥ	NPROP	-
ⲛⲉⲥⲧⲱⲣⲓⲁⲛⲟⲥ	N	-
ⲛⲉⲥⲧⲱⲣⲓⲟⲥ	NPROP	-
ⲛⲉⲥⲱ	VBD	-
#ⲛⲉⲧϩⲓⲧⲟⲩⲱ	N	-
#ⲛⲉⲧⲙⲟⲟⲩⲧ	N	-
ⲛⲉⲧⲛ	PPERS	-
ⲛⲉⲧⲛ	PPOS	-
#ⲛⲉⲧⲛⲉⲣⲏⲩ	N	-
#ⲛⲉⲧⲟⲩⲁⲁⲃ	N	-
#ⲛⲉⲧⲧⲁⲓⲏⲩ	N	-
ⲛⲉⲩ	PPOS	-
ⲛⲉⲩⲉⲣⲏⲟⲩ	N	-
ⲛⲉⲩⲉⲣⲏⲩ	N	-
ⲛⲉⲫⲑⲁⲗⲉⲓⲙ	NPROP	-
ⲛⲏ	PREP	-
ⲛⲏϫ	VSTAT	-
ⲛⲏⲥⲟⲥ	N	-
ⲛⲏⲥⲧⲉⲓⲁ	N	-
ⲛⲏⲥⲧⲉⲟⲩⲉ	V	-
ⲛⲏⲥⲧⲉⲩⲉ	V	-
ⲛⲏⲥⲧⲓⲁ	N	-
ⲛⲏⲧⲛ	PREP	-
ⲛⲏⲩ	VSTAT	-
ⲛⲏⲫⲉ	V	-
ⲛⲑⲉⲁⲛⲛ	CONJ	-
ⲛⲑⲉⲉⲧ	CONJ	-
ⲛⲑⲉⲉⲧⲉⲣⲉ	CONJ	-
ⲛⲑⲉⲉⲧⲥⲏϩ	ADV	-
ⲛⲑⲉⲙ	PREP	-
ⲛⲑⲉⲛ	PREP	-
ⲛⲑⲉⲧⲥⲏϩ	ADV	-
ⲛⲓ	PDEM	-
ⲛⲓϣϭⲣⲱⲟⲩ	NPROP	-
ⲛⲓϥⲉ	V	-
ⲛⲓⲃⲉ	V	-
ⲛⲓⲕⲁⲓⲁ	NPROP	-
ⲛⲓⲕⲏ	N	-
ⲛⲓⲕⲏⲧⲏⲥ	N	-
ⲛⲓⲕⲟⲙⲏⲇⲏⲥ	NPROP	-
ⲛⲓⲕⲟⲙⲏⲧⲏⲥ	NPROP	-
ⲛⲓⲙ	PINT	-
ⲛⲓⲥⲉ	V	-
ⲛⲓⲧⲣⲓⲁ	NPROP	-
ⲛⲕⲁ	N	-
ⲛⲕⲁⲛⲓⲙ	N	-
ⲛⲕⲉⲥⲟⲡ	ADV	-
ⲛⲕⲟⲧⲕ	V	-
ⲛⲙ	PREP	-
ⲛⲙⲙ	PREP	-
ⲛⲙⲙⲁ	PREP	-
ⲛⲙⲙⲏ	PREP	-
ⲛⲛⲁϩⲣⲁ	PREP	-
ⲛⲛⲁϩⲣⲉⲙ	PREP	-
ⲛⲛⲁϩⲣⲉⲛ	PREP	-
ⲛⲛⲁϩⲣⲏ	PREP	-
ⲛⲛⲁϩⲣⲙ	PREP	-
ⲛⲛⲁϩⲣⲛ	PREP	-
ⲛⲛⲁⲩⲛⲓⲙ	ADV	-
ⲛⲛⲉ	ANEGOPT	-
ⲛⲛⲉⲥϣⲱⲡⲉ	PTC	-
ⲛⲟϣⲡ	V	-
ⲛⲟϥⲣⲉ	N	-
ⲛⲟϫ	V	-
ⲛⲟϭ	N	-
ⲛⲟϭⲙⲡⲟⲗⲓⲥ	N	-
ⲛⲟϭⲛϭ	V	-
ⲛⲟϭⲛϭⲟⲙ	N	-
ⲛⲟϭⲛϭⲱⲛⲧ	N	-
ⲛⲟϭⲛⲉϭ	V	-
ⲛⲟϭⲛⲉϭⲟⲙ	N	-
ⲛⲟϭⲥ	VSTAT	-
ⲛⲟⲃⲉ	N	-
ⲛⲟⲃⲣⲉ	N	-
ⲛⲟⲉⲃⲣⲓⲟⲥ	N	-
ⲛⲟⲉⲓ	V	-
ⲛⲟⲉⲓⲕ	N	-
ⲛⲟⲉⲓⲛ	V	-
ⲛⲟⲉⲣⲁ	N	-
ⲛⲟⲉⲣⲟⲛ	N	-
ⲛⲟⲉⲣⲟⲥ	N	-
ⲛⲟⲏ	NPROP	-
ⲛⲟⲏⲙⲁ	N	-
ⲛⲟⲓ	V	-
ⲛⲟⲙⲓⲕⲟⲥ	N	-
ⲛⲟⲙⲟⲑⲉⲧⲏⲥ	N	-
ⲛⲟⲙⲟⲥ	N	-
ⲛⲟⲙⲧⲉ	N	-
ⲛⲟⲧⲁⲣⲓⲟⲥ	N	-
ⲛⲟⲩ	PPOS	-
ⲛⲟⲩ	V	-
ⲛⲟⲩϣⲏⲙ	ADV	-
ⲛⲟⲩϣⲡ	V	-
ⲛⲟⲩϣⲥ	V	-
ⲛⲟⲩϩ	N	-
ⲛⲟⲩϩⲉ	V	-
ⲛⲟⲩϩⲙ	V	-
ⲛⲟⲩϫ	V	-
ⲛⲟⲩϫⲉ	V	-
ⲛⲟⲩϭⲥ	N	-
ⲛⲟⲩϭⲥ	V	-
ⲛⲟⲩⲃ	N	-
ⲛⲟⲩⲃⲏϭ	PREP	-
ⲛⲟⲩⲃⲧ	V	-
ⲛⲟⲩⲉ	V	-
ⲛⲟⲩⲏⲣ	ADV	-
ⲛⲟⲩⲙⲉⲣⲓⲁⲛⲟⲥ	NPROP	-
ⲛⲟⲩⲙⲉⲣⲟⲥ	N	-
ⲛⲟⲩⲛ	N	-
ⲛⲟⲩⲛⲉ	N	-
ⲛⲟⲩⲟⲉⲓϣⲛⲓⲙ	ADV	-
ⲛⲟⲩⲥ	N	-
ⲛⲟⲩⲥⲟⲡ	ADV	-
ⲛⲟⲩⲧⲉ	N	-
ⲛⲣⲁⲧ	PREP	-
ⲛⲥⲁ	PREP	-
ⲛⲥⲁϥ	ADV	-
ⲛⲥⲁⲃⲏⲗ	CONJ	-
ⲛⲥⲁⲃⲏⲗϫⲉ	CONJ	-
ⲛⲥⲁⲃⲗⲗⲁ	PREP	-
ⲛⲥⲁⲟⲩⲥⲁ	ADV	-
ⲛⲥⲁⲡⲉⲓⲥⲁⲙⲛⲡⲁⲓ	ADV	-
ⲛⲥⲁⲥⲁⲛⲓⲙ	ADV	-
ⲛⲥⲱ	PREP	-
ⲛⲥⲱ	PREP_PPERO	-
ⲛⲧ	CFOC	-
ⲛⲧ	CREL	-
ⲛⲧ	V	-
ⲛⲧ	V_PPERO	-
ⲛⲧϥ	V	-
ⲛⲧⲁ	ACONJ_PPERS	-
ⲛⲧⲉ	PPERI	-
ⲛⲧⲉ	PREP	-
ⲛⲧⲉⲓϩⲉ	ADV	-
ⲛⲧⲉⲓϭⲟⲧ	ADV	-
ⲛⲧⲉⲓⲙⲓⲛⲉ	ADV	-
ⲛⲧⲉⲛϩⲉ	ADV	-
ⲛⲧⲉⲟⲩⲛⲟⲩ	ADV	-
ⲛⲧⲉⲡⲟⲩⲟⲉⲓⲛ	PREP	-
ⲛⲧⲉⲣ	APREC	-
ⲛⲧⲉⲣⲉ	APREC	-
ⲛⲧⲉⲧⲛ	PPERI	-
ⲛⲧⲉⲩϣⲏ	ADV	-
ⲛⲧⲉⲩϩⲉ	ADV	-
ⲛⲧⲉⲩⲛⲟⲩ	ADV	-
ⲛⲧⲏϭ	N	-
ⲛⲧⲓⲙⲓⲛⲉ	ADV	-
ⲛⲧⲕ	PPERI	-
ⲛⲧⲙ	PREP	-
ⲛⲧⲛ	PREP	-
ⲛⲧⲟ	PPERI	-
ⲛⲧⲟϥ	PPERI	-
ⲛⲧⲟⲕ	PPERI	-
ⲛⲧⲟⲟⲧ	PREP	-
ⲛⲧⲟⲟⲩ	PPERI	-
ⲛⲧⲟⲥ	PPERI	-
ⲛⲧⲡⲉⲛ	PREP	-
ⲛⲧⲱⲧⲛ	PPERI	-
ⲛⲩⲙⲫⲏ	N	-
ⲛⲩⲙⲫⲓⲟⲥ	N	-
ⲛⲱϩⲉ	NPROP	-
ⲝⲉⲥⲧⲏⲥ	N	-
ⲝⲟⲩⲣ	N	-
ⲟ	VSTAT	-
ⲟϣ	V	-
ⲟϣ	VSTAT	-
ⲟϣϥ	V	-
ⲟϣⲙ	V	-
ⲟϣⲟⲩ	V	-
ⲟϥⲧ	VSTAT	-
ⲟϩⲉ	N	-
ⲟϩⲥ	V	-
ⲟϭⲧϥ	V	-
ⲟⲃϣ	V	-
ⲟⲃϩⲉ	N	-
ⲟⲃⲉ	VSTAT	-
ⲟⲉⲓⲕ	N	-
ⲟⲍⲉⲓⲁⲥ	NPROP	-
ⲟⲓⲕⲟⲇⲟⲙⲏ	N	-
ⲟⲓⲕⲟⲛⲟⲙⲉⲓ	V	-
ⲟⲓⲕⲟⲛⲟⲙⲓⲁ	N	-
ⲟⲓⲕⲟⲛⲟⲙⲟⲥ	N	-
ⲟⲓⲕⲟⲩⲙⲉⲛⲏ	N	-
ⲟⲓⲕⲟⲩⲙⲛⲏ	N	-
ⲟⲕⲙ	VSTAT	-
ⲟⲗ	V	-
ⲟⲗⲃⲓⲟⲥ	NPROP	-
ⲟⲙⲉ	N	-
ⲟⲙⲕ	V	-
ⲟⲙⲥ	V	-
ⲟⲙⲥⲟ	V	-
ⲟⲛ	ADV	-
ⲟⲛϩ	VSTAT	-
ⲟⲛⲛⲟⲣⲓⲟⲥ	NPROP	-
ⲟⲛⲛⲱⲣⲓⲟⲥ	NPROP	-
ⲟⲛⲟⲙⲁⲍⲉ	V	-
ⲟⲛⲟⲙⲁⲥⲧⲟⲥ	N	-
ⲟⲛⲟⲣⲓⲟⲥ	NPROP	-
ⲟⲛⲧⲟⲥ	ADV	-
ⲟⲛⲧⲱⲥ	ADV	-
ⲟⲛⲱⲣⲓⲟⲥ	NPROP	-
ⲟⲟϩ	N	-
ⲟⲟⲙⲉ	N	-
ⲟⲟⲧⲉ	N	-
ⲟⲡⲧ	V	-
ⲟⲣϫ	V	-
ⲟⲣϫ	VSTAT	-
ⲟⲣⲃⲉ	V	-
ⲟⲣⲅⲁⲛⲟⲛ	N	-
ⲟⲣⲅⲏ	N	-
ⲟⲣⲇⲓⲛⲟⲛ	N	-
ⲟⲣⲑⲟⲇⲟⲝⲟⲥ	N	-
ⲟⲥⲉ	N	-
ⲟⲧⲡ	VSTAT	-
ⲟⲧⲡⲉⲛ	V	-
ⲟⲩ	ART	-
ⲟⲩ	PINT	-
ⲟⲩ	PPERO	-
ⲟⲩ	PPERS	-
ⲟⲩϣⲏ	N	-
ⲟⲩϣⲏⲛⲣⲟⲉⲓⲥ	N	-
ⲟⲩϣⲟⲟⲩⲉ	N	-
ⲟⲩϩⲟⲟⲣ	N	-
ⲟⲩϫⲁⲓ	V	-
ⲟⲩϭⲁⲥ	N	-
ⲟⲩⲁ	N	-
ⲟⲩⲁ	NUM	-
ⲟⲩⲁϣ	V	-
ⲟⲩⲁϣⲟⲩ	V	-
ⲟⲩⲁϩ	V	-
ⲟⲩⲁϩⲉ	N	-
ⲟⲩⲁϩⲉⲧ	N	-
ⲟⲩⲁϩⲓⲏⲧ	N	-
ⲟⲩⲁϩⲕⲥϥⲛ	V	-
ⲟⲩⲁⲁ	IMOD	-
ⲟⲩⲁⲁⲃ	VSTAT	-
ⲟⲩⲁⲁⲧ	IMOD	-
ⲟⲩⲁⲗⲉⲛϯⲛⲟⲥ	V	-
ⲟⲩⲁⲗⲉⲛⲧⲓⲛⲟⲥ	NPROP	-
ⲟⲩⲁⲗⲏⲥ	NPROP	-
ⲟⲩⲁⲙⲟⲙⲉ	N	-
ⲟⲩⲁⲙⲣⲱⲙⲉ	N	-
ⲟⲩⲁⲛⲟⲩⲱⲧ	N	-
ⲟⲩⲃⲁϣ	V	-
ⲟⲩⲃⲉ	PREP	-
ⲟⲩⲃⲏ	PREP	-
ⲟⲩⲅⲁⲣ	CONJ	-
ⲟⲩⲇ[.......]	UNKNOWN	-
ⲟⲩⲇⲉ	CONJ	-
ⲟⲩⲉ	N	-
ⲟⲩⲉ	V	-
ⲟⲩⲉϣ	V	-
ⲟⲩⲉϣⲥ	V	-
ⲟⲩⲉϩ	V	-
ⲟⲩⲉϩⲥⲁϩⲛⲉ	V	-
ⲟⲩⲉⲓ	N	-
ⲟⲩⲉⲓⲛⲉ	V	-
ⲟⲩⲉⲙ	V	-
ⲟⲩⲉⲛ	V	-
ⲟⲩⲉⲛϩ	V	-
ⲟⲩⲉⲣⲏⲧⲉ	N	-
ⲟⲩⲉⲥⲡⲁⲥⲓⲁⲛⲟⲥ	NPROP	-
ⲟⲩⲉⲧ	VBD	-
ⲟⲩⲏϩ	VSTAT	-
ⲟⲩⲏⲉⲓⲃ	N	-
ⲟⲩⲏⲏⲃ	N	-
ⲟⲩⲏⲛ	VSTAT	-
ⲟⲩⲏⲣ	PINT	-
ⲟⲩⲏⲧ	N	-
ⲟⲩⲏⲩ	VSTAT	-
ⲟⲩⲕⲉⲝⲉⲥⲧⲉⲓ	V	-
ⲟⲩⲕⲉⲝⲉⲥⲧⲓ	V	-
ⲟⲩⲕⲟⲩⲛ	CONJ	-
ⲟⲩⲗⲗⲉ	N	-
ⲟⲩⲙⲟⲛⲟⲛ	CONJ	-
ⲟⲩⲙⲟⲛⲟⲛϫⲉ	CONJ	-
ⲟⲩⲛ	CONJ	-
ⲟⲩⲛ	EXIST	-
ⲟⲩⲛⲁⲙ	N	-
ⲟⲩⲛⲟϥ	V	-
ⲟⲩⲛⲟⲩ	N	-
ⲟⲩⲛⲧ	EXIST	-
ⲟⲩⲛⲧⲁ	EXIST	-
ⲟⲩⲛⲧⲉ	EXIST	-
ⲟⲩⲛⲧⲏ	EXIST	-
ⲟⲩⲟϣⲃ	V	-
ⲟⲩⲟϣⲃⲉ	V	-
ⲟⲩⲟϣⲥ	VSTAT	-
ⲟⲩⲟϩ	V	-
ⲟⲩⲟϫ	VSTAT	-
ⲟⲩⲟϭⲉ	VSTAT	-
ⲟⲩⲟϭⲡ	VSTAT	-
ⲟⲩⲟⲉⲓ	N	-
ⲟⲩⲟⲉⲓϣ	N	-
ⲟⲩⲟⲉⲓⲉ	N	-
ⲟⲩⲟⲉⲓⲏ	N	-
ⲟⲩⲟⲉⲓⲛ	N	-
ⲟⲩⲟⲉⲓⲛⲁ	PTC	-
ⲟⲩⲟⲉⲓⲛⲏⲧⲛ	PTC	-
ⲟⲩⲟⲓ	N	-
ⲟⲩⲟⲓⲛⲁ	PTC	-
ⲟⲩⲟⲓⲛⲏⲧⲛ	PTC	-
ⲟⲩⲟⲗⲥ	V	-
ⲟⲩⲟⲙ	V	-
ⲟⲩⲟⲙϥ	N	-
ⲟⲩⲟⲛ	N	-
ⲟⲩⲟⲛϩ	V	-
ⲟⲩⲟⲛϩ	VSTAT	-
ⲟⲩⲟⲛϩⲛⲛ	N	-
ⲟⲩⲟⲛⲛⲓⲙ	N	-
ⲟⲩⲟⲟϩⲉ	VSTAT	-
ⲟⲩⲟⲟⲗⲉ	VSTAT	-
ⲟⲩⲟⲧⲃ	VSTAT	-
ⲟⲩⲟⲧⲟⲩⲉⲓⲧ	V	-
ⲟⲩⲟⲧⲟⲩⲉⲧ	V	-
ⲟⲩⲡⲉⲡⲁⲓ	N	-
ⲟⲩⲣⲃⲁⲧⲟⲥ	NPROP	-
ⲟⲩⲣⲓⲁⲥ	NPROP	-
ⲟⲩⲣⲟⲧ	N	-
ⲟⲩⲣⲟⲧ	V	-
ⲟⲩⲥⲓⲁ	N	-
ⲟⲩⲧⲉ	CONJ	-
ⲟⲩⲧⲉ	PREP	-
ⲟⲩⲧⲱ	PREP	-
ⲟⲩⲱ	V	-
ⲟⲩⲱϣ	N	-
ⲟⲩⲱϣ	V	-
ⲟⲩⲱϣϥ	V	-
ⲟⲩⲱϣⲃ	V	-
ⲟⲩⲱϣⲥ	V	-
ⲟⲩⲱϣⲧ	V	-
ⲟⲩⲱϩ	V	-
ⲟⲩⲱϩⲉ	N	-
ⲟⲩⲱϩⲙ	V	-
ⲟⲩⲱϭⲡ	V	-
ⲟⲩⲱⲗⲉ	V	-
ⲟⲩⲱⲗⲥ	V	-
ⲟⲩⲱⲗⲥⲛϩⲏⲧ	N	-
ⲟⲩⲱⲙ	N	-
ⲟⲩⲱⲙ	V	-
ⲟⲩⲱⲛ	V	-
ⲟⲩⲱⲛϣ	N	-
ⲟⲩⲱⲛϩ	V	-
ⲟⲩⲱⲥϥ	V	-
ⲟⲩⲱⲧ	N	-
ⲟⲫⲉⲗⲉⲓ	V	-
ⲟⲫⲉⲗⲉⲓⲁ	N	-
ⲡ	ART	-
ⲡ̣[…]ⲡⲟⲥ	UNKNOWN	-
ⲡϣϭⲉⲡⲟϩⲉ	NPROP	-
ⲡϣⲟⲓ	NPROP	-
ⲡⲁ	PPOS	-
ⲡⲁ[…]ϥⲟϭⲉ	UNKNOWN	-
ⲡⲁϣⲉ	N	-
ⲡⲁϣⲟⲛⲥ	NPROP	-
ⲡⲁϩ	V	-
ⲡⲁϩⲟⲙⲱ	NPROP	-
ⲡⲁϩⲣⲉ	N	-
ⲡⲁϩⲧ	V	-
ⲡⲁϩⲱⲙ	NPROP	-
ⲡⲁϩⲱⲙⲟ	NPROP	-
ⲡⲁϩⲱⲙⲱ	NPROP	-
ⲡⲁϭⲉⲛϣⲉ	N	-
ⲡⲁⲅⲁⲛⲟⲥ	N	-
ⲡⲁⲅⲁⲣⲭⲟⲥ	N	-
ⲡⲁⲏⲥⲉ	NPROP	-
ⲡⲁⲑⲏⲧⲟⲥ	N	-
ⲡⲁⲑⲟⲥ	N	-
ⲡⲁⲓ	PDEM	-
ⲡⲁⲓⲇⲉⲓⲁ	N	-
ⲡⲁⲓⲇⲉⲩⲉ	V	-
ⲡⲁⲓⲇⲉⲩⲥⲓⲥ	N	-
ⲡⲁⲓⲇⲓⲁ	N	-
ⲡⲁⲗⲁϯⲟⲛ	N	-
ⲡⲁⲗⲁⲓⲁ	N	-
ⲡⲁⲗⲁⲧⲓⲛⲟⲥ	NPROP	-
ⲡⲁⲗⲁⲧⲓⲟⲛ	N	-
ⲡⲁⲗⲓⲛ	ADV	-
ⲡⲁⲗⲓⲛ	CONJ	-
ⲡⲁⲗⲓⲥϯⲛⲏ	NPROP	-
ⲡⲁⲗⲗⲁϯⲟⲛ	N	-
ⲡⲁⲗⲗⲁⲇⲓⲟⲛ	N	-
ⲡⲁⲗⲗⲁⲧⲓⲛⲟⲥ	NPROP	-
ⲡⲁⲗⲗⲁⲧⲓⲟⲛ	N	-
ⲡⲁⲙⲟⲩⲛ	NPROP	-
ⲡⲁⲛⲓⲡⲉ	N	-
ⲡⲁⲛⲟⲡⲟⲗⲓⲧⲏⲥ	N	-
ⲡⲁⲛⲟⲥ	NPROP	-
ⲡⲁⲛⲧⲟⲕⲣⲁⲧⲱⲣ	N	-
ⲡⲁⲛⲧⲟⲥ	ADV	-
ⲡⲁⲛⲧⲱⲥ	ADV	-
ⲡⲁⲟⲡⲉ	N	-
ⲡⲁⲡⲁⲥ	N	-
ⲡⲁⲡⲛⲟⲩⲧⲉ	NPROP	-
ⲡⲁⲡⲟϩⲉ	NPROP	-
ⲡⲁⲣϩⲓⲥⲧⲁ	V	-
ⲡⲁⲣϩⲟⲓⲙⲓⲁ	N	-
ⲡⲁⲣⲁ	PREP	-
ⲡⲁⲣⲁⲃⲁ	V	-
ⲡⲁⲣⲁⲃⲁⲗⲗⲉ	V	-
ⲡⲁⲣⲁⲃⲁⲗⲗⲉⲓ	V	-
ⲡⲁⲣⲁⲃⲁⲥⲓⲥ	N	-
ⲡⲁⲣⲁⲃⲟⲗⲏ	N	-
ⲡⲁⲣⲁⲅⲅⲉⲓⲗⲉ	V	-
ⲡⲁⲣⲁⲅⲅⲉⲗⲓⲁ	N	-
ⲡⲁⲣⲁⲅⲅⲓⲗⲉ	V	-
ⲡⲁⲣⲁⲅⲉ	V	-
ⲡⲁⲣⲁⲇⲉⲓⲅⲙⲁ	N	-
ⲡⲁⲣⲁⲇⲉⲓⲥⲟⲥ	N	-
ⲡⲁⲣⲁⲇⲓⲅⲙⲁ	N	-
ⲡⲁⲣⲁⲇⲓⲅⲙⲁⲧⲓⲍⲉ	V	-
ⲡⲁⲣⲁⲇⲓⲇⲟⲩ	V	-
ⲡⲁⲣⲁⲇⲓⲥⲟⲥ	N	-
ⲡⲁⲣⲁⲇⲓⲥⲱⲥ	N	-
ⲡⲁⲣⲁⲇⲟⲥⲓⲥ	N	-
ⲡⲁⲣⲁⲑⲏⲕⲏ	N	-
ⲡⲁⲣⲁⲕⲁⲗⲉⲓ	V	-
ⲡⲁⲣⲁⲕⲗⲏⲥⲓⲥ	N	-
ⲡⲁⲣⲁⲕⲗⲏⲧⲟⲥ	N	-
ⲡⲁⲣⲁⲙⲩⲑⲓⲍⲉ	V	-
ⲡⲁⲣⲁⲛⲟⲙⲓⲁ	N	-
ⲡⲁⲣⲁⲛⲟⲙⲟⲛ	N	-
ⲡⲁⲣⲁⲛⲟⲙⲟⲥ	N	-
ⲡⲁⲣⲁⲛⲱⲙⲓⲁ	N	-
ⲡⲁⲣⲁⲥⲕⲉⲩⲁⲍⲉ	V	-
ⲡⲁⲣⲁⲥⲕⲉⲩⲏ	N	-
ⲡⲁⲣⲁⲥⲧⲁⲧⲏⲥ	N	-
ⲡⲁⲣⲁⲧⲓⲅⲙⲁⲧⲓⲍⲉ	V	-
ⲡⲁⲣⲁⲭⲱⲣⲉⲓ	V	-
ⲡⲁⲣⲉⲗⲑⲉ	V	-
ⲡⲁⲣⲉⲙϩⲟⲧⲡ	NPROP	-
ⲡⲁⲣⲑⲉⲛⲓⲁ	N	-
ⲡⲁⲣⲑⲉⲛⲟⲥ	N	-
ⲡⲁⲣⲙϩⲟⲧⲡ	NPROP	-
ⲡⲁⲣⲙⲟⲩⲧⲉ	NPROP	-
ⲡⲁⲣⲟⲩⲥⲓⲁ	N	-
ⲡⲁⲣⲣϩⲏⲥⲓⲁⲍⲉ	V	-
ⲡⲁⲣⲣⲏⲥⲓⲁ	N	-
ⲡⲁⲣⲣⲏⲥⲓⲁⲍⲉ	V	-
ⲡⲁⲣⲣⲟⲩⲥⲓⲁ	N	-
ⲡⲁⲥ	N	-
ⲡⲁⲥⲧ	V	-
ⲡⲁⲥⲭⲁ	N	-
ⲡⲁⲥⲭⲱⲣ	NPROP	-
ⲡⲁⲧ	N	-
ⲡⲁⲧⲁⲥⲥⲉ	V	-
ⲡⲁⲧⲉⲓ	V	-
ⲡⲁⲧⲣⲓⲁⲣⲭⲏⲥ	N	-
ⲡⲁⲩⲗⲉ	NPROP	-
ⲡⲁⲩⲗⲟⲥ	NPROP	-
ⲡⲁⲱⲛⲉ	NPROP	-
ⲡⲃⲁⲩ	NPROP	-
ⲡⲉ	ART	-
ⲡⲉ	COP	-
ⲡⲉ	N	-
ⲡⲉϣ	V	-
ⲡⲉϣⲛ	V	-
ⲡⲉϣⲥ	V	-
ⲡⲉϥ	PPOS	-
ⲡⲉϩⲧ	V	-
ⲡⲉϫⲁ	VBD	-
ⲡⲉϫⲉ	VBD	-
ⲡⲉⲇⲉⲩⲉ	V	-
ⲡⲉⲇⲉⲩⲥⲓⲥ	N	-
ⲡⲉⲇⲏⲥ	N	-
ⲡⲉⲑⲁⲅⲟⲣⲁ	NPROP	-
ⲡⲉⲑⲁⲅⲟⲣⲁⲥ	NPROP	-
ⲡⲉⲑⲏⲡ	N	-
ⲡⲉⲑⲓⲧⲟⲩⲱ	N	-
ⲡⲉⲑⲟⲟⲩ	N	-
ⲡⲉⲓ	PDEM	-
ⲡⲉⲓⲑⲉ	V	-
ⲡⲉⲓⲣⲁⲍⲉ	V	-
ⲡⲉⲓⲣⲁⲥⲙⲟⲥ	N	-
ⲡⲉⲓⲣⲉ	V	-
ⲡⲉⲕ	PPOS	-
ⲡⲉⲗⲁⲅⲟⲥ	N	-
ⲡⲉⲙϫⲉ	NPROP	-
ⲡⲉⲛ	PPOS	-
ⲡⲉⲛⲓⲡⲉ	N	-
ⲡⲉⲡⲧⲉⲓ	V	-
ⲡⲉⲣϫ	V	-
ⲡⲉⲣⲁ	V	-
ⲡⲉⲣⲉ	V	-
ⲡⲉⲣⲓⲉⲣⲅⲟⲥ	N	-
ⲡⲉⲣⲓⲥⲡⲁⲥⲙⲟⲥ	N	-
ⲡⲉⲣⲥⲓⲥ	NPROP	-
ⲡⲉⲣⲥⲓⲧⲏⲥ	N	-
ⲡⲉⲣⲥⲟⲥ	NPROP	-
ⲡⲉⲥ	PPOS	-
#ⲡⲉⲧϣⲟⲩⲉⲓⲧ	N	-
#ⲡⲉⲧϣⲟⲩⲱⲟⲩ	N	-
#ⲡⲉⲧϩⲓⲧⲟⲩⲱ	N	-
#ⲡⲉⲧⲉϣϣⲉ	N	-
#ⲡⲉⲧⲉϩⲛⲁ	N	-
#ⲡⲉⲧⲉⲩⲉ	V	-
#ⲡⲉⲧⲉⲩⲥⲓⲥ	N	-
#ⲡⲉⲧⲙⲙⲁⲩ	N	-
#ⲡⲉⲧⲙⲟⲟⲩⲧ	N	-
ⲡⲉⲧⲛ	PPOS	-
#ⲡⲉⲧⲛⲁⲛⲟⲩϥ	N	-
#ⲡⲉⲧⲛⲁⲛⲟⲩⲟⲩ	N	-
#ⲡⲉⲧⲟⲩⲁⲁⲃ	N	-
ⲡⲉⲧⲣⲁ	NPROP	-
ⲡⲉⲧⲣⲟⲥ	NPROP	-
#ⲡⲉⲧⲥⲏϩ	N	-
#ⲡⲉⲧⲥⲟⲩⲧⲱⲛ	N	-
ⲡⲉⲩ	PPOS	-
ⲡⲉⲩϣⲟⲙⲛⲧ	ADV	-
ⲡⲏϣ	VSTAT	-
ⲡⲏϩ	VSTAT	-
ⲡⲏⲅⲏ	N	-
ⲡⲏⲟⲩⲉ	N	-
ⲡⲏⲧ	VSTAT	-
ⲡⲏⲩⲉ	N	-
ⲡⲓ	PDEM	-
ⲡⲓⲑⲁⲅⲟⲣⲁ	NPROP	-
ⲡⲓⲑⲁⲅⲟⲣⲁⲥ	NPROP	-
ⲡⲓⲑⲉ	V	-
ⲡⲓⲗⲁⲧⲟⲥ	V	-
ⲡⲓⲛⲁⲝ	N	-
ⲡⲓⲣⲁⲍⲉ	V	-
ⲡⲓⲣⲁⲥⲙⲟⲥ	N	-
ⲡⲓⲣⲉ	V	-
ⲡⲓⲥⲧⲉⲩⲉ	V	-
ⲡⲓⲥⲧⲏⲥ	N	-
ⲡⲓⲥⲧⲓⲥ	N	-
ⲡⲓⲥⲧⲟⲥ	N	-
ⲡⲓⲧⲧⲁ	NPROP	-
ⲡⲕⲱⲟⲩ	NPROP	-
ⲡⲗϭⲉ	N	-
ⲡⲗⲁϯⲁ	N	-
ⲡⲗⲁⲕⲟⲩⲧⲟⲛ	N	-
ⲡⲗⲁⲕⲩⲧⲟⲛ	N	-
ⲡⲗⲁⲕⲱⲧⲟⲛ	N	-
ⲡⲗⲁⲛⲁ	V	-
ⲡⲗⲁⲛⲏ	N	-
ⲡⲗⲁⲝ	N	-
ⲡⲗⲁⲥⲓⲥ	N	-
ⲡⲗⲁⲥⲙⲁ	N	-
ⲡⲗⲁⲥⲥⲉ	V	-
ⲡⲗⲁⲧⲉⲓⲁ	N	-
ⲡⲗⲁⲧⲓⲁ	N	-
ⲡⲗⲉⲟⲛⲉⲕⲧⲉⲓ	V	-
ⲡⲗⲉⲟⲛⲉⲕⲧⲏⲥ	N	-
ⲡⲗⲉⲟⲛⲉⲝⲓⲁ	N	-
ⲡⲗⲏⲅⲏ	N	-
ⲡⲗⲏⲛ	CONJ	-
ⲡⲗⲏⲣⲟⲫⲟⲣⲉⲓ	V	-
ⲡⲗⲏⲣⲟⲫⲟⲣⲓ	V	-
ⲡⲗⲏⲣⲟⲫⲟⲣⲓⲁ	N	-
ⲡⲗⲏⲣⲱⲙⲁ	N	-
ⲡⲛⲉⲩⲙⲁ	N	-
ⲡⲛⲉⲩⲙⲁⲧⲓⲕⲟⲛ	N	-
ⲡⲛⲉⲩⲙⲁⲧⲓⲕⲟⲥ	N	-
ⲡⲛⲉⲩⲙⲁⲧⲓⲕⲱⲥ	ADV	-
ⲡⲛⲉⲩⲙⲁⲧⲟⲫⲟⲣⲟⲥ	N	-
ⲡⲛⲟⲏ	N	-
ⲡⲟⲓⲏⲧⲏⲥ	N	-
ⲡⲟⲗⲉⲓⲥ	N	-
ⲡⲟⲗⲉⲙⲁⲣⲭⲏⲥ	N	-
ⲡⲟⲗⲉⲙⲉⲓ	V	-
ⲡⲟⲗⲉⲙⲓⲥⲧⲏⲥ	N	-
ⲡⲟⲗⲉⲙⲟⲥ	N	-
ⲡⲟⲗⲓⲥ	N	-
ⲡⲟⲗⲓⲧⲉⲓⲁ	N	-
ⲡⲟⲗⲓⲧⲉⲩⲉ	V	-
ⲡⲟⲗⲓⲧⲉⲩⲙⲁ	N	-
ⲡⲟⲗⲓⲧⲉⲩⲧⲏⲥ	N	-
ⲡⲟⲗⲓⲧⲓⲁ	N	-
ⲡⲟⲗⲗⲁⲕⲓⲥ	ADV	-
ⲡⲟⲗⲗⲩⲗⲟⲅⲟⲥ	N	-
ⲡⲟⲗⲩϯⲁ	N	-
ⲡⲟⲗⲩⲗⲟⲅⲟⲥ	N	-
ⲡⲟⲗⲩⲙⲉⲓ	V	-
ⲡⲟⲗⲩⲙⲟⲥ	N	-
ⲡⲟⲗⲩⲫⲁⲛⲏⲥ	NPROP	-
ⲡⲟⲛⲉⲣⲟⲥ	N	-
ⲡⲟⲛⲏⲣⲉⲩⲉ	V	-
ⲡⲟⲛⲏⲣⲓⲁ	N	-
ⲡⲟⲛⲏⲣⲟⲛ	N	-
ⲡⲟⲛⲏⲣⲟⲥ	N	-
ⲡⲟⲛⲧⲓⲟⲥ	NPROP	-
ⲡⲟⲟⲛ	V	-
ⲡⲟⲟⲛⲉ	V	-
ⲡⲟⲟⲩ	ADV	-
ⲡⲟⲟⲩⲛϩⲟⲟⲩ	ADV	-
ⲡⲟⲣϣ	VSTAT	-
ⲡⲟⲣϫ	V	-
ⲡⲟⲣϫ	VSTAT	-
ⲡⲟⲣⲕ	V	-
ⲡⲟⲣⲕⲉ	V	-
ⲡⲟⲣⲛⲉⲓⲁ	N	-
ⲡⲟⲣⲛⲉⲩⲉ	V	-
ⲡⲟⲣⲛⲏ	N	-
ⲡⲟⲣⲛⲓⲁ	N	-
ⲡⲟⲣⲫⲉⲣⲓⲟⲥ	NPROP	-
ⲡⲟⲣⲫⲏⲣⲁ	N	-
ⲡⲟⲣⲫⲏⲣⲓⲟⲥ	NPROP	-
ⲡⲟⲣⲫⲓⲣⲁ	N	-
ⲡⲟⲣⲫⲓⲣⲓⲟⲥ	NPROP	-
ⲡⲟⲣⲫⲩⲣⲁ	N	-
ⲡⲟⲣⲫⲩⲣⲓⲟⲥ	NPROP	-
ⲡⲟⲣⲭⲏⲣⲓⲁ	NPROP	-
ⲡⲟⲥⲉ	VSTAT	-
ⲡⲟⲥⲟⲙⲁⲗⲗⲟⲛ	ADV	-
ⲡⲟⲥⲱ	ADV	-
ⲡⲟⲧⲏⲣⲓⲟⲛ	N	-
ⲡⲟⲩ	PPOS	-
ⲡⲟⲩⲁⲇⲉⲡⲟⲩⲁ	N	-
ⲡⲟⲩⲁⲡⲟⲩⲁ	N	-
ⲡⲣϣ	V	-
ⲡⲣϫ	V	-
ⲡⲣϭⲟⲩϣ	NPROP	-
ⲡⲣⲁⲅⲇⲟⲥ	N	-
ⲡⲣⲁⲅⲙⲁⲧⲉⲩⲧⲏⲥ	N	-
ⲡⲣⲁⲅⲧⲟⲥ	N	-
ⲡⲣⲁⲓⲧⲁⲛⲓⲁ	N	-
ⲡⲣⲁⲓⲧⲱⲣⲓⲟⲛ	N	-
ⲡⲣⲁⲕⲇⲟⲥ	N	-
ⲡⲣⲁⲕⲧⲓⲕⲟⲛ	N	-
ⲡⲣⲁⲕⲧⲟⲥ	N	-
ⲡⲣⲁⲝⲓⲥ	N	-
ⲡⲣⲉⲓⲱⲟⲩ	VSTAT	-
ⲡⲣⲉⲡⲉⲓ	V	-
ⲡⲣⲉⲥⲃⲉⲩⲉ	V	-
ⲡⲣⲉⲥⲃⲩⲧⲉⲣⲟⲥ	N	-
ⲡⲣⲉⲥⲃⲩⲧⲏⲣⲟⲥ	N	-
ⲡⲣⲏϣ	N	-
ⲡⲣⲟϩⲁⲓⲣⲉⲥⲓⲥ	N	-
ⲡⲣⲟϩⲁⲓⲣⲏⲥⲓⲥ	N	-
ⲡⲣⲟϩⲉⲣⲉⲥⲓⲥ	N	-
ⲡⲣⲟϩⲉⲣⲏⲥⲓⲥ	N	-
ⲡⲣⲟⲅⲛⲱⲥⲧⲏⲥ	N	-
ⲡⲣⲟⲇⲓⲇⲟⲩ	V	-
ⲡⲣⲟⲇⲟⲥⲓⲁ	N	-
ⲡⲣⲟⲇⲣⲟⲙⲟⲥ	N	-
ⲡⲣⲟⲉⲗⲑⲉ	V	-
ⲡⲣⲟⲏⲗⲑⲉ	V	-
ⲡⲣⲟⲑⲉⲙⲓⲁ	N	-
ⲡⲣⲟⲑⲩⲙⲓⲁ	N	-
ⲡⲣⲟⲕⲟⲡⲏ	N	-
ⲡⲣⲟⲕⲟⲡⲧⲉⲓ	V	-
ⲡⲣⲟⲛⲓⲁ	N	-
ⲡⲣⲟⲛⲟⲓⲁ	N	-
ⲡⲣⲟⲥ	PREP	-
ⲡⲣⲟⲥⲇⲟⲕⲓⲁ	N	-
ⲡⲣⲟⲥⲉⲩⲭⲏ	N	-
ⲡⲣⲟⲥⲉⲭⲉ	V	-
ⲡⲣⲟⲥⲕⲁⲣⲧⲏⲣⲉ	V	-
ⲡⲣⲟⲥⲕⲁⲣⲧⲏⲣⲉⲓ	V	-
ⲡⲣⲟⲥⲕⲁⲣⲧⲩⲣⲉ	V	-
ⲡⲣⲟⲥⲕⲩⲛⲉⲓ	V	-
ⲡⲣⲟⲥⲟⲇⲟⲥ	N	-
ⲡⲣⲟⲥⲟⲡⲟⲛ	N	-
ⲡⲣⲟⲥⲟⲩⲕⲟⲩⲓ	ADV	-
ⲡⲣⲟⲥⲟⲩⲟⲩⲛⲟⲩ	ADV	-
ⲡⲣⲟⲥⲟⲩⲟⲩⲟⲉⲓϣ	ADV	-
ⲡⲣⲟⲥⲟⲩⲟⲩⲟⲓϣ	ADV	-
ⲡⲣⲟⲥⲧⲁⲅⲙⲁ	N	-
ⲡⲣⲟⲥⲧⲁⲥⲓⲁ	N	-
ⲡⲣⲟⲥⲫⲉⲣⲉⲓ	V	-
ⲡⲣⲟⲥⲫⲟⲣⲁ	N	-
ⲡⲣⲟⲥⲫⲱⲣⲁ	N	-
ⲡⲣⲟⲥⲱⲡⲟⲛ	N	-
ⲡⲣⲟⲧⲉⲣⲓⲟⲥ	NPROP	-
ⲡⲣⲟⲧⲣⲉⲡⲉ	V	-
ⲡⲣⲟⲧⲣⲉⲡⲧⲓⲕⲟⲛ	N	-
ⲡⲣⲟⲧⲣⲟⲡⲏ	N	-
ⲡⲣⲟⲫⲁⲥⲓⲥ	N	-
ⲡⲣⲟⲫⲏⲧⲉⲩⲉ	V	-
ⲡⲣⲟⲫⲏⲧⲏⲥ	N	-
ⲡⲣⲟⲫⲏⲧⲓⲁ	N	-
ⲡⲣⲱ	N	-
ⲡⲣⲱⲧⲟⲕⲟⲓⲙⲏⲗⲓⲁⲣⲭⲏⲥ	N	-
ⲡⲥⲟⲓ	NPROP	-
ⲡⲧ	V	-
ⲡⲩⲑⲁⲅⲟⲣⲁ	NPROP	-
ⲡⲩⲑⲁⲅⲟⲣⲁⲥ	NPROP	-
ⲡⲩⲗⲏ	N	-
ⲡⲩⲣⲅⲟⲥ	N	-
ⲡⲱϣ	V	-
ⲡⲱϣⲛ	V	-
ⲡⲱϣⲥ	V	-
ⲡⲱϩ	V	-
ⲡⲱϩⲥ	V	-
ⲡⲱϩⲧ	V	-
ⲡⲱϭⲉ	V	-
ⲡⲱⲗϩ	V	-
ⲡⲱⲗϭ	V	-
ⲡⲱⲛⲕ	V	-
ⲡⲱⲛⲩⲣⲓⲁ	N	-
ⲡⲱⲣϣ	V	-
ⲡⲱⲣϫ	V	-
ⲡⲱⲣⲕ	V	-
ⲡⲱⲥ	ADV	-
ⲡⲱⲧ	V	-
ⲡⲱⲧⲏⲣⲓⲟⲛ	N	-
ⲡⲱⲧⲥ	V	-
ⲡⲱⲱⲛⲉ	N	-
ⲡⲱⲱⲛⲉ	V	-
ⲡⲱⲱⲡⲉ	V	-
ⲡⲱⲱⲣⲉ	V	-
ⲣ	N	-
ⲣ	V	-
ⲣϣⲁ	V	-
ⲣϣⲁⲩ	V	-
ⲣϣⲙⲙⲟ	V	-
ⲣϣⲡⲏⲣⲉ	V	-
ⲣϣⲣⲡ	V	-
ⲣϥⲛⲧ	V	-
ⲣϩⲁⲗ	V	-
ⲣϩⲃⲁ	V	-
ⲣϩⲉ	V	-
ⲣϩⲗⲗⲟ	V	-
ⲣϩⲙⲙⲉ	V	-
ⲣϩⲛⲁ	V	-
ⲣϩⲟⲧⲉ	V	-
ⲣϩⲱⲃ	V	-
ⲣϫⲟⲉⲓⲥ	V	-
ⲣϫⲟⲓⲥ	V	-
ⲣϫⲟⲗⲉⲥ	V	-
ⲣϫⲟⲟⲗⲉⲥ	V	-
ⲣⲁϣⲉ	V	-
ⲣⲁϩⲧ	V	-
ⲣⲁϩⲧ	VSTAT	-
ⲣⲁⲕⲟⲧⲉ	NPROP	-
ⲣⲁⲕⲧⲟⲩ	V	-
ⲣⲁⲛ	N	-
ⲣⲁⲛⲁ	V	-
ⲣⲁⲛⲁϣ	V	-
ⲣⲁⲡⲁⲧⲟⲟⲧ	V	-
ⲣⲁⲡⲉ	V	-
ⲣⲁⲥⲟⲩ	N	-
ⲣⲁⲥⲧⲉ	N	-
ⲣⲁⲧ	N	-
ⲣⲁⲧϣⲁⲩ	V	-
ⲣⲁⲧⲥⲱⲧⲙ	V	-
ⲣⲉ	V	-
ⲣⲉϣⲧ	V	-
ⲣⲉϥϣⲁϫⲉ	N	-
ⲣⲉϥϣⲉⲙϣⲉⲉⲓⲇⲟⲗⲟⲛ	N	-
ⲣⲉϥϣⲉⲙϣⲉⲛⲟⲩⲧⲉ	N	-
ⲣⲉϥϣⲙϣⲉⲉⲓⲇⲱⲗⲟⲛ	N	-
ⲣⲉϥϣⲙϣⲉⲛⲟⲩⲧⲉ	N	-
ⲣⲉϥϣⲡϩⲓⲥⲉ	N	-
ⲣⲉϥϣⲱⲛⲉ	N	-
ⲣⲉϥϣⲱⲥ	N	-
ⲣⲉϥϩⲉⲧⲃⲛⲟⲩⲧⲉ	N	-
ⲣⲉϥϩⲉⲧⲃⲣⲱⲙⲉ	N	-
ⲣⲉϥϩⲉⲧⲃⲯⲩⲭⲏ	N	-
ⲣⲉϥϩⲱⲧⲃ	N	-
ⲣⲉϥϫⲉϭⲟⲗ	N	-
ⲣⲉϥϫⲉϭⲥⲟⲣⲧ	N	-
ⲣⲉϥϫⲓϣⲟϫⲛⲉ	N	-
ⲣⲉϥϫⲓϭⲟⲗ	N	-
ⲣⲉϥϫⲓⲛϭⲟⲛⲉⲥ	N	-
ⲣⲉϥϫⲓⲛϭⲟⲛⲥ	N	-
ⲣⲉϥϫⲣⲟ	N	-
ⲣⲉϥϯⲙⲛⲧⲛⲁ	N	-
ⲣⲉϥϯⲣⲁⲥⲟⲩ	N	-
ⲣⲉϥϯⲥⲃⲱ	N	-
ⲣⲉϥⲁⲣⲉⲥⲕⲉ	N	-
ⲣⲉϥⲇⲓⲁⲕⲟⲛⲉⲓ	N	-
ⲣⲉϥⲉⲓⲣⲉ	N	-
ⲣⲉϥⲉⲣϩⲟⲧⲉ	N	-
ⲣⲉϥⲉⲣⲛⲟⲃⲉ	N	-
ⲣⲉϥⲉⲣⲡⲁϩⲣⲉ	N	-
ⲣⲉϥⲉⲣⲡⲉⲑⲟⲟⲩ	N	-
ⲣⲉϥⲕⲁⲗⲉⲓ	N	-
ⲣⲉϥⲕⲁⲥⲕⲥ	N	-
ⲣⲉϥⲕⲁⲧⲁⲗⲁⲗⲉⲓ	N	-
ⲣⲉϥⲕⲣⲟⲙⲣⲉⲙ	N	-
ⲣⲉϥⲕⲣⲟⲙⲣⲙ	N	-
ⲣⲉϥⲗⲟⲕⲥ	N	-
ⲣⲉϥⲗⲱⲕⲥ	N	-
ⲣⲉϥⲙⲉⲩⲧ	N	-
ⲣⲉϥⲙⲓϣⲉ	N	-
ⲣⲉϥⲙⲟⲟⲛⲉ	N	-
ⲣⲉϥⲙⲟⲩⲟⲩⲧ	N	-
ⲣⲉϥⲙⲟⲩⲧⲉ	N	-
ⲣⲉϥⲡⲉϩⲧⲥⲛⲟϥ	N	-
ⲣⲉϥⲡⲉⲣⲉⲣⲁⲥⲟⲩ	N	-
ⲣⲉϥⲣϩⲙⲙⲉ	N	-
ⲣⲉϥⲣϩⲟⲧⲉ	N	-
ⲣⲉϥⲣⲉⲓⲟⲡⲉ	N	-
ⲣⲉϥⲣⲛⲟⲃⲉ	N	-
ⲣⲉϥⲣⲟⲩⲟⲉⲓⲛ	N	-
ⲣⲉϥⲣⲟⲩⲟⲓⲛ	N	-
ⲣⲉϥⲣⲡⲁϩⲣⲉ	N	-
ⲣⲉϥⲣⲡⲉⲑⲟⲟⲩ	N	-
ⲣⲉϥⲣⲱⲕϩ	N	-
ⲣⲉϥⲥⲉⲥⲛⲟϥ	N	-
ⲣⲉϥⲥⲩⲗⲁ	N	-
ⲣⲉϥⲥⲱⲛⲧ	N	-
ⲣⲉϥⲧⲁⲕⲉⲯⲩⲭⲏ	N	-
ⲣⲉϥⲧⲁⲗϭⲟ	N	-
ⲣⲉϥⲧⲁⲙⲉⲓⲟ	N	-
ⲣⲉϥⲧⲁⲙⲓⲟ	N	-
ⲣⲉϥⲧⲁⲛϩⲟ	N	-
ⲣⲉϥⲧⲃⲃⲟ	N	-
ⲣⲉϥⲧⲱⲣⲡ	N	-
ⲣⲉϥⲯⲁⲗⲗⲉⲓ	N	-
ⲣⲉϥⲱϣ	N	-
ⲣⲉϩⲧ	V	-
ⲣⲉⲕ	V	-
ⲣⲉⲕϩ	V	-
ⲣⲉⲕⲣⲓⲕⲉ	N	-
ⲣⲉⲙⲏⲧ	N	-
ⲣⲉⲙⲓⲟⲟⲩⲉ	N	-
ⲣⲉⲙⲣⲁϣ	N	-
ⲣⲏ	N	-
ⲣⲏⲥ	N	-
ⲣⲏⲧ	VSTAT	-
ⲣⲑⲉⲙ	V	-
ⲣⲑⲉⲛ	V	-
ⲣⲓ	N	-
ⲣⲓⲕⲉ	V	-
ⲣⲓⲙⲉ	N	-
ⲣⲓⲙⲉ	V	-
ⲣⲓⲣ	N	-
ⲣⲕⲁⲕⲉ	V	-
ⲣⲕⲣⲓⲕⲉ	N	-
ⲣⲙϩⲉ	N	-
ⲣⲙϩⲣⲱⲙⲏ	N	-
ⲣⲙⲉⲓⲏ	N	-
ⲣⲙⲙⲁⲟ	N	-
ⲣⲙⲛϩⲏⲧ	N	-
ⲣⲙⲛϩⲓⲏ	N	-
ⲣⲙⲛⲕⲁϩ	N	-
ⲣⲙⲛⲕⲏⲙⲉ	N	-
ⲣⲙⲛⲛⲟⲩⲧⲉ	N	-
ⲣⲙⲛⲧⲣⲉ	V	-
ⲣⲙⲡⲣϭⲟⲩϣ	N	-
ⲣⲙⲣⲁϣ	N	-
ⲣⲙⲣⲁⲕⲟⲧⲉ	N	-
ⲣⲙⲧⲁⲙⲙⲁ	N	-
ⲣⲙⲧⲁⲛⲇⲓⲟⲭⲓⲁ	N	-
ⲣⲛⲟϥⲣⲉ	V	-
ⲣⲛⲟⲃⲉ	V	-
ⲣⲛⲟⲃⲣⲉ	V	-
ⲣⲟ	N	-
ⲣⲟⲉⲓⲥ	V	-
ⲣⲟⲕϩ	V	-
ⲣⲟⲙⲡⲉ	N	-
ⲣⲟⲟⲩϣ	N	-
ⲣⲟⲟⲩⲧ	VSTAT	-
ⲣⲟⲩϩⲉ	N	-
ⲣⲟⲩⲟⲉⲓⲛ	V	-
ⲣⲟⲩⲟⲓⲛ	V	-
ⲣⲡⲃⲟⲗ	V	-
ⲣⲡⲉ	N	-
ⲣⲡⲏⲩⲉ	N	-
ⲣⲡⲙⲉⲉⲩⲉ	V	-
ⲣⲡⲱⲃϣ	V	-
ⲣⲣⲟ	N	-
ⲣⲣⲱ	N	-
ⲣⲣⲱⲟⲩ	N	-
ⲣⲧⲣⲟⲫⲏ	V	-
ⲣⲱ	N	-
ⲣⲱ	PTC	-
ⲣⲱϣⲉ	V	-
ⲣⲱϩⲉ	V	-
ⲣⲱϩⲧ	V	-
ⲣⲱⲕϩ	V	-
ⲣⲱⲙⲉ	N	-
ⲥ	PPERO	-
ⲥ	PPERS	-
ⲥϩⲁⲓ	V	-
ⲥϩⲓⲙⲉ	N	-
ⲥϩⲟⲩⲟⲣⲧ	VSTAT	-
ⲥϩⲟⲩⲱⲣ	V	-
ⲥϭⲣⲁϩⲧ	VSTAT	-
ⲥϯⲃⲱⲱⲛ	N	-
ⲥϯⲛⲟⲩϥⲉ	N	-
ⲥϯⲛⲟⲩⲃⲉ	N	-
ⲥⲁ	N	-
ⲥⲁϣϥ	N	-
ⲥⲁϣϥⲉ	N	-
ⲥⲁϣⲉ	VSTAT	-
ⲥⲁϣⲧ	VSTAT	-
ⲥⲁϩ	N	-
ⲥⲁϩ	V	-
ⲥⲁϩⲏⲩ	VSTAT	-
ⲥⲁϩⲟⲩ	N	-
ⲥⲁϩⲟⲩ	V	-
ⲥⲁϩⲱ	V	-
ⲥⲁⲁⲛϣ	V	-
ⲥⲁⲁⲧ	V	-
ⲥⲁⲃⲁ	NPROP	-
ⲥⲁⲃⲁⲱⲑ	NPROP	-
ⲥⲁⲃⲃⲁⲧⲟⲛ	N	-
ⲥⲁⲃⲃⲁⲧⲱⲛ	N	-
ⲥⲁⲃⲉ	N	-
ⲥⲁⲃⲉⲉⲩ	N	-
ⲥⲁⲃⲉⲗⲗⲓⲟⲥ	N	-
ⲥⲁⲃⲏ	N	-
ⲥⲁⲃⲟⲗ	ADV	-
ⲥⲁⲇⲁⲛⲁⲥ	N	-
ⲥⲁⲇⲱⲕ	NPROP	-
ⲥⲁⲉⲓⲛ	N	-
ⲥⲁⲗⲁⲑⲓⲏⲗ	NPROP	-
ⲥⲁⲗⲙⲱⲛ	NPROP	-
ⲥⲁⲗⲡⲓⲅⲝ	N	-
ⲥⲁⲗⲡⲓⲍⲉ	V	-
ⲥⲁⲙⲁⲣⲓⲧⲏⲥ	N	-
ⲥⲁⲛϣ	V	-
ⲥⲁⲛϩⲟⲩⲛ	N	-
ⲥⲁⲛⲃⲟⲗ	N	-
ⲥⲁⲟⲩⲗ	NPROP	-
ⲥⲁⲡⲓⲥⲁ	ADV	-
ⲥⲁⲣⲁⲅⲉⲛⲟⲥ	N	-
ⲥⲁⲣⲁⲡⲓⲟⲛ	NPROP	-
ⲥⲁⲣⲁⲡⲓⲱⲛ	NPROP	-
ⲥⲁⲣⲁⲫⲓⲛ	NPROP	-
ⲥⲁⲣⲇⲟⲛⲓⲗⲉ	NPROP	-
ⲥⲁⲣⲕⲓⲕⲏ	N	-
ⲥⲁⲣⲕⲓⲕⲟⲛ	N	-
ⲥⲁⲣⲕⲓⲕⲟⲥ	N	-
ⲥⲁⲣⲕⲓⲕⲱⲥ	ADV	-
ⲥⲁⲣⲝ	N	-
ⲥⲁⲣⲣⲁ	NPROP	-
ⲥⲁⲧ	N	-
ⲥⲁⲧⲁⲛⲁⲥ	NPROP	-
ⲥⲁⲧⲉ	N	-
ⲥⲃⲃⲉ	V	-
ⲥⲃⲟⲉⲓ	N	-
ⲥⲃⲟⲓ	N	-
ⲥⲃⲟⲟⲩⲉ	N	-
ⲥⲃⲟⲩⲓ	N	-
ⲥⲃⲧⲉ	V	-
ⲥⲃⲧⲱⲧ	V	-
ⲥⲃⲧⲱⲧ	VSTAT	-
ⲥⲃⲱ	N	-
ⲥⲉ	N	-
ⲥⲉ	NUM	-
ⲥⲉ	PPERO	-
ⲥⲉ	PPERS	-
ⲥⲉ	PTC	-
ⲥⲉ	V	-
ⲥⲉϣϥ	V	-
ⲥⲉϩ	V	-
ⲥⲉϭⲣⲁϩⲧ	VSTAT	-
ⲥⲉⲇⲉⲕⲓⲁⲥ	NPROP	-
ⲥⲉⲉⲡⲉ	V	-
ⲥⲉⲓ	V	-
ⲥⲉⲓⲛⲑⲏ	N	-
ⲥⲉⲗⲉⲩⲕⲓⲁ	NPROP	-
ⲥⲉⲙⲛⲟⲛ	N	-
ⲥⲉⲛⲛⲁⲭⲏⲣⲉⲓⲙ	NPROP	-
ⲥⲉⲛⲛⲁⲭⲏⲣⲓⲙ	NPROP	-
ⲥⲉⲛⲟⲩⲑⲓⲟⲥ	NPROP	-
ⲥⲉⲛⲟⲩⲑⲓⲟⲩ	NPROP	-
ⲥⲉⲛⲧⲉ	N	-
ⲥⲉⲡⲥⲡ	V	-
ⲥⲉⲡⲥⲱⲡ	V	-
ⲥⲉⲡⲥⲱⲡⲉ	V	-
ⲥⲉⲣⲁⲡⲓⲛ	NPROP	-
ⲥⲉⲣⲁⲡⲓⲥ	NPROP	-
ⲥⲉⲣⲁⲫⲓⲛ	NPROP	-
ⲥⲉⲧⲡ	V	-
ⲥⲉⲩϩ	V	-
ⲥⲉⲩⲏⲣⲓⲁⲛⲟⲥ	NPROP	-
ⲥⲉⲩⲏⲣⲟⲥ	NPROP	-
ⲥⲏϣ	VSTAT	-
ⲥⲏϥⲉ	N	-
ⲥⲏϩ	VSTAT	-
ⲥⲏϭ	VSTAT	-
ⲥⲏⲅⲱⲣ	NPROP	-
ⲥⲏⲏⲡⲉ	V	-
ⲥⲏⲙⲁⲛⲉ	V	-
ⲥⲏⲣ	VSTAT	-
ⲥⲏⲩ	N	-
ⲥⲓϣⲉ	N	-
ⲥⲓⲃⲧ	N	-
ⲥⲓⲕⲓⲙⲁ	NPROP	-
ⲥⲓⲙⲱⲛ	NPROP	-
ⲥⲓⲛⲁ	NPROP	-
ⲥⲓⲛⲃⲗϫⲉ	NPROP	-
ⲥⲓⲛⲟⲩⲑⲓⲟⲥ	NPROP	-
ⲥⲓⲛⲟⲩⲑⲓⲟⲩ	NPROP	-
ⲥⲓⲛⲟⲩⲥⲓⲁ	N	-
ⲥⲓⲟⲟⲩⲛ	N	-
ⲥⲓⲟⲟⲩⲧ	NPROP	-
ⲥⲓⲟⲩ	N	-
ⲥⲓⲟⲩⲣ	N	-
ⲥⲓⲱⲛ	NPROP	-
ⲥⲕⲁⲛⲇⲁⲗⲓⲍⲉ	V	-
ⲥⲕⲁⲛⲇⲁⲗⲟⲛ	N	-
ⲥⲕⲁⲫⲟⲥ	N	-
ⲥⲕⲉⲛⲏ	N	-
ⲥⲕⲉⲡⲁⲍⲉ	V	-
ⲥⲕⲉⲡⲧⲉ	V	-
ⲥⲕⲉⲡⲧⲉⲓ	V	-
ⲥⲕⲉⲡⲧⲱⲣ	N	-
ⲥⲕⲉⲣⲕⲱⲣ	V	-
ⲥⲕⲉⲣⲕⲱⲣⲉ	V	-
ⲥⲕⲉⲩⲉ	N	-
ⲥⲕⲉⲩⲏ	N	-
ⲥⲕⲉⲩⲟⲥ	N	-
ⲥⲕⲏⲛⲏ	N	-
ⲥⲕⲏⲡⲏ	N	-
ⲥⲕⲟⲡⲟⲥ	N	-
ⲥⲕⲟⲣⲕⲉⲣ	V	-
ⲥⲕⲟⲣⲕⲣ	V	-
ⲥⲕⲣⲕⲣ	V	-
ⲥⲕⲣⲱⲫⲁ	N	-
ⲥⲕⲩⲗⲗⲉⲓ	V	-
ⲥⲕⲩⲗⲙⲟⲥ	N	-
ⲥⲕⲩⲛⲏ	N	-
ⲥⲗⲁⲁⲧⲉ	V	-
ⲥⲗⲥⲱⲗ	V	-
ⲥⲙⲁⲙⲁⲁⲧ	VSTAT	-
ⲥⲙⲉⲛⲥⲉⲛⲧⲉ	V	-
ⲥⲙⲉⲛⲥⲛⲧⲉ	V	-
ⲥⲙⲏ	N	-
ⲥⲙⲓⲛⲉ	V	-
ⲥⲙⲙⲉ	N	-
ⲥⲙⲙⲉ	V	-
ⲥⲙⲛ	V	-
ⲥⲙⲛⲥⲉⲛⲧⲉ	V	-
ⲥⲙⲛⲧϥ	V	-
ⲥⲙⲟⲛⲧ	VSTAT	-
ⲥⲙⲟⲧ	N	-
ⲥⲙⲟⲩ	V	-
ⲥⲛⲁⲩ	N	-
ⲥⲛⲁⲩϩ	N	-
ⲥⲛⲏⲟⲩ	N	-
ⲥⲛⲏⲩ	N	-
ⲥⲛⲟϥ	N	-
ⲥⲛⲧⲉ	N	-
ⲥⲛⲱⲱϥ	N	-
ⲥⲟ	N	-
ⲥⲟϣ	V	-
ⲥⲟϣⲕ	V	-
ⲥⲟϩⲉ	V	-
ⲥⲟϭ	N	-
ⲥⲟⲃϩ	VSTAT	-
ⲥⲟⲃⲧ	N	-
ⲥⲟⲃⲧⲉ	V	-
ⲥⲟⲇⲟⲙⲁ	NPROP	-
ⲥⲟⲉⲓⲧ	N	-
ⲥⲟⲕ	V	-
ⲥⲟⲗⲟⲙⲱⲛ	NPROP	-
ⲥⲟⲗⲥⲉⲗ	V	-
ⲥⲟⲗⲥⲗ	V	-
ⲥⲟⲗⲱⲙⲱⲛ	NPROP	-
ⲥⲟⲛ	N	-
ⲥⲟⲛϩ	V	-
ⲥⲟⲛϩ	VSTAT	-
ⲥⲟⲛϩⲉ	V	-
ⲥⲟⲛⲧ	V	-
ⲥⲟⲛⲧⲉ	N	-
ⲥⲟⲟ	V	-
ⲥⲟⲟϥ	VSTAT	-
ⲥⲟⲟϩⲉ	V	-
ⲥⲟⲟⲛⲉ	N	-
ⲥⲟⲟⲧ	V	-
ⲥⲟⲟⲩ	N	-
ⲥⲟⲟⲩϩ	V	-
ⲥⲟⲟⲩϩ	VSTAT	-
ⲥⲟⲟⲩϩⲉ	N	-
ⲥⲟⲟⲩϩⲉϩⲟⲩⲛ	VSTAT	-
ⲥⲟⲟⲩϩⲛ	V	-
ⲥⲟⲟⲩϩⲥ	N	-
ⲥⲟⲟⲩⲛ	N	-
ⲥⲟⲟⲩⲛ	V	-
ⲥⲟⲟⲩⲛϣⲟ	N	-
ⲥⲟⲟⲩⲧⲛ	V	-
ⲥⲟⲡ	N	-
ⲥⲟⲡⲥ	V	-
ⲥⲟⲣ	V	-
ⲥⲟⲣⲙ	V	-
ⲥⲟⲣⲧ	N	-
ⲥⲟⲧ	V	-
ⲥⲟⲧⲃⲉϥ	N	-
ⲥⲟⲧⲉ	N	-
ⲥⲟⲧⲙ	V	-
ⲥⲟⲧⲙϥ	V	-
ⲥⲟⲧⲙⲉ	V	-
ⲥⲟⲧⲙⲉϥ	V	-
ⲥⲟⲧⲡ	V	-
ⲥⲟⲧⲡ	VSTAT	-
ⲥⲟⲩ	N	-
ⲥⲟⲩ	PPERO	-
ⲥⲟⲩⲁⲛ	NPROP	-
ⲥⲟⲩⲉⲛ	V	-
ⲥⲟⲩⲗⲱⲗ	VSTAT	-
ⲥⲟⲩⲛ	V	-
ⲥⲟⲩⲛⲛⲟⲥ	NPROP	-
ⲥⲟⲩⲟ	N	-
ⲥⲟⲩⲟⲛ	V	-
ⲥⲟⲩⲣⲉ	N	-
ⲥⲟⲩⲣⲉⲥ	NPROP	-
ⲥⲟⲩⲥⲁⲛⲛⲁ	NPROP	-
ⲥⲟⲩⲧⲛ	V	-
ⲥⲟⲩⲧⲱⲛ	VSTAT	-
ⲥⲟⲩⲱⲛ	V	-
ⲥⲟⲫⲓⲁ	N	-
ⲥⲟⲫⲓⲍⲉ	V	-
ⲥⲟⲫⲓⲥⲧⲏⲥ	N	-
ⲥⲟⲫⲟⲥ	N	-
ⲥⲡⲁⲑⲁⲣⲓⲟⲥ	N	-
ⲥⲡⲁⲧⲁⲗⲁ	V	-
ⲥⲡⲉⲗⲁⲓⲟⲛ	N	-
ⲥⲡⲉⲣⲙⲁ	N	-
ⲥⲡⲓⲣ	N	-
ⲥⲡⲗⲁⲅⲭⲛⲟⲛ	N	-
ⲥⲡⲗⲁⲭⲛⲟⲛ	N	-
ⲥⲡⲟⲛⲇⲏ	N	-
ⲥⲡⲟⲛⲇⲓⲗⲟⲛ	N	-
ⲥⲡⲟⲛⲧⲓⲗⲟⲛ	N	-
ⲥⲡⲟⲧⲟⲩ	N	-
ⲥⲡⲟⲩⲇⲁⲍⲉ	V	-
ⲥⲡⲟⲩⲇⲏ	N	-
ⲥⲡⲥⲱⲡ	V	-
ⲥⲡⲥⲱⲡⲉ	V	-
ⲥⲣϥⲉ	V	-
ⲥⲣⲟϥⲣϥ	V	-
ⲥⲣⲟϥⲣⲉϥ	V	-
ⲥⲧⲁⲁⲧⲉ	V	-
ⲥⲧⲁⲥⲓⲥ	N	-
ⲥⲧⲁⲩⲣⲟⲥ	N	-
ⲥⲧⲁⲩⲣⲟⲩ	V	-
ⲥⲧⲉⲣⲉⲟⲙⲁ	N	-
ⲥⲧⲉⲣⲉⲩⲙⲁ	N	-
ⲥⲧⲉⲣⲉⲱⲙⲁ	N	-
ⲥⲧⲉⲫⲁⲛⲟⲥ	NPROP	-
ⲥⲧⲉⲫⲁⲛⲟⲩ	V	-
ⲥⲧⲏⲣⲉⲟⲙⲁ	N	-
ⲥⲧⲏⲣⲉⲱⲙⲁ	N	-
ⲥⲧⲏⲫⲁⲛⲟⲥ	NPROP	-
ⲥⲧⲏⲫⲁⲛⲟⲩ	V	-
ⲥⲧⲓⲗⲓⲧⲉⲩⲉ	V	-
ⲥⲧⲟ	V	-
ⲥⲧⲟⲓ	N	-
ⲥⲧⲟⲓⲭⲉⲓⲟⲛ	N	-
ⲥⲧⲟⲓⲭⲓⲟⲛ	N	-
ⲥⲧⲟⲟⲩ	V	-
ⲥⲧⲣⲁⲧⲉⲓⲁ	N	-
ⲥⲧⲣⲁⲧⲉⲩⲙⲁ	N	-
ⲥⲧⲣⲁⲧⲏⲅⲟⲥ	N	-
ⲥⲧⲣⲁⲧⲏⲗⲁⲧⲏⲥ	N	-
ⲥⲧⲣⲁⲧⲓⲁ	N	-
ⲥⲧⲣⲁⲧⲟⲛⲓⲕⲟⲥ	NPROP	-
ⲥⲧⲣⲁⲧⲟⲡⲉⲇⲁⲣⲭⲟⲥ	N	-
ⲥⲧⲣⲁⲧⲟⲡⲉⲧⲁⲣⲭⲟⲥ	N	-
ⲥⲧⲣⲁⲧⲩⲗⲁⲧⲏⲥ	N	-
ⲥⲧⲣⲁⲧⲱⲣ	N	-
ⲥⲧⲩⲗⲏ	N	-
ⲥⲧⲩⲗⲗⲏ	N	-
ⲥⲧⲩⲗⲗⲟⲥ	N	-
ⲥⲧⲩⲗⲟⲥ	N	-
ⲥⲧⲱⲧ	V	-
ⲥⲩⲅⲅⲉⲛⲏⲥ	N	-
ⲥⲩⲅⲕⲗⲏⲧⲟⲥ	N	-
ⲥⲩⲗⲁ	V	-
ⲥⲩⲙⲁⲛⲉ	V	-
ⲥⲩⲙⲃⲟⲩⲗⲉⲩⲉ	V	-
ⲥⲩⲙⲫⲟⲛⲉⲓ	V	-
ⲥⲩⲙⲫⲱⲛⲉⲓ	V	-
ⲥⲩⲙⲫⲱⲛⲓⲁ	N	-
ⲥⲩⲛϩⲉⲇⲣⲓⲟⲛ	N	-
ⲥⲩⲛϩⲓⲥⲧⲁ	V	-
ⲥⲩⲛϩⲟⲇⲟⲥ	N	-
ⲥⲩⲛⲁⲅⲉ	V	-
ⲥⲩⲛⲁⲅⲱⲅⲏ	N	-
ⲥⲩⲛⲁⲓⲛⲉⲓ	V	-
ⲥⲩⲛⲁⲝⲓⲥ	N	-
ⲥⲩⲛⲅⲣⲁⲫⲉⲩⲥ	N	-
ⲥⲩⲛⲉⲓⲇⲏⲥⲓⲥ	N	-
ⲥⲩⲛⲉⲭⲉ	V	-
ⲥⲩⲛⲍⲏⲧⲏⲧⲏⲥ	N	-
ⲥⲩⲛⲏⲑⲓⲁ	N	-
ⲥⲩⲛⲏⲛⲉⲓ	V	-
ⲥⲩⲛⲕⲗⲏⲣⲟⲛⲟⲙⲟⲥ	N	-
ⲥⲩⲛⲕⲗⲏⲧⲟⲥ	N	-
ⲥⲩⲛⲟⲩⲥⲓⲁ	N	-
ⲥⲩⲛⲧⲁⲅⲙⲁ	N	-
ⲥⲩⲛⲧⲁⲕⲏ	N	-
ⲥⲩⲛⲧⲉⲗⲉⲓⲁ	N	-
ⲥⲩⲛⲧⲉⲗⲓⲁ	N	-
ⲥⲩⲛⲧⲉⲭⲉ	V	-
ⲥⲩⲛⲧⲉⲭⲓⲁ	N	-
ⲥⲩⲛⲧⲏⲭⲓⲁ	N	-
ⲥⲩⲛⲧⲩⲭⲉ	V	-
ⲥⲩⲣⲁ	V	-
ⲥⲩⲣⲓⲁ	NPROP	-
ⲥⲩⲥⲧⲣⲟⲫⲉⲓ	V	-
ⲥⲫⲣⲁⲅⲓⲍⲉ	V	-
ⲥⲭⲉⲇⲟⲛ	ADV	-
ⲥⲭⲉⲇⲱⲛ	ADV	-
ⲥⲭⲏⲙⲁ	N	-
ⲥⲭⲓⲍⲁ	N	-
ⲥⲭⲓⲥⲁ	N	-
ⲥⲭⲓⲥⲙⲁ	N	-
ⲥⲭⲟⲗⲁⲥⲧⲓⲕⲟⲥ	N	-
ⲥⲱ	V	-
ⲥⲱϣ	V	-
ⲥⲱϣϥ	V	-
ⲥⲱϣⲉ	N	-
ⲥⲱϣⲉⲙ	V	-
ⲥⲱϣⲙ	V	-
ⲥⲱϣⲧ	V	-
ⲥⲱϩ	N	-
ⲥⲱϩⲉ	V	-
ⲥⲱϩⲡ	V	-
ⲥⲱϩⲣ	V	-
ⲥⲱⲃϩ	V	-
ⲥⲱⲃⲁϩ	N	-
ⲥⲱⲃⲉ	V	-
ⲥⲱⲕ	V	-
ⲥⲱⲕⲣⲁⲧⲏⲥ	NPROP	-
ⲥⲱⲙⲁ	N	-
ⲥⲱⲙⲁⲁⲩⲱ	N	-
ⲥⲱⲙⲁⲕⲁⲓⲁⲓⲙⲁ	N	-
ⲥⲱⲙⲁⲕⲁⲓⲁⲓⲙⲁⲭⲣⲓⲥⲧⲟⲩ	N	-
ⲥⲱⲙⲁⲙⲛ	N	-
ⲥⲱⲙⲁⲧⲓⲕⲏ	N	-
ⲥⲱⲙⲁⲧⲓⲕⲟⲛ	N	-
ⲥⲱⲛϩ	V	-
ⲥⲱⲛⲉ	N	-
ⲥⲱⲛⲧ	V	-
ⲥⲱⲟⲩϩ	V	-
ⲥⲱⲟⲩϩⲉϩⲟⲩⲛ	V	-
ⲥⲱⲣ	V	-
ⲥⲱⲣⲉⲙ	V	-
ⲥⲱⲣⲙ	V	-
ⲥⲱⲧⲉ	V	-
ⲥⲱⲧⲏⲣ	N	-
ⲥⲱⲧⲏⲣⲓⲁ	N	-
ⲥⲱⲧⲏⲣⲓⲭⲟⲥ	NPROP	-
ⲥⲱⲧⲙ	V	-
ⲥⲱⲧⲡ	V	-
ⲥⲱⲫⲟⲥ	N	-
ⲥⲱⲱϥ	V	-
ⲧ	ART	-
ⲧ	PPERO	-
ⲧϩⲟ	V	-
ⲧϩⲧⲱϩ	VSTAT	-
ⲧϭⲁⲉⲓⲟ	V	-
ⲧϭⲁⲓⲟ	V	-
ⲧⲁ	ACONJ_PPERS	-
ⲧⲁ	PPOS	-
ⲧⲁϣⲉ	V	-
ⲧⲁϣⲉⲟⲉⲓϣ	V	-
ⲧⲁϣⲟ	V	-
ⲧⲁϩ	V	-
ⲧⲁϩⲉ	V	-
ⲧⲁϩⲉ	VSTAT	-
ⲧⲁϩⲏⲩ	VSTAT	-
ⲧⲁϩⲙ	V	-
ⲧⲁϩⲙ	VSTAT	-
ⲧⲁϩⲙⲉ	V	-
ⲧⲁϩⲙⲉ	VSTAT	-
ⲧⲁϩⲛⲟ	V	-
ⲧⲁϩⲟ	V	-
ⲧⲁϩⲥ	V	-
ⲧⲁϩⲭ	V	-
ⲧⲁϩⲱⲙ	NPROP	-
ⲧⲁϫⲣⲉ	V	-
ⲧⲁϫⲣⲏⲩ	VSTAT	-
ⲧⲁϫⲣⲟ	V	-
ⲧⲁϭⲥⲉ	N	-
ⲧⲁⲁ	V	-
ⲧⲁⲁⲧⲉ	V	-
ⲧⲁⲅⲙⲁ	N	-
ⲧⲁⲉⲓⲏⲩ	VSTAT	-
ⲧⲁⲉⲓⲟ	V	-
ⲧⲁⲉⲓⲟⲛⲧⲉⲑⲉ	CONJ	-
ⲧⲁⲉⲓⲟⲛⲧⲉⲧϩⲉ	CONJ	-
ⲧⲁⲓ	PDEM	-
ⲧⲁⲓⲏⲩ	VSTAT	-
ⲧⲁⲓⲟ	V	-
ⲧⲁⲓⲟⲛⲧⲉⲑⲉ	ADV	-
ⲧⲁⲓⲟⲛⲧⲉⲧϩⲉ	CONJ	-
ⲧⲁⲓⲟⲩ	N	-
ⲧⲁⲓⲧⲉⲑⲉ	ADV	-
ⲧⲁⲓⲧⲉⲑⲉⲛ	PREP	-
ⲧⲁⲕⲉ	V	-
ⲧⲁⲕⲏⲩ	VSTAT	-
ⲧⲁⲕⲟ	V	-
ⲧⲁⲗϭⲉ	V	-
ⲧⲁⲗϭⲟ	V	-
ⲧⲁⲗⲁⲓⲡⲟⲣⲉⲓ	V	-
ⲧⲁⲗⲁⲓⲡⲟⲣⲟⲥ	N	-
ⲧⲁⲗⲁⲓⲡⲱⲣⲉⲓ	V	-
ⲧⲁⲗⲁⲓⲡⲱⲣⲟⲥ	N	-
ⲧⲁⲗⲉⲡⲟⲣⲉⲓ	V	-
ⲧⲁⲗⲉⲡⲱⲣⲉⲓ	V	-
ⲧⲁⲗⲏⲩ	VSTAT	-
ⲧⲁⲗⲟ	V	-
ⲧⲁⲗⲟⲉϩⲣⲁⲓ	V	-
ⲧⲁⲙⲁⲥⲕⲟⲥ	NPROP	-
ⲧⲁⲙⲉ	V	-
ⲧⲁⲙⲉⲓⲉ	V	-
ⲧⲁⲙⲉⲓⲟ	V	-
ⲧⲁⲙⲉⲓⲟⲛ	N	-
ⲧⲁⲙⲓⲉ	V	-
ⲧⲁⲙⲓⲟ	V	-
ⲧⲁⲙⲙⲁ	NPROP	-
ⲧⲁⲙⲟ	V	-
ⲧⲁⲙⲱ	V	-
ⲧⲁⲛϩⲉ	V	-
ⲧⲁⲛϩⲉⲧ	V	-
ⲧⲁⲛϩⲟ	V	-
ⲧⲁⲛϩⲟⲩⲧ	V	-
ⲧⲁⲛϯⲟⲭⲓⲁ	NPROP	-
ⲧⲁⲛⲇⲓⲟⲭⲓⲁ	NPROP	-
ⲧⲁⲛⲟⲩⲃⲓⲥ	NPROP	-
ⲧⲁⲛⲧⲓⲟⲭⲓⲁ	NPROP	-
ⲧⲁⲝⲓⲥ	N	-
ⲧⲁⲝⲓⲱⲧⲏⲥ	N	-
ⲧⲁⲟⲩⲉ	V	-
ⲧⲁⲟⲩⲟ	V	-
ⲧⲁⲡⲣⲟ	N	-
ⲧⲁⲣⲁⲥⲥⲉ	V	-
ⲧⲁⲣⲁⲭⲏ	N	-
ⲧⲁⲣⲉ	AFUTCONJ	-
ⲧⲁⲣⲕⲟ	V	-
ⲧⲁⲣⲥⲟⲥ	NPROP	-
ⲧⲁⲣⲧⲁⲣⲟⲥ	N	-
ⲧⲁⲥⲭⲓⲥⲁ	N	-
ⲧⲁⲩⲉ	V	-
ⲧⲁⲩⲟ	V	-
ⲧⲁⲫⲟⲥ	N	-
ⲧⲁⲭⲏ	ADV	-
ⲧⲃⲁ	N	-
ⲧⲃⲃⲉ	V	-
ⲧⲃⲃⲏⲩ	VSTAT	-
ⲧⲃⲃⲟ	N	-
ⲧⲃⲃⲟ	V	-
ⲧⲃⲏⲣ	N	-
ⲧⲃⲛⲏ	N	-
ⲧⲃⲛⲟⲟⲩⲉ	N	-
ⲧⲃⲧ	N	-
ⲧⲉ	ART	-
ⲧⲉ	COP	-
ⲧⲉ	PPERO	-
ⲧⲉ	PPERS	-
ⲧⲉϥ	PPOS	-
ⲧⲉϩⲛⲉ	V	-
ⲧⲉϩⲧⲱϩ	VSTAT	-
ⲧⲉⲃⲥ	V	-
ⲧⲉⲃⲧ	N	-
ⲧⲉⲓ	PDEM	-
ⲧⲉⲓϩⲉ	ADV	-
ⲧⲉⲓⲙⲓⲛⲉ	N	-
ⲧⲉⲕ	PPOS	-
ⲧⲉⲕⲙ	V	-
ⲧⲉⲗϯⲗⲉ	N	-
ⲧⲉⲗⲉⲓⲟⲥ	N	-
ⲧⲉⲗⲏⲗ	V	-
ⲧⲉⲗⲟⲥ	N	-
ⲧⲉⲗⲱⲛⲏⲥ	N	-
ⲧⲉⲗⲱⲛⲓⲟⲛ	N	-
ⲧⲉⲛ	PPOS	-
ⲧⲉⲛⲛⲟⲟⲩ	V	-
ⲧⲉⲛⲛⲟⲟⲩⲥ	V	-
ⲧⲉⲛⲟⲩ	ADV	-
ⲧⲉⲛⲧⲏⲩⲧⲛ	V	-
ⲧⲉⲛⲧⲱⲛⲧ	V	-
ⲧⲉⲣⲟⲙⲡⲉ	ADV	-
ⲧⲉⲣⲱⲧ	NPROP	-
ⲧⲉⲣⲱⲧⲁϣⲁⲛⲥ	NPROP	-
ⲧⲉⲥ	PPOS	-
#ⲧⲉⲧⲙⲟⲟⲩⲧ	N	-
ⲧⲉⲧⲛ	PPERS	-
ⲧⲉⲧⲛ	PPOS	-
ⲧⲉⲧⲣⲁⲡⲩⲗⲟⲛ	N	-
ⲧⲉⲩ	PPOS	-
ⲧⲉⲩⲧⲉⲣⲟⲛⲟⲙⲓⲟⲛ	N	-
ⲧⲉⲭⲛⲏ	N	-
ⲧⲉⲭⲛⲓⲧⲏⲥ	N	-
ⲧⲉⲱⲥ	ADV	-
ⲧⲏ	N	-
ⲧⲏϣ	VSTAT	-
ⲧⲏⲃⲧ	N	-
ⲧⲏⲏⲃⲉ	N	-
ⲧⲏⲕ	VSTAT	-
ⲧⲏⲕⲛϩⲏⲧ	VSTAT	-
ⲧⲏⲛϩ	N	-
ⲧⲏⲣ	IMOD	-
ⲧⲏⲣϥ	N	-
ⲧⲏⲣⲏⲃ	NPROP	-
ⲧⲏⲩ	N	-
ⲧⲏⲩⲧⲛ	PPERO	-
ⲧⲓϩⲉ	ADV	-
ⲧⲓⲙⲁⲓⲟⲥ	NPROP	-
ⲧⲓⲙⲉ	N	-
ⲧⲓⲙⲏ	N	-
ⲧⲓⲙⲓⲛⲉ	N	-
ⲧⲓⲙⲟⲑⲉⲟⲥ	NPROP	-
ⲧⲓⲙⲟⲣⲉⲓ	V	-
ⲧⲓⲙⲟⲣⲉⲓⲁ	N	-
ⲧⲓⲙⲟⲣⲓ	V	-
ⲧⲓⲙⲟⲣⲓⲁ	N	-
ⲧⲓⲙⲱⲣⲉⲓ	V	-
ⲧⲓⲙⲱⲣⲉⲓⲁ	N	-
ⲧⲓⲙⲱⲣⲓ	V	-
ⲧⲓⲙⲱⲣⲓⲁ	N	-
ⲧⲓⲡⲉ	N	-
ⲧⲓⲣⲱⲛ	N	-
ⲧⲕⲁⲥ	N	-
ⲧⲕⲱⲟⲩ	NPROP	-
ⲧⲗϯⲗⲉ	N	-
ⲧⲗⲧⲓⲗⲉ	N	-
ⲧⲙ	NEG	-
ⲧⲙⲁⲉⲓⲏⲩ	VSTAT	-
ⲧⲙⲁⲓⲏⲩ	VSTAT	-
ⲧⲙⲁⲓⲟ	V	-
ⲧⲙⲁⲓⲟⲕ	V	-
ⲧⲙⲙⲟ	V	-
ⲧⲙⲟ	V	-
ⲧⲛ	PPERO	-
ⲧⲛ	PPERS	-
ⲧⲛϩ	N	-
ⲧⲛⲛⲟⲟⲩ	V	-
ⲧⲛⲧⲱⲛ	V	-
ⲧⲛⲧⲱⲛ	VSTAT	-
ⲧⲟ	N	-
ⲧⲟ	VSTAT	-
ⲧⲟϣ	N	-
ⲧⲟϣ	V	-
ⲧⲟϭ	V	-
ⲧⲟϭⲉ	V	-
ⲧⲟⲃⲥ	V	-
ⲧⲟⲉⲓⲥ	N	-
ⲧⲟⲉⲓⲧ	N	-
ⲧⲟⲉⲓⲧ	V	-
ⲧⲟⲓⲥ	N	-
ⲧⲟⲕ	VSTAT	-
ⲧⲟⲕⲙ	VSTAT	-
ⲧⲟⲗⲉⲙⲁⲓⲟⲥ	NPROP	-
ⲧⲟⲗⲉⲙⲉⲟⲥ	NPROP	-
ⲧⲟⲗⲙⲁ	V	-
ⲧⲟⲗⲙⲏⲣⲓⲁ	N	-
ⲧⲟⲗⲟⲙⲁ	V	-
ⲧⲟⲗⲟⲙⲁⲓⲟⲥ	NPROP	-
ⲧⲟⲗⲟⲙⲉⲟⲥ	NPROP	-
ⲧⲟⲙⲟⲥ	N	-
ⲧⲟⲙⲥ	V	-
ⲧⲟⲙⲥ	VSTAT	-
ⲧⲟⲛⲧⲉⲛ	V	-
ⲧⲟⲛⲧⲛ	V	-
ⲧⲟⲝⲟⲧⲏⲥ	N	-
ⲧⲟⲟⲃ	V	-
ⲧⲟⲟⲃⲉ	VSTAT	-
ⲧⲟⲟⲧ	N	-
ⲧⲟⲟⲩ	N	-
ⲧⲟⲟⲩⲉ	N	-
ⲧⲟⲡⲟⲥ	N	-
ⲧⲟⲣϩ	VSTAT	-
ⲧⲟⲣⲡ	V	-
ⲧⲟⲧⲉ	ADV	-
ⲧⲟⲩ	PPOS	-
ⲧⲟⲩϩⲱ	NPROP	-
ⲧⲟⲩϫⲉ	V	-
ⲧⲟⲩϫⲏⲩ	VSTAT	-
ⲧⲟⲩϫⲟ	V	-
ⲧⲟⲩⲉⲓⲏ	N	-
ⲧⲟⲩⲉⲓⲟ	V	-
ⲧⲟⲩⲓⲟ	V	-
ⲧⲟⲩⲛⲉⲉⲓⲁⲁ	V	-
ⲧⲟⲩⲛⲉⲉⲓⲁⲁⲧ	V	-
ⲧⲟⲩⲛⲉⲓⲁⲧ	V	-
ⲧⲟⲩⲛⲉⲥ	V	-
ⲧⲟⲩⲛⲟⲥ	V	-
ⲧⲟⲩⲟⲟⲧⲉ	N	-
ⲧⲟⲩⲟⲧⲉ	N	-
ⲧⲟⲩⲣⲏⲥ	N	-
ⲧⲟⲩⲱⲧ	N	-
ⲧⲣⲁⲡⲉⲍⲁ	N	-
ⲧⲣⲉ	ACAUS	-
ⲧⲣⲓⲁⲥ	N	-
ⲧⲣⲟⲙⲟⲥ	N	-
ⲧⲣⲟⲡⲟⲥ	N	-
ⲧⲣⲟⲫⲏ	N	-
ⲧⲣⲩⲫⲁ	V	-
ⲧⲣⲱⲫⲏ	N	-
ⲧⲥⲁⲃⲉⲓⲁ	V	-
ⲧⲥⲁⲃⲓⲁ	V	-
ⲧⲥⲁⲃⲟ	V	-
ⲧⲥⲁⲉⲓⲟ	V	-
ⲧⲥⲁⲓⲟ	V	-
ⲧⲥⲁⲛⲉ	V	-
ⲧⲥⲁⲛⲟ	V	-
ⲧⲥⲁⲛⲟⲥ	V	-
ⲧⲥⲉ	V	-
ⲧⲥⲉⲓⲁ	V	-
ⲧⲥⲉⲓⲟ	V	-
ⲧⲥⲉⲛⲕⲟ	V	-
ⲧⲥⲓⲉ	V	-
ⲧⲥⲓⲟ	V	-
ⲧⲥⲛⲕⲟ	V	-
ⲧⲥⲟ	V	-
ⲧⲥⲧⲉ	V	-
ⲧⲥⲧⲏⲩ	VSTAT	-
ⲧⲥⲧⲟ	V	-
ⲧⲩⲡⲟⲥ	N	-
ⲧⲩⲣⲁⲛⲛⲟⲥ	N	-
ⲧⲩⲣⲁⲛⲟⲥ	NPROP	-
ⲧⲩⲣⲟⲥ	NPROP	-
ⲧⲱϣ	V	-
ⲧⲱϩ	V	-
ⲧⲱϩⲙ	N	-
ⲧⲱϩⲙ	V	-
ⲧⲱϭ	V	-
ⲧⲱϭⲉ	V	-
ⲧⲱϭⲛ	V	-
ⲧⲱϭⲥ	V	-
ⲧⲱⲃϩ	V	-
ⲧⲱⲃⲉ	V	-
ⲧⲱⲃⲥ	V	-
ⲧⲱⲕ	V	-
ⲧⲱⲕⲙ	V	-
ⲧⲱⲕⲛϩⲏⲧ	V	-
ⲧⲱⲕⲥ	V	-
ⲧⲱⲗⲙ	V	-
ⲧⲱⲗⲱⲙⲁ	V	-
ⲧⲱⲙ	V	-
ⲧⲱⲙⲛⲧ	V	-
ⲧⲱⲙⲣⲱ	V	-
ⲧⲱⲙⲥ	V	-
ⲧⲱⲙⲧ	V	-
ⲧⲱⲛ	ADV	-
ⲧⲱⲛ	N	-
ⲧⲱⲛⲟⲩ	ADV	-
ⲧⲱⲟⲩⲛ	V	-
ⲧⲱⲡⲟⲥ	N	-
ⲧⲱⲣⲡ	V	-
ⲧⲱⲥ	V	-
ⲧⲱⲧ	N	-
ⲧⲱⲧⲛϩⲏⲧ	V	-
ⲧⲱⲱⲃⲉ	V	-
ⲧⲱⲱⲙⲉ	V	-
ⲩ	ART	-
ⲩ	PPERO	-
ⲩ	PPERS	-
ⲩϣⲏ	N	-
ⲩϣⲟⲟⲩⲉ	N	-
ⲩϩⲟⲟⲣ	N	-
ⲩϩⲟⲣ	N	-
ⲩⲛ	EXIST	-
ⲩⲛⲟⲩ	N	-
ⲩⲛⲧ	EXIST	-
ⲩⲛⲧⲁ	EXIST	-
ⲩⲛⲧⲉ	EXIST	-
ⲩⲟⲉⲓϣ	N	-
ⲫⲁⲛⲉⲣⲟⲛ	ADV	-
ⲫⲁⲣⲁⲱ	NPROP	-
ⲫⲁⲣⲉⲥ	NPROP	-
ⲫⲁⲣⲓⲥⲁⲓⲟⲥ	N	-
ⲫⲁⲧⲏⲣ	N	-
ⲫⲁⲩⲥⲧⲟⲥ	NPROP	-
ⲫⲏⲗⲓⲝ	NPROP	-
ⲫⲑⲟⲛⲉⲓ	V	-
ⲫⲑⲟⲛⲏⲣⲟⲥ	N	-
ⲫⲑⲟⲛⲟⲥ	N	-
ⲫⲓⲁⲗⲏ	N	-
ⲫⲓⲃ	NPROP	-
ⲫⲓⲗⲁⲣⲭⲏⲥ	N	-
ⲫⲓⲗⲓⲡⲡⲟⲥ	NPROP	-
ⲫⲓⲗⲟⲕⲁⲗⲟⲥ	N	-
ⲫⲓⲗⲟⲡⲟⲛⲓⲁ	N	-
ⲫⲓⲗⲟⲡⲟⲛⲟⲥ	N	-
ⲫⲓⲗⲟⲥⲟⲫⲉⲓ	V	-
ⲫⲓⲗⲟⲥⲟⲫⲓⲁ	N	-
ⲫⲓⲗⲟⲥⲟⲫⲟⲥ	N	-
ⲫⲓⲛⲉⲉⲥ	NPROP	-
ⲫⲟⲣⲉⲓ	V	-
ⲫⲟⲣⲓ	V	-
ⲫⲟⲣⲟⲥ	N	-
ⲫⲣⲁⲅⲉⲗⲗⲟⲩ	V	-
ⲫⲣⲟⲛⲉⲓ	V	-
ⲫⲩⲗⲁⲝ	N	-
ⲫⲩⲗⲓⲝ	NPROP	-
ⲫⲩⲥⲉⲓ	ADV	-
ⲫⲩⲥⲓⲕⲏ	N	-
ⲫⲩⲥⲓⲕⲟⲛ	N	-
ⲫⲩⲥⲓⲥ	N	-
ⲫⲱⲃ	N	-
ⲫⲱⲛⲏ	N	-
ⲫⲱⲣⲉⲓ	V	-
ⲫⲱⲥⲧⲏⲣ	N	-
ⲭⲁⲉⲓⲣⲉ	PTC	-
ⲭⲁⲓⲣⲉ	PTC	-
ⲭⲁⲓⲣⲉⲧⲉ	PTC	-
ⲭⲁⲗⲁ	V	-
ⲭⲁⲗⲁⲍⲁ	N	-
ⲭⲁⲗⲁⲛⲏ	NPROP	-
ⲭⲁⲗⲇⲁⲓⲟⲥ	N	-
ⲭⲁⲗⲓⲛⲟⲥ	N	-
ⲭⲁⲗⲕⲉⲇⲱⲛ	NPROP	-
ⲭⲁⲗⲕⲏⲇⲱⲛ	NPROP	-
ⲭⲁⲗⲕⲩⲇⲱⲛ	NPROP	-
ⲭⲁⲛⲁⲁⲛ	NPROP	-
ⲭⲁⲛⲁⲛⲁⲓⲁ	NPROP	-
ⲭⲁⲣⲓⲍⲉ	V	-
ⲭⲁⲣⲓⲥ	N	-
ⲭⲁⲣⲓⲥⲙⲁ	N	-
ⲭⲁⲣⲧⲏⲥ	N	-
ⲭⲉⲓⲙⲁⲣⲣⲟⲥ	N	-
ⲭⲉⲓⲣⲟⲧⲟⲛⲉⲓ	V	-
ⲭⲉⲓⲣⲟⲧⲟⲛⲓⲁ	N	-
ⲭⲉⲣⲟⲩⲃⲓⲙ	N	-
ⲭⲏⲣⲁ	N	-
ⲭⲓⲣⲟⲇⲟⲛⲓⲁ	N	-
ⲭⲓⲱⲛ	N	-
ⲭⲓⲱⲛⲟⲥ	N	-
ⲭⲗⲉⲩⲁⲍⲉ	V	-
ⲭⲟⲓⲁⲭ	NPROP	-
ⲭⲟⲣⲁ	N	-
ⲭⲟⲣⲉⲅⲉⲓ	V	-
ⲭⲟⲣⲉⲩⲉ	V	-
ⲭⲟⲣⲏⲅⲓⲁ	N	-
ⲭⲟⲣⲟⲥ	N	-
ⲭⲟⲣⲧⲟⲥ	N	-
ⲭⲟⲣⲩⲅⲉⲓ	V	-
ⲭⲟⲩⲥ	N	-
ⲭⲣⲉⲓⲁ	N	-
ⲭⲣⲉⲓⲥⲧⲓⲁⲛⲟⲥ	N	-
ⲭⲣⲉⲱⲥⲧⲉⲓ	V	-
ⲭⲣⲏⲙⲁ	N	-
ⲭⲣⲏⲙⲁϯⲕⲟⲛ	N	-
ⲭⲣⲏⲙⲁⲧⲓⲍⲉ	V	-
ⲭⲣⲏⲙⲁⲧⲓⲕⲟⲛ	N	-
ⲭⲣⲏⲥϯⲁⲛⲟⲥ	N	-
ⲭⲣⲏⲥⲓⲙⲟⲛ	N	-
ⲭⲣⲏⲥⲓⲙⲱⲛ	N	-
ⲭⲣⲏⲥⲧⲓⲁⲛⲟⲥ	N	-
ⲭⲣⲏⲥⲧⲟⲥ	N	-
ⲭⲣⲏⲱⲥⲧⲓ	V	-
ⲭⲣⲓⲁ	N	-
ⲭⲣⲓⲥϯⲁⲛⲟⲥ	N	-
ⲭⲣⲓⲥⲧⲓⲁⲛⲏ	NPROP	-
ⲭⲣⲓⲥⲧⲓⲁⲛⲟⲥ	N	-
ⲭⲣⲓⲥⲧⲟⲥ	N	-
ⲭⲣⲓⲥⲧⲟⲥ	NPROP	-
ⲭⲣⲟⲛⲟⲥ	N	-
ⲭⲣⲩⲥⲓⲥ	N	-
ⲭⲣⲩⲱⲥⲧⲉ	V	-
ⲭⲣⲱ	V	-
ⲭⲣⲱⲙⲁ	N	-
ⲭⲱⲣⲁ	N	-
ⲭⲱⲣⲁⲩⲗⲏⲥ	N	-
ⲭⲱⲣⲉⲩⲉ	V	-
ⲭⲱⲣⲏⲃ	NPROP	-
ⲭⲱⲣⲏⲅⲉⲓ	V	-
ⲭⲱⲣⲏⲅⲓⲁ	N	-
ⲭⲱⲣⲏⲙⲁ	N	-
ⲭⲱⲣⲓⲥ	PREP	-
ⲯⲁⲗⲉⲓ	V	-
ⲯⲁⲗⲗⲉⲓ	V	-
ⲯⲁⲗⲙⲟⲥ	N	-
ⲯⲁⲗⲙⲱⲇⲟⲥ	N	-
ⲯⲉⲩⲇⲟⲡⲁⲣⲑⲉⲛⲟⲥ	N	-
ⲯⲏⲫⲓⲥⲙⲁ	N	-
ⲯⲏⲫⲟⲥ	N	-
ⲯⲓⲥ	N	-
ⲯⲓⲧⲉ	N	-
ⲯⲩⲫⲓⲥⲙⲁ	N	-
ⲯⲩⲫⲟⲥ	N	-
ⲯⲩⲭⲏ	N	-
ⲯⲩⲭⲓⲕⲟⲛ	N	-
ⲯⲩⲭⲟⲟⲩⲉ	N	-
ⲱ	PTC	-
ⲱϣ	V	-
ⲱϣⲉⲃⲟⲗ	V	-
ⲱϩⲉ	V	-
ⲱϩⲥⲉ	V	-
ⲱϫⲛ	V	-
ⲱϭⲃ	V	-
ⲱϭⲉⲃ	V	-
ⲱϭⲧ	V	-
ⲱⲃϣ	V	-
ⲱⲕⲙ	V	-
ⲱⲗⲉⲙ	V	-
ⲱⲗⲙ	V	-
ⲱⲙⲥ	V	-
ⲱⲛϣ	V	-
ⲱⲛϩ	N	-
ⲱⲛϩ	V	-
ⲱⲛⲉ	N	-
ⲱⲛⲉⲙⲙⲉ	N	-
ⲱⲡ	V	-
ⲱⲣϫ	V	-
ⲱⲣⲉϫ	V	-
ⲱⲣⲓⲅⲉⲛⲏⲥ	NPROP	-
ⲱⲣⲕ	V	-
ⲱⲣⲙ	V	-
ⲱⲥϭ	V	-
ⲱⲥⲏⲉ	NPROP	-
ⲱⲥⲕ	V	-
ⲱⲧⲡ	V	-
ⲱⲫⲉⲗⲉⲓ	V	-
ⲻ	PUNCT	-
ϣⲱⲡⲉ	V	-
ϯ	V	-
ⲣ	V	-
ϫⲟⲟ	V	-
ⲉⲓ	V	-
ϫⲓ	V	-
ⲉⲓⲣⲉ	V	-
ⲕⲱ	V	-
ⲥⲱⲧⲙ	V	-
ⲕⲁ	V	-
ⲕⲧⲟ	V	-
ⲉⲓⲙⲉ	V	-
ⲙⲓϣⲉ	V	-
ⲙⲉⲣⲉ	V	-
ⲧⲁⲕⲟ	V	-
ⲙⲟⲟϣⲉ	V	-
ⲥⲁϩⲟⲩ	V	-
ⲣⲛⲟⲃⲉ	V	-
ϫⲱ	V	-
ⲛⲁⲩ	V	-
ϫⲱϩⲙ	V	-
ⲙⲕⲁϩ	V	-
ⲣϩⲟⲧⲉ	V	-
ⲛⲕⲟⲧⲕ	V	-
ϩⲉ	V	-
ϭⲱ	V	-
ϫⲡⲟ	V	-
ϫⲱⲕ	V	-
ⲧⲁⲙⲟ	V	-
ⲉⲧⲉⲣⲉ	V	-
ⲗⲩⲡⲉⲓ	V	-
ⲙⲟⲩⲧⲉ	V	-
ⲣⲕⲁⲕⲉ	V	-
ⲥⲟⲟⲩⲛ	V	-
ⲧⲛⲧⲱⲛ	V	-
ⲧⲱⲱⲃⲉ	V	-
ⲡⲁⲣⲁⲃⲁ	V	-
ⲣⲭⲣⲉⲓⲁ	V	-
ⲥⲁⲛⲟⲩϣ	V	-
ϥⲓ	V	-
ⲥⲣ	V	-
ϣⲱⲡ	V	-
ϩⲱⲡ	V	-
ⲃⲱⲕ	V	-
ⲙⲟⲩ	V	-
ⲥⲱϣ	V	-
ⲡⲱⲧ	V	-
ⲧⲱⲧ	V	-
ϣⲁϫⲉ	V	-
ϣⲁⲣⲉ	V	-
ϣⲓⲛⲉ	V	-
ϣⲟⲕϩ	V	-
ⲣϩⲱⲃ	V	-
ⲙⲡϣⲁ	V	-
ⲕⲱⲧⲉ	V	-
ⲙⲁⲧⲉ	V	-
ⲣⲱϩⲧ	V	-
ⲟⲩⲱϣ	V	-
ⲥⲙⲟⲩ	V	-
ⲥⲱⲱϥ	V	-
ⲧⲁⲙⲱ	V	-
ϩⲟⲟⲩϣ	V	-
ϫⲓⲟⲩⲉ	V	-
ⲣϩⲟⲩⲟ	V	-
ⲃⲟⲟⲛⲉ	V	-
ⲙⲉϣϣⲉ	V	-
ⲕⲱⲗⲩⲉ	V	-
ⲙⲁⲩⲁⲧ	V	-
ⲙⲉⲉⲩⲉ	V	-
ⲙⲟⲥⲧⲉ	V	-
ⲛⲉⲃⲟⲗ	V	-
ⲟⲩⲁϩⲙ	V	-
ⲟⲩⲱⲛϩ	V	-
ⲡⲱⲱⲛⲉ	V	-
ⲧⲁⲙⲓⲉ	V	-
ⲧⲁⲙⲓⲟ	V	-
ⲧⲥⲁⲃⲱ	V	-
ⲧⲱⲟⲩⲛ	V	-
ⲉⲝⲁⲡⲁⲧⲁ	V	-
ⲙⲉⲗⲉⲧⲁ	V	-
ⲟⲩⲟⲓⲉϣ	V	-
ⲥⲗⲁⲁⲧⲉ	V	-
ⲥⲣⲙⲣⲱⲙ	V	-
ⲧⲁⲩⲟⲩⲟ	V	-
ⲧⲛⲛⲟⲟⲩ	V	-
ⲧⲟⲩⲛⲟⲥ	V	-
ⲕⲁⲧⲁⲫⲣⲟⲛⲉⲓ	V	-
ⲫⲑⲟⲛⲉⲓ	V	-
ϩⲟⲙⲟⲗⲟⲅⲉⲓ	V	-
ϣϭⲙϭⲟⲙ	V	-
ϥⲟ	V	-
ϫⲉ	V	-
ϫⲟ	V	-
ⲁⲁ	V	-
ⲉⲡ	V	-
ⲙⲉ	V	-
ϣⲟⲡ	V	-
ϣⲱⲗ	V	-
ϩⲉⲡ	V	-
ϩⲕⲟ	V	-
ϫⲓⲧ	V	-
ϫⲛⲉ	V	-
ϭⲓⲛ	V	-
ⲕⲁⲁ	V	-
ⲕⲉⲧ	V	-
ⲧⲟϣ	V	-
ⲧⲱϣ	V	-
ⲟⲩⲉ	V	-
ⲥⲉⲓ	V	-
ⲧⲁⲁ	V	-
ⲧⲥⲟ	V	-
ϣⲁⲁⲧ	V	-
ϣⲁⲣⲱ	V	-
ϣⲓⲃⲉ	V	-
ϣⲓⲕⲉ	V	-
ϣⲗⲏⲗ	V	-
ϣⲱⲛⲉ	V	-
ϣⲱⲱⲧ	V	-
ϩⲱⲣⲡ	V	-
ϫⲉⲣⲱ	V	-
ϫⲓⲧⲉ	V	-
ϫⲟⲟⲩ	V	-
ϫⲡⲓⲟ	V	-
ⲉϣϣⲉ	V	-
ⲣϩⲁϩ	V	-
ⲣϩⲛⲁ	V	-
ⲉⲓⲁⲧ	V	-
ⲉⲓⲃⲉ	V	-
ⲑⲙⲕⲟ	V	-
ⲗⲩⲡⲏ	V	-
ⲣⲱϣⲉ	V	-
ⲙⲧⲟⲛ	V	-
ⲛⲟⲩϫ	V	-
ⲟⲩⲁϩ	V	-
ⲟⲩⲉϣ	V	-
ⲟⲩⲉϩ	V	-
ⲟⲩⲱϩ	V	-
ⲡⲱⲣϫ	V	-
ⲣⲥⲟϭ	V	-
ⲥⲁⲛϣ	V	-
ⲥⲟⲧⲡ	V	-
ⲥⲱⲣⲙ	V	-
ⲥⲱⲧⲡ	V	-
ⲧⲁⲓⲉ	V	-
ⲧⲁⲓⲟ	V	-
ⲧⲁⲕⲉ	V	-
ⲧⲁⲙⲉ	V	-
ⲧⲙⲙⲟ	V	-
ⲧⲥⲧⲟ	V	-
ⲱⲟⲟⲡ	V	-
ϩⲟϫϩϫ	V	-
ϣⲉⲡϣⲡ	V	-
ϭⲙϭⲟⲙ	V	-
ϫⲟⲡϫⲡ	V	-
ⲙⲉⲧⲁⲛⲟⲉⲓ	V	-
ⲧϭⲁⲓⲉ	V	-
ⲛⲟⲩⲧⲉ	N	-
ϩⲉ	N	-
ⲙⲁ	N	-
ϩⲏⲧ	N	-
ⲣⲱⲙⲉ	N	-
ϫⲟⲉⲓⲥ	N	-
ϩⲱⲃ	N	-
ⲗⲁⲁⲩ	N	-
ϣⲁϫⲉ	N	-
ϩⲟⲟⲩ	N	-
ⲙⲁⲁⲩ	N	-
ϩⲃⲏⲩⲉ	N	-
ⲉⲓⲱⲧ	N	-
ⲕⲁⲕⲉ	N	-
ⲟⲩⲟⲉⲓⲛ	N	-
ⲥⲟⲛ	N	-
ⲉⲓⲟⲧⲉ	N	-
ϣⲏⲣⲉ	N	-
ⲧⲟⲟⲧ	N	-
ⲙⲉⲉⲩⲉ	N	-
ⲩϣⲏ	N	-
ϫⲁϫⲉ	N	-
ϩⲗⲗⲟ	N	-
ⲛⲟⲃⲉ	N	-
ⲟⲩⲱϣ	N	-
ⲥⲛⲏⲩ	N	-
ⲡⲟⲛⲏⲣⲟⲛ	N	-
ⲡⲟⲛⲏⲣⲟⲥ	N	-
ⲁⲧⲥⲃⲱ	N	-
ⲅⲣⲁⲫⲏ	N	-
ⲉⲛⲧⲟⲗⲏ	N	-
ⲙⲉⲉⲣⲉ	N	-
ϩⲛⲁ	N	-
ⲛⲟϭ	N	-
ⲱⲛϩ	N	-
ϩⲏⲃⲥ	N	-
ϫⲣⲟⲡ	N	-
ⲕⲣⲟϥ	N	-
ⲙⲕⲁϩ	N	-
ⲙⲏⲧⲉ	N	-
ⲡⲟⲛⲏⲣⲓⲁ	N	-
ⲕⲟⲟⲩⲉ	N	-
ⲙⲉⲣⲓⲧ	N	-
ⲧⲁⲡⲣⲟ	N	-
ⲕⲟⲥⲙⲟⲥ	N	-
ⲙⲛⲧⲥⲟϭ	N	-
ⲛⲩⲕⲧⲉⲣⲓⲥ	N	-
ⲉⲡⲓⲥⲧⲏⲙⲏ	N	-
ⲉⲡⲓⲥⲧⲟⲗⲏ	N	-
ⲥⲩⲛⲁⲅⲱⲅⲏ	N	-
ϩⲛⲟ	N	-
ⲃⲟⲗ	N	-
ⲥⲃⲱ	N	-
ⲥⲟⲡ	N	-
ⲧⲱⲧ	N	-
ϣⲟⲣⲡ	N	-
ϭⲱⲛⲧ	N	-
ⲉⲟⲟⲩ	N	-
ⲉⲣⲏⲩ	N	-
ⲗⲁⲟⲥ	N	-
ⲟⲩⲟⲛ	N	-
ϣⲉⲉⲣⲉ	N	-
ϩⲛⲁⲁⲩ	N	-
ϩⲟⲟⲩⲧ	N	-
ⲥϩⲓⲙⲉ	N	-
ⲙⲛⲧⲁⲅⲁⲑⲟⲥ	N	-
ⲁⲧϩⲏⲧ	N	-
ⲙⲛⲧⲁⲧⲥⲱⲧⲙ	N	-
ⲥⲁϩⲟⲩ	N	-
ⲡⲁⲑⲟⲥ	N	-
ⲧⲉⲗⲱⲛⲏⲥ	N	-
ϫⲓϫⲉⲉⲩⲉ	N	-
ϩⲉⲑⲛⲓⲕⲟⲥ	N	-
ⲭⲁⲣⲧⲏⲥ	N	-
ⲡⲁⲣⲑⲉⲛⲟⲥ	N	-
ⲙⲉ	N	-
ϣⲏⲙ	N	-
ϩⲧⲏ	N	-
ϭⲟⲗ	N	-
ⲣⲁⲧ	N	-
ⲣⲡⲉ	N	-
ϩⲏⲧⲛ	N	-
ϩⲓⲥⲉ	N	-
ϩⲟⲩⲟ	N	-
ϭⲟⲛⲥ	N	-
ⲇⲓⲕⲁⲓⲟⲥ	N	-
ⲉⲛⲉϩ	N	-
ⲉⲥⲏⲧ	N	-
ⲡⲁϣⲉ	N	-
ⲙⲧⲟⲛ	N	-
ⲥⲏϥⲉ	N	-
ⲟⲩⲟⲓ	N	-
ⲟⲩⲱⲧ	N	-
ⲥⲁⲃⲉ	N	-
ⲧⲁⲙⲟ	N	-
ⲧⲃⲃⲟ	N	-
ⲟⲩⲉⲣⲏⲧⲉ	N	-
ϫⲓⲛϫⲏ	N	-
ϩⲉⲛⲉⲉⲧⲏ	N	-
ⲁⲅⲁⲑⲟⲥ	N	-
ⲁⲛⲁⲅⲕⲏ	N	-
ⲁⲛⲟⲙⲓⲁ	N	-
ⲃⲟⲏⲑⲟⲥ	N	-
ⲃⲁⲣⲟⲥ	N	-
ⲉⲥⲟⲟⲩ	N	-
ⲉⲧⲉⲣⲉ	N	-
ⲕⲗⲁϥⲧ	N	-
ⲕⲟⲙⲉⲥ	N	-
ⲗⲉⲗⲟⲩ	N	-
ⲙⲏⲏϣⲉ	N	-
ⲥⲁϩⲛⲉ	N	-
ⲛⲁⲓⲁⲧ	N	-
ⲛⲟⲩϭⲥ	N	-
ⲟⲩⲣⲟⲧ	N	-
ⲡⲗⲏⲅⲏ	N	-
ⲣⲁⲥⲟⲩ	N	-
ⲥⲟⲫⲟⲥ	N	-
ⲧⲁⲙⲟⲓ	N	-
ⲁⲡⲟⲫⲁⲥⲓⲥ	N	-
ⲙⲛⲧⲁⲧⲛⲟⲩⲧⲉ	N	-
ⲥⲁⲣⲕⲓⲕⲟⲛ	N	-
ⲁⲡⲟⲥⲧⲟⲗⲟⲥ	N	-
ⲧⲓⲙⲱⲣⲓⲁ	N	-
ⲙⲛⲧⲣⲉϥⲧⲱϩ	N	-
ⲟⲩⲟⲉⲓϣ	N	-
ⲡⲓⲥⲧⲟⲥ	N	-
ⲡⲛⲉⲩⲙⲁ	N	-
ⲣⲙⲛϩⲏⲧ	N	-
ⲥⲃⲟⲟⲩⲉ	N	-
ⲥⲟⲡ[.]	N	-
ⲥⲡⲟⲧⲟⲩ	N	-
ⲙⲛⲧⲣⲙⲛϩⲏⲧ	N	-
ⲃⲁⲩⲕⲁⲗⲓⲟⲛ	N	-
ⲙⲛⲧⲧⲉⲗⲓⲟⲥ	N	-
ⲃⲁⲥⲕⲁⲛⲟⲥ	N	-
ⲙⲛⲧϫⲱⲱⲣⲉ	N	-
ⲙⲛⲧⲃⲁⲃⲉⲣⲱⲙⲉ	N	-
ⲇⲓⲁⲃⲟⲗⲟⲥ	N	-
ⲙⲛⲧⲣⲉϥϯϭⲱⲛⲧ	N	-
ⲇⲓⲁⲕⲟⲛⲓⲁ	N	-
ⲣⲉϥⲣⲛⲟⲃⲉ	N	-
ⲙⲛⲧϩⲁⲡⲗⲟⲩⲥ	N	-
ⲁⲧⲛⲟⲩⲧⲉ	N	-
ⲡⲁⲣⲣⲏⲥⲓⲁ	N	-
ⲡⲣⲟⲫⲏⲧⲏⲥ	N	-
ϯ	N	-
ⲛ	N	-
ⲥ	N	-
ϩⲟ	N	-
ⲏⲓ	N	-
ⲡⲉ	N	-
ⲣⲱ	N	-
ⲥⲟ	N	-
ⲧⲓ	N	-
ⲧⲟ	N	-
ϣϥⲉ	N	-
ϣⲁϩ	N	-
ϣⲟϣ	N	-
ϩⲟϥ	N	-
ϭⲓϫ	N	-
ϣⲏⲓ	N	-
ϩⲱⲥ	N	-
ϭⲟⲙ	N	-
ⲁⲩⲱ	N	-
ⲃⲁⲗ	N	-
ⲏⲣⲡ	N	-
ⲛⲉϩ	N	-
ⲙⲁⲓ	N	-
ⲙⲟⲩ	N	-
ⲙⲧⲟ	N	-
ⲥⲟϭ	N	-
ⲛⲙⲙ	N	-
ⲟⲩⲉ	N	-
ⲣⲁⲛ	N	-
ⲣⲙⲏ	N	-
ⲱⲣϫ	N	-
ⲧⲱⲛ	N	-
ϫⲱϩⲙ	N	-
ϣⲓⲛⲉ	N	-
ϣⲙⲙⲟ	N	-
ϣⲟⲟⲩ	N	-
ϩⲁⲁⲩ	N	-
ϩⲟⲩo	N	-
ϩⲗⲗⲱ	N	-
ϩⲟⲧⲉ	N	-
ϩⲟⲩⲛ	N	-
ϫⲁⲓⲉ	N	-
ϯⲧⲱⲛ	N	-
ⲭⲣⲓⲥⲧⲟⲥ	N	-
ⲥⲕⲉⲡⲁⲥⲧⲏⲥ	N	-
ⲇⲓⲕⲁⲓⲟⲛ	N	-
ⲁⲑⲏⲧ	N	-
ⲁⲓⲱⲛ	N	-
ⲃⲗⲗⲉ	N	-
ⲃⲗⲗⲏ	N	-
ⲙⲡϣⲁ	N	-
ⲙⲓⲛⲉ	N	-
ⲥⲁϣϥ	N	-
ⲙⲟⲩⲥ	N	-
ⲥⲓϣⲉ	N	-
ⲟⲛⲧⲉ	N	-
ⲟⲩⲉϣ	N	-
ⲟⲣⲅⲏ	N	-
ⲟⲩⲱⲙ	N	-
ⲡⲏⲅⲏ	N	-
ⲡⲣⲏϣ	N	-
ⲥⲁⲣⲝ	N	-
ⲥⲛⲟϥ	N	-
ⲥⲙⲙⲉ	N	-
ⲥⲙⲟⲧ	N	-
ⲥⲱⲙⲁ	N	-
ⲉⲗⲁⲭⲓⲥⲧⲟⲛ	N	-
ⲯⲩⲭⲏ	N	-
ⲙⲛⲧⲣⲉϥϩⲓⲗⲁ	N	-
ⲙⲛⲧⲁⲧⲥⲃⲱ	N	-
ⲙⲛⲧⲛⲟⲩⲧⲉ	N	-
ⲙⲛⲧⲥⲧⲙⲏⲧ	N	-
ϣⲟⲩϣⲟⲩ	N	-
ⲕⲟⲓⲛⲱⲛⲟⲥ	N	-
ϩⲟⲉⲓⲧⲉ	N	-
ⲟⲓⲕⲟⲩⲙⲉⲛⲏ	N	-
ⲥⲧⲉⲣⲉⲱⲙⲁ	N	-
ⲙⲛⲧⲣⲉϥϩⲉⲧⲃⲯⲩⲭⲏ	N	-
ϣⲟϫⲛⲉ	N	-
ϩⲏⲏⲛⲉ	N	-
ϩⲓⲟⲛⲉ	N	-
ϩⲗⲗⲟⲓ	N	-
ϩⲟⲟⲗⲉ	N	-
ϩⲟⲥⲟⲛ	N	-
ϫⲓⲟⲩⲉ	N	-
ϭⲗⲱⲡⲉ	N	-
ⲡⲁⲣⲁⲇⲉⲓⲥⲟⲥ	N	-
ⲡⲁⲛⲟⲩⲣⲅⲓⲁ	N	-
ⲙⲛⲧϫⲁⲥⲓϩⲏⲧ	N	-
ⲥⲕⲁⲛⲇⲁⲗⲟⲛ	N	-
ϩⲩⲡⲟⲧⲁⲅⲏ	N	-
ⲙⲉⲥⲟⲩⲁⲫⲓ	N	-
ⲣϩⲙⲙⲉ	N	-
ⲁⲅⲁⲑⲟⲛ	N	-
ⲁⲅⲅⲓⲟⲛ	N	-
ⲃⲟⲏⲑⲓⲁ	N	-
ⲓⲏⲥⲟⲩⲥ	NPROP	-
ⲓⲱϩⲁⲛⲛⲏⲥ	NPROP	-
ⲓⲁⲕⲱⲃ	NPROP	-
ⲥⲁⲧⲁⲛⲁⲥ	NPROP	-
ⲥⲓⲙⲱⲛ	NPROP	-
ⲓⲁⲕⲱⲃⲟⲥ	NPROP	-
ⲁⲃⲣⲁϩⲁⲙ	NPROP	-
ⲓⲥⲁⲁⲕ	NPROP	-
ⲭⲣⲓⲥⲧⲟⲥ	NPROP	-
ϩⲏⲣⲱⲇⲏⲥ	NPROP	-
ⲅⲁⲗⲓⲗⲁⲓⲁ	NPROP	-
ϩⲣⲁⲭⲏⲗ	NPROP	-
ⲥⲁⲣⲣⲁ	NPROP	-
ϩⲣⲉⲃⲉⲕⲕⲁ	NPROP	-
ⲍⲉⲃⲉⲇⲁⲓⲟⲥ	NPROP	-
ⲏⲥⲁⲩ	NPROP	-
ⲏⲥⲁⲓⲁⲥ	NPROP	-
ⲓⲟⲣⲇⲁⲛⲏⲥ	NPROP	-
ϩⲓⲉⲣⲟⲥⲟⲗⲩⲙⲁ	NPROP	-
ⲙⲱⲩⲥⲏⲥ	NPROP	-
ⲁⲛⲇⲣⲉⲁⲥ	NPROP	-
ⲡⲁⲩⲗⲟⲥ	NPROP	-
ϩⲏⲣⲱⲇⲓⲁⲥ	NPROP	-
ⲫⲓⲗⲓⲡⲡⲟⲥ	NPROP	-
ⲁⲛⲛⲁ	NPROP	-
ⲁⲫⲑⲟⲛⲓⲁ	NPROP	-
ⲓⲟⲩⲇⲁⲥ	NPROP	-
ⲓⲥⲣⲁⲏⲗ	NPROP	-
ϩⲓⲉⲣⲟⲩⲥⲁⲗⲏⲙ	NPROP	-
ⲡⲉⲧⲣⲟⲥ	NPROP	-
ⲕⲁⲫⲁⲣⲛⲁⲟⲩⲙ	NPROP	-
ⲃⲁⲗⲗⲁ	NPROP	-
ⲓⲟⲩⲇⲁⲓⲁ	NPROP	-
ⲉⲩϩⲁ	NPROP	-
ⲓⲱⲥⲏ	NPROP	-
ⲍⲉⲗⲫⲁ	NPROP	-
ⲑⲱⲙⲁⲥ	NPROP	-
ⲓⲟⲩⲇⲁ	NPROP	-
ⲓⲱⲥⲏⲫ	NPROP	-
ⲙⲁⲣⲓⲁ	NPROP	-
ⲓⲥⲙⲁⲏⲗ	NPROP	-
ⲡⲉⲧⲣⲁ	NPROP	-
ⲓⲱϩⲁⲛⲏⲥ	NPROP	-
ⲧⲩⲣⲟⲥ	NPROP	-
ⲉⲗⲓⲥⲁⲃⲉⲧ	NPROP	-
ⲓⲱⲥⲓⲁⲥ	NPROP	-
ⲡⲣⲟⲥⲟⲩⲟⲉⲓϣ	NPROP	-
ⲕⲁⲣⲡⲟⲥ	NPROP	-
ⲇⲉⲃⲃⲱⲣⲁ	NPROP	-
ϩⲏⲗⲉⲓⲁⲥ	NPROP	-
ⲟⲇⲟⲗⲗⲁ	NPROP	-
ⲇⲁⲩⲉⲓⲇ	NPROP	-
ⲥⲉⲛⲟⲩⲑⲓⲟⲩ	NPROP	-
ⲃⲁⲣⲑⲟⲗⲟⲙⲁⲓⲟⲥ	NPROP	-
ⲫⲁⲛⲟⲩⲏⲗ	NPROP	-
ⲓⲉⲣⲉⲙⲓⲁⲥ	NPROP	-
ⲇⲓⲁⲃⲟⲗⲟⲥ	NPROP	-
ⲓⲉⲍⲉⲕⲓⲥⲣⲁⲏⲗ	NPROP	-
ⲗⲓⲁ	NPROP	-
ⲛⲟⲏ	NPROP	-
ⲃⲉⲛⲓⲁⲙⲓⲛ	NPROP	-
ⲥⲁⲙⲯⲱⲛ	NPROP	-
ⲁⲃⲓⲁⲑⲁⲣ	NPROP	-
ⲧⲁⲗⲉⲓⲑⲁ	NPROP	-
ⲛⲁⲍⲁⲣⲉⲑ	NPROP	-
ⲁⲗⲉⲝⲁⲛⲇⲣⲟⲥ	NPROP	-
ⲛ	PREP	-
ⲉ	PREP	-
ⲙ	PREP	-
ⲙⲛ	PREP	-
ϩⲛ	PREP	-
ⲙⲙⲟ	PREP	-
ⲛⲁ	PREP	-
ⲉⲣⲟ	PREP	-
ϩⲙ	PREP	-
ⲉⲧⲃⲉ	PREP	-
ⲕⲁⲧⲁ	PREP	-
ⲛⲙⲙⲁ	PREP	-
ⲛϩⲏⲧ	PREP	-
ϩⲓ	PREP	-
ⲛⲥⲱ	PREP	-
ⲛⲧⲉ	PREP	-
ϩⲓⲧⲙ	PREP	-
ϫⲓⲛ	PREP	-
ⲛⲥⲁ	PREP	-
ϩⲁ	PREP	-
ⲛⲏ	PREP	-
ⲛⲙ	PREP	-
ⲉϫⲱ	PREP	-
ⲉϫⲛ	PREP	-
ⲉⲧⲃⲏⲏⲧ	PREP	-
ϣⲁ	PREP	-
ⲉⲣⲱ	PREP	-
ⲙⲙⲱ	PREP	-
ϩⲓϫⲛ	PREP	-
ϩⲁⲣⲟ	PREP	-
ϩⲁⲧⲛ	PREP	-
ⲉⲣⲁⲧ	PREP	-
ⲛⲙⲙ	PREP	-
ϩⲁⲣⲁⲧ	PREP	-
ϩⲓϫⲱ	PREP	-
ⲉⲧⲟⲟⲧ	PREP	-
ⲛⲧⲟⲟⲧ	PREP	-
ⲉϫⲙ	PREP	-
ϩⲓϫⲙ	PREP	-
ⲙⲛⲛⲥⲁ	PREP	-
ϣⲁⲣⲟ	PREP	-
ϣⲁⲣⲱ	PREP	-
ϩⲓⲱⲱ	PREP	-
ⲁϫⲛ	PREP	-
ϩⲁⲧⲏ	PREP	-
ϩⲓⲧⲛ	PREP	-
ϩⲓⲧⲟⲩⲱ	PREP	-
ⲉⲧⲃⲏⲏ	PREP	-
ⲛⲙⲙⲏ	PREP	-
ⲛⲁϩⲣⲛ	PREP	-
ⲙⲛⲛⲥⲱ	PREP	-
ϩⲓⲱ	PREP	-
ϩⲁϩⲧⲏ	PREP	-
ⲉϩⲟⲩⲉ	PREP	-
ϩⲁⲣⲱ	PREP	-
ϩⲁⲧⲉ	PREP	-
ϩⲓⲣⲙ	PREP	-
ⲉϩⲣⲁ	PREP	-
ⲟⲩⲃⲏ	PREP	-
ⲧⲟⲟⲧ	PREP	-
ⲭⲱⲣⲓⲥ	PREP	-
ϫⲓ	PREP	-
ϩⲣⲁⲓ	PREP	-
ϩⲓⲧⲟⲟⲧ	PREP	-
ⲛϩⲧⲏ	PREP	-
ⲣⲣⲙⲙⲁⲟ	V	-
ⲉⲫⲣⲉⲙ	NPROP	-
ⲙⲁⲙⲙⲱⲛⲁⲥ	NPROP	-