ⲉⲅⲕⲗⲏⲥⲧⲱⲥ	ⲉⲅⲕⲗⲏⲥⲧⲱⲥ
ⲉⲡⲓⲃⲟⲩⲗⲟⲥ	ⲉⲡⲓⲃⲟⲩⲗⲟⲥ
ⲙⲛⲧⲕⲁⲕⲟⲩⲣⲅⲟⲥ	ⲙⲛⲧ|ⲕⲁⲕⲟⲩⲣⲅⲟⲥ
ⲧⲣⲓⲁⲇⲓⲕⲟⲛ	ⲧⲣⲓⲁⲇⲓⲕⲟⲛ
ⲫⲑⲟⲛⲏⲣⲟⲥ	ⲫⲑⲟⲛⲏⲣⲟⲥ
ϣⲁⲁⲣ	ϣⲁⲁⲣ
ϣⲁⲙϣⲉⲓⲇⲱⲗⲟⲛ	ϣⲁⲙϣⲉ|ⲓⲇⲱⲗⲟⲛ
ϣⲃⲣⲡⲁⲣⲑⲉⲛⲟⲥ	ϣⲃⲣ|ⲡⲁⲣⲑⲉⲛⲟⲥ
ϣⲏⲣⲡⲥϩⲁⲓ	ϣⲏⲣⲡ|ⲥϩⲁⲓ
ϣⲙϣⲉⲉⲓⲇⲱⲗⲟⲛ	ϣⲙϣⲉ|ⲉⲓⲇⲱⲗⲟⲛ
ϣⲟⲩⲡⲓⲥⲧⲉⲩⲉ	ϣⲟⲩ|ⲡⲓⲥⲧⲉⲩⲉ
ϣⲡϩⲙⲟⲧ	ϣⲡ|ϩⲙⲟⲧ
ϣⲣⲡⲥⲏⲙⲁⲛⲉ	ϣⲣⲡ|ⲥⲏⲙⲁⲛⲉ
ϣⲣⲡⲧⲁⲥⲥⲉ	ϣⲣⲡ|ⲧⲁⲥⲥⲉ
ϣⲧⲟⲩϫⲉ	ϣ|ⲧⲟⲩϫⲉ
ϥⲁⲓϩⲟⲡⲗⲟⲛ	ϥⲁⲓ|ϩⲟⲡⲗⲟⲛ
ϥⲓⲉⲓⲁⲧ	ϥⲓ|ⲉⲓⲁⲧ
ϥⲓⲣⲟⲟⲩϣ	ϥⲓ|ⲣⲟⲟⲩϣ
ϩⲁⲅⲓⲁⲍⲉ	ϩⲁⲅⲓⲁⲍⲉ
ϩⲁⲅⲓⲁⲥⲙⲟⲥ	ϩⲁⲅⲓⲁⲥⲙⲟⲥ
ϩⲁⲅⲓⲱⲥⲩⲛⲏ	ϩⲁⲅⲓⲱⲥⲩⲛⲏ
ϩⲁⲅⲓⲱⲧⲁⲧⲟⲥ	ϩⲁⲅⲓⲱⲧⲁⲧⲟⲥ
ϩⲁⲅⲛⲟⲛ	ϩⲁⲅⲛⲟⲛ
ϩⲁⲓⲣⲉⲥⲓⲥ	ϩⲁⲓⲣⲉⲥⲓⲥ
ϩⲁⲓⲣⲉⲧⲓⲕⲟⲥ	ϩⲁⲓⲣⲉⲧⲓⲕⲟⲥ
ϩⲁⲗⲓⲉⲩⲥ	ϩⲁⲗⲓⲉⲩⲥ
ϩⲁⲗⲩⲥⲓⲥ	ϩⲁⲗⲩⲥⲓⲥ
ϩⲁⲙⲁ	ϩⲁⲙⲁ
ϩⲁⲙⲏⲛ	ϩⲁⲙⲏⲛ
ϩⲁⲡⲗⲟⲩⲛ	ϩⲁⲡⲗⲟⲩⲛ
ϩⲁⲡⲗⲟⲩⲥ	ϩⲁⲡⲗⲟⲩⲥ
ϩⲁⲡⲗⲱⲥ	ϩⲁⲡⲗⲱⲥ
ϩⲁⲣϣϩⲏⲧ	ϩⲁⲣϣ|ϩⲏⲧ
ϩⲁⲣⲙⲁ	ϩⲁⲣⲙⲁ
ϩⲁⲣⲙⲟⲍⲉ	ϩⲁⲣⲙⲟⲍⲉ
ϩⲁⲣⲙⲟⲛⲓⲁ	ϩⲁⲣⲙⲟⲛⲓⲁ
ϩⲁⲣⲡⲁⲍⲉ	ϩⲁⲣⲡⲁⲍⲉ
ϩⲉⲃⲇⲟⲙⲁⲥ	ϩⲉⲃⲇⲟⲙⲁⲥ
ϩⲉⲃⲣⲁⲓⲁ	ϩⲉⲃⲣⲁⲓⲁ
ϩⲉⲃⲣⲁⲓⲟⲥ	ϩⲉⲃⲣⲁⲓⲟⲥ
ϩⲉⲑⲛⲓⲕⲟⲥ	ϩⲉⲑⲛⲓⲕⲟⲥ
ϩⲉⲑⲛⲟⲥ	ϩⲉⲑⲛⲟⲥ
ϩⲉⲓⲙⲁⲣⲙⲉⲛⲏ	ϩⲉⲓⲙⲁⲣⲙⲉⲛⲏ
ϩⲉⲕⲁⲧⲟⲛⲧⲁⲣⲭⲟⲥ	ϩⲉⲕⲁⲧⲟⲛⲧⲁⲣⲭⲟⲥ
ϩⲉⲗⲗⲏⲛⲟⲥ	ϩⲉⲗⲗⲏⲛⲟⲥ
ϩⲉⲗⲗⲏⲛ	ϩⲉⲗⲗⲏⲛ
ϩⲉⲗⲟⲥ	ϩⲉⲗⲟⲥ
ϩⲉⲗⲡⲓⲍⲉ	ϩⲉⲗⲡⲓⲍⲉ
ϩⲉⲗⲡⲓⲥ	ϩⲉⲗⲡⲓⲥ
ϩⲉⲙⲏⲣⲁ	ϩⲉⲙⲏⲣⲁ
ϩⲉⲛⲛⲁⲥ	ϩⲉⲛⲛⲁⲥ
ϩⲉⲝⲓⲥ	ϩⲉⲝⲓⲥ
ϩⲉⲣⲙⲉⲛⲉⲩⲧⲏⲥ	ϩⲉⲣⲙⲉⲛⲉⲩⲧⲏⲥ
ϩⲉⲣⲙⲏⲛⲉⲓⲁ	ϩⲉⲣⲙⲏⲛⲉⲓⲁ
ϩⲉⲣⲙⲏⲛⲉⲩⲉ	ϩⲉⲣⲙⲏⲛⲉⲩⲉ
ϩⲉⲣⲙⲏⲥ	ϩⲉⲣⲙⲏⲥ
ϩⲉⲧⲁⲍⲉ	ϩⲉⲧⲁⲍⲉ
ϩⲉⲧⲁⲓⲣⲁ	ϩⲉⲧⲁⲓⲣⲁ
ϩⲉⲧⲟⲓⲙⲟⲥ	ϩⲉⲧⲟⲓⲙⲟⲥ
ϩⲉⲩⲣⲉⲙⲁ	ϩⲉⲩⲣⲉⲙⲁ
ϩⲉⲱⲥ	ϩⲉⲱⲥ
ϩⲏⲅⲉⲙⲟⲛⲓⲁ	ϩⲏⲅⲉⲙⲟⲛⲓⲁ
ϩⲏⲅⲉⲙⲱⲛⲓⲕⲟⲛ	ϩⲏⲅⲉⲙⲱⲛⲓⲕⲟⲛ
ϩⲏⲅⲉⲙⲱⲛ	ϩⲏⲅⲉⲙⲱⲛ
ϩⲏⲅⲟⲩⲙⲉⲛⲟⲥ	ϩⲏⲅⲟⲩⲙⲉⲛⲟⲥ
ϩⲏⲇⲁⲛⲏ	ϩⲏⲇⲁⲛⲏ
ϩⲏⲇⲟⲛⲏ	ϩⲏⲇⲟⲛⲏ
ϩⲏⲗⲓϭⲓⲁ	ϩⲏⲗⲓϭⲓⲁ
ϩⲏⲗⲓⲕⲓⲁ	ϩⲏⲗⲓⲕⲓⲁ
ϩⲏⲗⲓⲟⲥ	ϩⲏⲗⲓⲟⲥ
ϩⲏⲡⲁⲣ	ϩⲏⲡⲁⲣ
ϩⲏⲣⲱⲇⲓⲁⲛⲟⲥ	ϩⲏⲣⲱⲇⲓⲁⲛⲟⲥ
ϩⲓⲁⲣⲭⲏ	ϩⲓ|ⲁⲣⲭⲏ
ϩⲓⲁⲧⲣⲟⲥ	ϩⲓⲁⲧⲣⲟⲥ
ϩⲓⲇⲓⲱⲧⲏⲥ	ϩⲓⲇⲓⲱⲧⲏⲥ
ϩⲓⲉⲣⲁ	ϩⲓⲉⲣⲁ
ϩⲓⲉⲣⲟⲛ	ϩⲓⲉⲣⲟⲛ
ϩⲓⲕⲁⲛⲟⲥ	ϩⲓⲕⲁⲛⲟⲥ
ϩⲓⲕⲱⲛ	ϩⲓⲕⲱⲛ
ϩⲓⲗⲓⲕⲣⲓⲛⲏⲥ	ϩⲓⲗⲓⲕⲣⲓⲛⲏⲥ
ϩⲓⲙⲁⲣⲙⲉⲛⲏ	ϩⲓⲙⲁⲣⲙⲉⲛⲏ
ϩⲓⲙⲉⲣⲟⲥ	ϩⲓⲙⲉⲣⲟⲥ
ϩⲓⲛⲁ	ϩⲓⲛⲁ
ϩⲓⲡⲡⲉⲩⲥ	ϩⲓⲡⲡⲉⲩⲥ
ϩⲓⲡⲡⲓⲕⲟⲥ	ϩⲓⲡⲡⲓⲕⲟⲥ
ϩⲓⲥⲁⲅⲅⲉⲗⲟⲥ	ϩⲓⲥⲁⲅⲅⲉⲗⲟⲥ
ϩⲓⲥⲓⲟⲛ	ϩⲓⲥⲓⲟⲛ
ϩⲓⲥⲟⲛ	ϩⲓⲥⲟⲛ
ϩⲓⲥⲟⲥ	ϩⲓⲥⲟⲥ
ϩⲓⲥⲧⲟⲣⲓⲍⲉ	ϩⲓⲥⲧⲟⲣⲓⲍⲉ
ϩⲓⲧⲁⲗⲓⲕⲏ	ϩⲓⲧⲁⲗⲓⲕⲏ
ϩⲛⲧⲟⲩ	ϩⲛⲧⲟⲩ
ϩⲟⲃⲟⲗⲟⲥ	ϩⲟⲃⲟⲗⲟⲥ
ϩⲟⲇⲟⲥ	ϩⲟⲇⲟⲥ
ϩⲟⲓⲟⲛ	ϩⲟⲓⲟⲛ
ϩⲟⲗⲓⲅⲟⲛ	ϩⲟⲗⲓⲅⲟⲛ
ϩⲟⲗⲟⲕⲁⲩⲧⲱⲙⲁ	ϩⲟⲗⲟⲕⲁⲩⲧⲱⲙⲁ
ϩⲟⲗⲟⲕⲟⲧⲧⲓⲛⲟⲥ	ϩⲟⲗⲟⲕⲟⲧⲧⲓⲛⲟⲥ
ϩⲟⲗⲟⲛ	ϩⲟⲗⲟⲛ
ϩⲟⲗⲟⲥⲏⲣⲓⲕⲕⲟⲛ	ϩⲟⲗⲟⲥⲏⲣⲓⲕⲕⲟⲛ
ϩⲟⲗⲱⲥ	ϩⲟⲗⲱⲥ
ϩⲟⲙⲏⲣⲟⲥ	ϩⲟⲙⲏⲣⲟⲥ
ϩⲟⲙⲓⲗⲓⲁ	ϩⲟⲙⲓⲗⲓⲁ
ϩⲟⲙⲟⲗⲟⲅⲉⲓ	ϩⲟⲙⲟⲗⲟⲅⲉⲓ
ϩⲟⲙⲟⲗⲟⲅⲏⲧⲏⲥ	ϩⲟⲙⲟⲗⲟⲅⲏⲧⲏⲥ
ϩⲟⲙⲟⲗⲟⲅⲓⲁ	ϩⲟⲙⲟⲗⲟⲅⲓⲁ
ϩⲟⲙⲟⲛⲟⲓⲁ	ϩⲟⲙⲟⲛⲟⲓⲁ
ϩⲟⲙⲟⲛⲟⲓ	ϩⲟⲙⲟⲛⲟⲓ
ϩⲟⲙⲟⲟⲩⲥⲓⲟⲛ	ϩⲟⲙⲟⲟⲩⲥⲓⲟⲛ
ϩⲟⲙⲟⲟⲩⲥⲓⲟⲥ	ϩⲟⲙⲟⲟⲩⲥⲓⲟⲥ
ϩⲟⲙⲱⲥ	ϩⲟⲙⲱⲥ
ϩⲟⲡⲗⲟⲛ	ϩⲟⲡⲗⲟⲛ
ϩⲟⲡⲟⲧⲉ	ϩⲟⲡⲟⲧⲉ
ϩⲟⲡⲟⲩ	ϩⲟⲡⲟⲩ
ϩⲟⲡⲱⲥ	ϩⲟⲡⲱⲥ
ϩⲟⲣⲁⲥⲓⲥ	ϩⲟⲣⲁⲥⲓⲥ
ϩⲟⲣⲓⲍⲉ	ϩⲟⲣⲓⲍⲉ
ϩⲟⲣⲙⲏ	ϩⲟⲣⲙⲏ
ϩⲟⲣⲙⲓⲥⲕⲟⲥ	ϩⲟⲣⲙⲓⲥⲕⲟⲥ
ϩⲟⲣⲟⲙⲁ	ϩⲟⲣⲟⲙⲁ
ϩⲟⲣⲟⲥ	ϩⲟⲣⲟⲥ
ϩⲟⲥⲓⲱⲧⲁⲧⲟⲥ	ϩⲟⲥⲓⲱⲧⲁⲧⲟⲥ
ϩⲟⲥⲟⲛ	ϩⲟⲥⲟⲛ
ϩⲟⲧⲁⲛ	ϩⲟⲧⲁⲛ
ϩⲟⲧⲉ	ϩⲟⲧⲉ
ϩⲟⲧⲓ	ϩⲟⲧⲓ
ϩⲣⲁⲓ	ϩⲣⲁⲓ
ϩⲣⲁⲙⲛⲟⲥ	ϩⲣⲁⲙⲛⲟⲥ
ϩⲣⲁⲭⲁ	ϩⲣⲁⲭⲁ
ϩⲣⲉⲡⲓⲍⲉ	ϩⲣⲉⲡⲓⲍⲉ
ϩⲣⲏⲧⲟⲛ	ϩⲣⲏⲧⲟⲛ
ϩⲣⲏⲧⲱⲣ	ϩⲣⲏⲧⲱⲣ
ϩⲣⲱⲙⲁⲓⲕⲟⲛ	ϩⲣⲱⲙⲁⲓⲕⲟⲛ
ϩⲣⲱⲙⲁⲓⲟⲥ	ϩⲣⲱⲙⲁⲓⲟⲥ
ϩⲩⲁⲕⲓⲛⲑⲓⲛⲟⲛ	ϩⲩⲁⲕⲓⲛⲑⲓⲛⲟⲛ
ϩⲩⲁⲕⲓⲛⲑⲟⲥ	ϩⲩⲁⲕⲓⲛⲑⲟⲥ
ϩⲩⲃⲣⲓⲍⲉ	ϩⲩⲃⲣⲓⲍⲉ
ϩⲩⲇⲁⲛⲉ	ϩⲩⲇⲁⲛⲉ
ϩⲩⲇⲣⲓⲁ	ϩⲩⲇⲣⲓⲁ
ϩⲩⲇⲣⲟⲡⲓⲕⲟⲥ	ϩⲩⲇⲣⲟⲡⲓⲕⲟⲥ
ϩⲩⲗⲏ	ϩⲩⲗⲏ
ϩⲩⲗⲓⲕⲏ	ϩⲩⲗⲓⲕⲏ
ϩⲩⲗⲓⲕⲟⲛ	ϩⲩⲗⲓⲕⲟⲛ
ϩⲩⲗⲓⲕⲟⲥ	ϩⲩⲗⲓⲕⲟⲥ
ϩⲩⲙⲏⲛ	ϩⲩⲙⲏⲛ
ϩⲩⲙⲛⲉⲩⲉ	ϩⲩⲙⲛⲉⲩⲉ
ϩⲩⲙⲛⲓ	ϩⲩⲙⲛⲓ
ϩⲩⲙⲛⲟⲗⲟⲅⲉⲓ	ϩⲩⲙⲛⲟⲗⲟⲅⲉⲓ
ϩⲩⲙⲛⲟⲗⲟⲅⲓⲁ	ϩⲩⲙⲛⲟⲗⲟⲅⲓⲁ
ϩⲩⲙⲛⲟⲥ	ϩⲩⲙⲛⲟⲥ
ϩⲩⲙⲛⲱⲧⲟⲥ	ϩⲩⲙⲛⲱⲧⲟⲥ
ϩⲩⲡⲁⲣⲏⲥ	ϩⲩⲡⲁⲣⲏⲥ
ϩⲩⲡⲁⲣⲝⲓⲥ	ϩⲩⲡⲁⲣⲝⲓⲥ
ϩⲩⲡⲁⲣⲭⲟⲛⲧⲁ	ϩⲩⲡⲁⲣⲭⲟⲛⲧⲁ
ϩⲩⲡⲏⲣⲉⲥⲓⲁ	ϩⲩⲡⲏⲣⲉⲥⲓⲁ
ϩⲩⲡⲏⲣⲉⲧⲉⲓ	ϩⲩⲡⲏⲣⲉⲧⲉⲓ
ϩⲩⲡⲏⲣⲉⲧⲏⲥ	ϩⲩⲡⲏⲣⲉⲧⲏⲥ
ϩⲩⲡⲟⲅⲣⲁⲫⲉⲩⲥ	ϩⲩⲡⲟⲅⲣⲁⲫⲉⲩⲥ
ϩⲩⲡⲟⲅⲣⲁⲫⲉ	ϩⲩⲡⲟⲅⲣⲁⲫⲉ
ϩⲩⲡⲟⲅⲣⲁⲫⲏ	ϩⲩⲡⲟⲅⲣⲁⲫⲏ
ϩⲩⲡⲟⲇⲓⲁⲕⲟⲛⲟⲥ	ϩⲩⲡⲟⲇⲓⲁⲕⲟⲛⲟⲥ
ϩⲩⲡⲟⲇⲓⲁⲕⲱⲛ	ϩⲩⲡⲟⲇⲓⲁⲕⲱⲛ
ϩⲩⲡⲟⲕⲉⲓⲥⲑⲁⲓ	ϩⲩⲡⲟⲕⲉⲓⲥⲑⲁⲓ
ϩⲩⲡⲟⲕⲟⲣⲉⲩⲉ	ϩⲩⲡⲟⲕⲟⲣⲉⲩⲉ
ϩⲩⲡⲟⲕⲣⲓⲛⲉ	ϩⲩⲡⲟⲕⲣⲓⲛⲉ
ϩⲩⲡⲟⲕⲣⲓⲥⲓⲥ	ϩⲩⲡⲟⲕⲣⲓⲥⲓⲥ
ϩⲩⲡⲟⲕⲣⲓⲧⲏⲥ	ϩⲩⲡⲟⲕⲣⲓⲧⲏⲥ
ϩⲩⲡⲟⲗⲩⲙⲯⲓⲥ	ϩⲩⲡⲟⲗⲩⲙⲯⲓⲥ
ϩⲩⲡⲟⲙⲓⲛⲉ	ϩⲩⲡⲟⲙⲓⲛⲉ
ϩⲩⲡⲟⲙⲛⲏⲙⲁ	ϩⲩⲡⲟⲙⲛⲏⲙⲁ
ϩⲩⲡⲟⲙⲛⲏⲥⲓⲥ	ϩⲩⲡⲟⲙⲛⲏⲥⲓⲥ
ϩⲩⲡⲟⲙⲛⲏⲥⲕⲉ	ϩⲩⲡⲟⲙⲛⲏⲥⲕⲉ
ϩⲩⲡⲟⲙⲟⲛⲏ	ϩⲩⲡⲟⲙⲟⲛⲏ
ϩⲩⲡⲟⲡⲟⲇⲓⲟⲛ	ϩⲩⲡⲟⲡⲟⲇⲓⲟⲛ
ϩⲩⲡⲟⲥⲧⲁⲥⲓⲥ	ϩⲩⲡⲟⲥⲧⲁⲥⲓⲥ
ϩⲩⲡⲟⲧⲁⲅⲏ	ϩⲩⲡⲟⲧⲁⲅⲏ
ϩⲩⲡⲟⲧⲁⲥⲥⲉ	ϩⲩⲡⲟⲧⲁⲥⲥⲉ
ϩⲩⲡⲟⲩⲣⲅⲉⲓ	ϩⲩⲡⲟⲩⲣⲅⲉⲓ
ϩⲩⲡⲟⲩⲣⲅⲓⲥⲑⲉ	ϩⲩⲡⲟⲩⲣⲅⲓⲥⲑⲉ
ϩⲩⲡⲟⲭⲟⲣⲉⲓ	ϩⲩⲡⲟⲭⲟⲣⲉⲓ
ϩⲩⲡⲱⲣⲁⲟⲛ	ϩⲩⲡⲱⲣⲁⲟⲛ
ϩⲩⲥⲥⲱⲡⲟⲥ	ϩⲩⲥⲥⲱⲡⲟⲥ
ϩⲱⲣⲓⲍⲉ	ϩⲱⲣⲓⲍⲉ
ϩⲱⲥⲧⲉ	ϩⲱⲥⲧⲉ
ϩⲱⲥ	ϩⲱⲥ
ϫⲁⲥⲓϩⲏⲧ	ϫⲁⲥⲓ|ϩⲏⲧ
ϫⲉⲕⲁⲥ	ϫⲉⲕⲁⲥ
ϫⲓϣⲁϫⲉ	ϫⲓ|ϣⲁϫⲉ
ϫⲓϣⲕⲁⲕ	ϫⲓ|ϣⲕⲁⲕ
ϫⲓϩⲁⲓ	ϫⲓ|ϩⲁⲓ
ϫⲓϩⲓⲕⲱⲛ	ϫⲓ|ϩⲓⲕⲱⲛ
ϫⲓϩⲓⲙⲉ	ϫⲓ|ϩⲓⲙⲉ
ϫⲓϩⲟ	ϫⲓ|ϩⲟ
ϫⲓϩⲣⲁϥ	ϫⲓ|ϩⲣⲁ|ϥ
ϫⲓϯⲡⲉ	ϫⲓ|ϯⲡⲉ
ϫⲓⲁⲅⲁⲡⲏ	ϫⲓ|ⲁⲅⲁⲡⲏ
ϫⲓⲁⲛⲁⲡⲁⲩⲥⲓⲥ	ϫⲓ|ⲁⲛⲁⲡⲁⲩⲥⲓⲥ
ϫⲓⲁⲝⲓⲱⲙⲁ	ϫⲓ|ⲁⲝⲓⲱⲙⲁ
ϫⲓⲁⲣⲭⲏ	ϫⲓ|ⲁⲣⲭⲏ
ϫⲓⲃⲁⲡⲧⲓⲥⲙⲁ	ϫⲓ|ⲃⲁⲡⲧⲓⲥⲙⲁ
ϫⲓⲉⲟⲟⲩ	ϫⲓ|ⲉⲟⲟⲩ
ϫⲓⲉⲡⲓⲧⲓⲙⲓⲁ	ϫⲓ|ⲉⲡⲓⲧⲓⲙⲓⲁ
ϫⲓⲕⲁⲧⲏⲅⲟⲣⲓⲁ	ϫⲓ|ⲕⲁⲧⲏⲅⲟⲣⲓⲁ
ϫⲓⲕⲗⲏⲣⲟⲛⲟⲙⲓⲁ	ϫⲓ|ⲕⲗⲏⲣⲟⲛⲟⲙⲓⲁ
ϫⲓⲕⲗⲏⲣⲟⲥ	ϫⲓ|ⲕⲗⲏⲣⲟⲥ
ϫⲓⲗⲩⲡⲏ	ϫⲓ|ⲗⲩⲡⲏ
ϫⲓⲙⲟⲣⲫⲏ	ϫⲓ|ⲙⲟⲣⲫⲏ
ϫⲓⲛϭⲟⲛⲥ	ϫⲓ|ⲛ|ϭⲟⲛⲥ
ϫⲓⲟⲩⲁ	ϫⲓ|ⲟⲩⲁ
ϫⲓⲡⲉⲓⲣⲁ	ϫⲓ|ⲡⲉⲓⲣⲁ
ϫⲓⲡⲏⲣⲁ	ϫⲓ|ⲡⲏⲣⲁ
ϫⲓⲡⲓⲣⲁ	ϫⲓ|ⲡⲓⲣⲁ
ϫⲓⲥⲁⲣⲝ	ϫⲓ|ⲥⲁⲣⲝ
ϫⲓⲥⲕⲉⲩⲏ	ϫⲓ|ⲥⲕⲉⲩⲏ
ϫⲓⲥⲩⲙⲃⲟⲩⲗⲓⲟⲛ	ϫⲓ|ⲥⲩⲙⲃⲟⲩⲗⲓⲟⲛ
ϫⲓⲥⲱⲙⲁ	ϫⲓ|ⲥⲱⲙⲁ
ϫⲓⲧⲉⲭⲟⲗⲗⲏ	ϫⲓ|ⲧⲉ|ⲭⲟⲗⲗⲏ
ϫⲓⲧⲣⲟⲫⲏ	ϫⲓ|ⲧⲣⲟⲫⲏ
ϫⲓⲧⲩⲡⲟⲥ	ϫⲓ|ⲧⲩⲡⲟⲥ
ϭⲓⲛϣⲁϫⲉ	ϭⲓⲛ|ϣⲁϫⲉ
ϭⲓⲛϣⲱⲗⲙ	ϭⲓⲛ|ϣⲱⲗⲙ
ϭⲓⲛϩⲩⲙⲛⲉⲩⲉ	ϭⲓⲛ|ϩⲩⲙⲛⲉⲩⲉ
ϭⲓⲛⲁϩⲉⲣⲁⲧ	ϭⲓⲛ|ⲁϩⲉⲣⲁⲧ
ϭⲓⲛⲗⲩⲡⲏ	ϭⲓⲛ|ⲗⲩⲡⲏ
ϭⲓⲛⲛⲁⲩ	ϭⲓⲛ|ⲛⲁⲩ
ϭⲓⲛⲡⲣⲟⲥϩⲩⲇⲣⲉⲩⲉ	ϭⲓⲛ|ⲡⲣⲟⲥϩⲩⲇⲣⲉⲩⲉ
ϭⲓⲛⲥⲱⲧⲙ	ϭⲓⲛ|ⲥⲱⲧⲙ
ϭⲛⲁⲫⲟⲣⲙⲏ	ϭⲛ|ⲁⲫⲟⲣⲙⲏ
ϭⲛⲭⲁⲣⲓⲥ	ϭⲛ|ⲭⲁⲣⲓⲥ
ϭⲟⲗⲗⲉ	ϭⲟⲗⲗⲉ
ϯϣⲓⲡⲉ	ϯ|ϣⲓⲡⲉ
ϯϩⲁⲡ	ϯ|ϩⲁⲡ
ϯϩⲏⲩ	ϯ|ϩⲏⲩ
ϯϩⲓⲕⲱⲛ	ϯ|ϩⲓⲕⲱⲛ
ϯϩⲓⲥⲉ	ϯ|ϩⲓⲥⲉ
ϯϩⲧⲏ	ϯ|ϩⲧⲏ
ϯϭⲣⲟⲟⲙⲡⲉ	ϯ|ϭⲣⲟⲟⲙⲡⲉ
ϯⲁⲁⲥ	ϯ|ⲁⲁⲥ
ϯⲁⲅⲁⲑⲟⲛ	ϯ|ⲁⲅⲁⲑⲟⲛ
ϯⲁⲅⲁⲡⲏ	ϯ|ⲁⲅⲁⲡⲏ
ϯⲁⲅⲱⲛ	ϯ|ⲁⲅⲱⲛ
ϯⲁⲓⲱⲛ	ϯ|ⲁⲓⲱⲛ
ϯⲁⲙⲁⲣⲧⲉⲣⲉ	ϯⲁⲙⲁⲣⲧⲉⲣⲉ
ϯⲁⲛⲁⲡⲁⲩⲥⲓⲥ	ϯ|ⲁⲛⲁⲡⲁⲩⲥⲓⲥ
ϯⲁⲡⲟⲕⲣⲓⲥⲓⲥ	ϯ|ⲁⲡⲟⲕⲣⲓⲥⲓⲥ
ϯⲁⲡⲟⲫⲁⲥⲓⲥ	ϯ|ⲁⲡⲟⲫⲁⲥⲓⲥ
ϯⲁⲫⲟⲣⲙⲏ	ϯ|ⲁⲫⲟⲣⲙⲏ
ϯⲃⲁⲡⲧⲓⲥⲙⲁ	ϯ|ⲃⲁⲡⲧⲓⲥⲙⲁ
ϯⲇⲱⲣⲟⲛ	ϯ|ⲇⲱⲣⲟⲛ
ϯⲉⲅⲅⲩⲏⲧⲏⲥ	ϯ|ⲉⲅⲅⲩⲏⲧⲏⲥ
ϯⲉⲓⲣⲏⲛⲏ	ϯ|ⲉⲓⲣⲏⲛⲏ
ϯⲉⲛⲧⲟⲗⲏ	ϯ|ⲉⲛⲧⲟⲗⲏ
ϯⲉⲟⲟⲩ	ϯ|ⲉⲟⲟⲩ
ϯⲑⲣⲟⲛⲟⲥ	ϯ|ⲑⲣⲟⲛⲟⲥ
ϯⲕⲁⲡⲛⲟⲥ	ϯ|ⲕⲁⲡⲛⲟⲥ
ϯⲕⲁⲣⲡⲟⲥ	ϯ|ⲕⲁⲣⲡⲟⲥ
ϯⲕⲁⲧⲁⲥⲧⲁⲥⲓⲥ	ϯ|ⲕⲁⲧⲁⲥⲧⲁⲥⲓⲥ
ϯⲕⲗⲏⲣⲟⲥ	ϯ|ⲕⲗⲏⲣⲟⲥ
ϯⲕⲗⲯ	ϯ|ⲕⲗⲯ
ϯⲕⲛⲉⲩⲉ	ϯⲕⲛⲉⲩⲉ
ϯⲕⲣⲁⲩⲕⲏ	ϯ|ⲕⲣⲁⲩⲕⲏ
ϯⲗⲉⲝⲓⲥ	ϯ|ⲗⲉⲝⲓⲥ
ϯⲗⲓⲃⲉⲗⲗⲟⲥ	ϯ|ⲗⲓⲃⲉⲗⲗⲟⲥ
ϯⲗⲟⲅⲟⲥ	ϯ|ⲗⲟⲅⲟⲥ
ϯⲗⲩⲡⲏ	ϯ|ⲗⲩⲡⲏ
ϯⲙⲉⲧⲁⲛⲓⲁ	ϯ|ⲙⲉⲧⲁⲛⲓⲁ
ϯⲙⲟⲣⲫⲏ	ϯ|ⲙⲟⲣⲫⲏ
ϯⲛⲟⲙⲟⲥ	ϯ|ⲛⲟⲙⲟⲥ
ϯⲛⲧⲟⲗⲏ	ϯ|ⲛⲧⲟⲗⲏ
ϯⲟⲥⲉ	ϯ|ⲟⲥⲉ
ϯⲟⲩⲱ	ϯ|ⲟⲩⲱ
ϯⲡⲓ	ϯ|ⲡⲓ
ϯⲥⲃⲱ	ϯ|ⲥⲃⲱ
ϯⲥⲙⲏ	ϯ|ⲥⲙⲏ
ϯⲥⲟ	ϯ|ⲥⲟ
ϯⲥⲩⲙⲃⲟⲗⲏ	ϯ|ⲥⲩⲙⲃⲟⲗⲏ
ϯⲧⲁⲝⲓⲥ	ϯ|ⲧⲁⲝⲓⲥ
ϯⲧⲣⲟⲫⲏ	ϯ|ⲧⲣⲟⲫⲏ
ϯⲧⲱⲛ	ϯ|ⲧⲱⲛ
ϯⲭⲁⲣⲁⲕⲧⲏⲣ	ϯ|ⲭⲁⲣⲁⲕⲧⲏⲣ
ϯⲭⲁⲣⲓⲥ	ϯ|ⲭⲁⲣⲓⲥ
ⲁϩⲉⲣⲁⲧ	ⲁϩⲉ|ⲣⲁⲧ
ⲁϩⲟⲣⲁⲧⲟⲛ	ⲁϩⲟⲣⲁⲧⲟⲛ
ⲁϩⲟⲣⲁⲧⲟⲥ	ⲁϩⲟⲣⲁⲧⲟⲥ
ⲁⲃⲁⲥⲓⲗⲉⲩⲧⲟⲥ	ⲁⲃⲁⲥⲓⲗⲉⲩⲧⲟⲥ
ⲁⲃⲉⲗⲧⲓⲟⲛ	ⲁⲃⲉⲗⲧⲓⲟⲛ
ⲁⲅⲁⲑⲟⲛ	ⲁⲅⲁⲑⲟⲛ
ⲁⲅⲁⲑⲟⲥ	ⲁⲅⲁⲑⲟⲥ
ⲁⲅⲁⲗⲗⲓⲱⲛ	ⲁⲅⲁⲗⲗⲓⲱⲛ
ⲁⲅⲁⲛⲁⲕⲧⲉⲓ	ⲁⲅⲁⲛⲁⲕⲧⲉⲓ
ⲁⲅⲁⲡⲁ	ⲁⲅⲁⲡⲁ
ⲁⲅⲁⲡⲏⲧⲟⲥ	ⲁⲅⲁⲡⲏⲧⲟⲥ
ⲁⲅⲁⲡⲏ	ⲁⲅⲁⲡⲏ
ⲁⲅⲁⲡⲏ 	ⲁⲅⲁⲡⲏ 
ⲁⲅⲁⲣⲓⲛⲛⲉⲟⲥ	ⲁⲅⲁⲣⲓⲛⲛⲉⲟⲥ
ⲁⲅⲅⲉⲗⲓⲕⲏ	ⲁⲅⲅⲉⲗⲓⲕⲏ
ⲁⲅⲅⲉⲗⲓⲕⲟⲛ	ⲁⲅⲅⲉⲗⲓⲕⲟⲛ
ⲁⲅⲅⲉⲗⲓⲕⲟⲥ	ⲁⲅⲅⲉⲗⲓⲕⲟⲥ
ⲁⲅⲅⲉⲗⲟⲥ	ⲁⲅⲅⲉⲗⲟⲥ
ⲁⲅⲅⲓⲟⲛ	ⲁⲅⲅⲓⲟⲛ
ⲁⲅⲉⲗⲏ	ⲁⲅⲉⲗⲏ
ⲁⲅⲉⲛⲛⲏⲧⲟⲛ	ⲁⲅⲉⲛⲛⲏⲧⲟⲛ
ⲁⲅⲉⲛⲛⲏⲧⲟⲥ	ⲁⲅⲉⲛⲛⲏⲧⲟⲥ
ⲁⲅⲓⲁ	ⲁⲅⲓⲁ
ⲁⲅⲓⲟⲛ	ⲁⲅⲓⲟⲛ
ⲁⲅⲓⲟⲥ	ⲁⲅⲓⲟⲥ
ⲁⲅⲛⲱⲙⲏⲥⲩⲛⲏ	ⲁⲅⲛⲱⲙⲏⲥⲩⲛⲏ
ⲁⲅⲛⲱⲙⲟⲛ	ⲁⲅⲛⲱⲙⲟⲛ
ⲁⲅⲛⲱⲥⲧⲟⲥ	ⲁⲅⲛⲱⲥⲧⲟⲥ
ⲁⲅⲟⲣⲁⲓⲟⲥ	ⲁⲅⲟⲣⲁⲓⲟⲥ
ⲁⲅⲟⲣⲁⲥⲓⲁ	ⲁⲅⲟⲣⲁⲥⲓⲁ
ⲁⲅⲟⲣⲁ	ⲁⲅⲟⲣⲁ
ⲁⲅⲣⲁⲫⲟⲥ	ⲁⲅⲣⲁⲫⲟⲥ
ⲁⲅⲣⲓⲟⲛ	ⲁⲅⲣⲓⲟⲛ
ⲁⲅⲣⲓⲟⲥ	ⲁⲅⲣⲓⲟⲥ
ⲁⲅⲱⲅⲏ	ⲁⲅⲱⲅⲏ
ⲁⲅⲱⲛⲓⲁ	ⲁⲅⲱⲛⲓⲁ
ⲁⲅⲱⲛⲓⲍⲉⲥⲑⲉ	ⲁⲅⲱⲛⲓⲍⲉⲥⲑⲉ
ⲁⲅⲱⲛⲓⲍⲉ	ⲁⲅⲱⲛⲓⲍⲉ
ⲁⲅⲱⲛⲓⲥⲧⲏⲥ	ⲁⲅⲱⲛⲓⲥⲧⲏⲥ
ⲁⲅⲱⲛⲟⲑⲉⲧⲏⲥ	ⲁⲅⲱⲛⲟⲑⲉⲧⲏⲥ
ⲁⲅⲱⲛ	ⲁⲅⲱⲛ
ⲁⲇⲁⲙⲁⲛⲧⲓⲛⲏ	ⲁⲇⲁⲙⲁⲛⲧⲓⲛⲏ
ⲁⲇⲁⲙⲁⲛⲧⲟⲥ	ⲁⲇⲁⲙⲁⲛⲧⲟⲥ
ⲁⲇⲏⲗⲟⲥ	ⲁⲇⲏⲗⲟⲥ
ⲁⲇⲓϭⲓ	ⲁⲇⲓϭⲓ
ⲁⲇⲓⲕⲁⲓⲟⲥ	ⲁⲇⲓⲕⲁⲓⲟⲥ
ⲁⲇⲓⲕⲓⲁ	ⲁⲇⲓⲕⲓⲁ
ⲁⲇⲓⲕⲟⲛ	ⲁⲇⲓⲕⲟⲛ
ⲁⲇⲓⲕⲟⲥ	ⲁⲇⲓⲕⲟⲥ
ⲁⲇⲓⲕⲱⲥ	ⲁⲇⲓⲕⲱⲥ
ⲁⲉⲓ	ⲁⲉⲓ
ⲁⲉⲣⲟⲇⲓⲟⲥ	ⲁⲉⲣⲟⲇⲓⲟⲥ
ⲁⲉⲧⲟⲥ	ⲁⲉⲧⲟⲥ
ⲁⲏⲣ	ⲁⲏⲣ
ⲁⲑⲁⲛⲁⲥⲓⲁ	ⲁⲑⲁⲛⲁⲥⲓⲁ
ⲁⲑⲁⲛⲁⲧⲟⲛ	ⲁⲑⲁⲛⲁⲧⲟⲛ
ⲁⲑⲁⲛⲁⲧⲟⲥ	ⲁⲑⲁⲛⲁⲧⲟⲥ
ⲁⲑⲉⲣⲙⲏⲛⲉⲩⲉ	ⲁⲑⲉⲣⲙⲏⲛⲉⲩⲉ
ⲁⲑⲉⲧⲉⲓ	ⲁⲑⲉⲧⲉⲓ
ⲁⲑⲏⲛⲁⲓⲟⲥ	ⲁⲑⲏⲛⲁⲓⲟⲥ
ⲁⲑⲗⲏⲥⲓⲥ	ⲁⲑⲗⲏⲥⲓⲥ
ⲁⲑⲗⲏⲧⲏⲥ	ⲁⲑⲗⲏⲧⲏⲥ
ⲁⲑⲗⲟⲛ	ⲁⲑⲗⲟⲛ
ⲁⲑⲗⲟⲫⲟⲣⲟⲥ	ⲁⲑⲗⲟⲫⲟⲣⲟⲥ
ⲁⲑⲩⲛⲁ	ⲁⲑⲩⲛⲁ
ⲁⲑⲩⲣⲁⲥ	ⲁⲑⲩⲣⲁⲥ
ⲁⲓⲇⲓⲟⲥ	ⲁⲓⲇⲓⲟⲥ
ⲁⲓⲇⲟⲓⲟⲛ	ⲁⲓⲇⲟⲓⲟⲛ
ⲁⲓⲛⲓⲅⲙⲁ	ⲁⲓⲛⲓⲅⲙⲁ
ⲁⲓⲡⲉⲛⲟⲥ	ⲁⲓⲡⲉⲛⲟⲥ
ⲁⲓⲥⲑⲁⲛⲉ	ⲁⲓⲥⲑⲁⲛⲉ
ⲁⲓⲥⲑⲏⲥⲓⲥ	ⲁⲓⲥⲑⲏⲥⲓⲥ
ⲁⲓⲥⲑⲏⲧⲏⲣⲓⲟⲛ	ⲁⲓⲥⲑⲏⲧⲏⲣⲓⲟⲛ
ⲁⲓⲥⲑⲏⲧⲟⲛ	ⲁⲓⲥⲑⲏⲧⲟⲛ
ⲁⲓⲥⲑⲏⲧⲟⲥ	ⲁⲓⲥⲑⲏⲧⲟⲥ
ⲁⲓⲧⲉⲓ	ⲁⲓⲧⲉⲓ
ⲁⲓⲧⲏⲙⲁ	ⲁⲓⲧⲏⲙⲁ
ⲁⲓⲧⲏⲥⲓⲥ	ⲁⲓⲧⲏⲥⲓⲥ
ⲁⲓⲧⲓⲁ	ⲁⲓⲧⲓⲁ
ⲁⲓⲧⲓⲟⲛ	ⲁⲓⲧⲓⲟⲛ
ⲁⲓⲭⲙⲁⲗⲱⲥⲓⲁ	ⲁⲓⲭⲙⲁⲗⲱⲥⲓⲁ
ⲁⲓⲭⲙⲁⲗⲱⲧⲉⲩⲉ	ⲁⲓⲭⲙⲁⲗⲱⲧⲉⲩⲉ
ⲁⲓⲭⲙⲁⲗⲱⲧⲓⲍⲉ	ⲁⲓⲭⲙⲁⲗⲱⲧⲓⲍⲉ
ⲁⲓⲭⲙⲁⲗⲱⲧⲟⲥ	ⲁⲓⲭⲙⲁⲗⲱⲧⲟⲥ
ⲁⲓⲱⲛⲓⲟⲛ	ⲁⲓⲱⲛⲓⲟⲛ
ⲁⲓⲱⲛⲓⲟⲥ	ⲁⲓⲱⲛⲓⲟⲥ
ⲁⲓⲱⲛ	ⲁⲓⲱⲛ
ⲁⲕⲁⲑⲁⲣⲥⲓⲁ	ⲁⲕⲁⲑⲁⲣⲥⲓⲁ
ⲁⲕⲁⲑⲁⲣⲧⲟⲛ	ⲁⲕⲁⲑⲁⲣⲧⲟⲛ
ⲁⲕⲁⲑⲁⲣⲧⲟⲥ	ⲁⲕⲁⲑⲁⲣⲧⲟⲥ
ⲁⲕⲁⲕⲟⲥ	ⲁⲕⲁⲕⲟⲥ
ⲁⲕⲁⲧⲁⲅⲛⲱⲥⲧⲟⲥ	ⲁⲕⲁⲧⲁⲅⲛⲱⲥⲧⲟⲥ
ⲁⲕⲉⲣⲁⲓⲟⲛ	ⲁⲕⲉⲣⲁⲓⲟⲛ
ⲁⲕⲉⲣⲁⲓⲟⲥ	ⲁⲕⲉⲣⲁⲓⲟⲥ
ⲁⲕⲙⲏⲛ	ⲁⲕⲙⲏⲛ
ⲁⲕⲙⲏ	ⲁⲕⲙⲏ
ⲁⲕⲟⲗⲗⲟⲩⲑⲓⲁ	ⲁⲕⲟⲗⲗⲟⲩⲑⲓⲁ
ⲁⲕⲟⲗⲟⲩⲑⲓⲁ	ⲁⲕⲟⲗⲟⲩⲑⲓⲁ
ⲁⲕⲣⲁⲧⲟⲛ	ⲁⲕⲣⲁⲧⲟⲛ
ⲁⲕⲣⲓⲃⲁⲍⲉ	ⲁⲕⲣⲓⲃⲁⲍⲉ
ⲁⲕⲣⲓⲃⲓⲁ	ⲁⲕⲣⲓⲃⲓⲁ
ⲁⲕⲣⲓⲃⲱⲥ	ⲁⲕⲣⲓⲃⲱⲥ
ⲁⲕⲣⲓⲥ	ⲁⲕⲣⲓⲥ
ⲁⲕⲣⲟⲁⲧⲏⲥ	ⲁⲕⲣⲟⲁⲧⲏⲥ
ⲁⲕⲧⲓⲛ	ⲁⲕⲧⲓⲛ
ⲁⲕⲩⲣⲟⲛ	ⲁⲕⲩⲣⲟⲛ
ⲁⲕⲩⲣⲟⲩ	ⲁⲕⲩⲣⲟⲩ
ⲁⲗⲁⲃⲁⲥⲧⲣⲟⲛ	ⲁⲗⲁⲃⲁⲥⲧⲣⲟⲛ
ⲁⲗⲉⲕⲧⲟⲥ	ⲁⲗⲉⲕⲧⲟⲥ
ⲁⲗⲉⲕⲧⲱⲣ	ⲁⲗⲉⲕⲧⲱⲣ
ⲁⲗⲏⲑⲉⲓⲁ	ⲁⲗⲏⲑⲉⲓⲁ
ⲁⲗⲏⲑⲓⲛⲏ	ⲁⲗⲏⲑⲓⲛⲏ
ⲁⲗⲏⲑⲓⲛⲟⲛ	ⲁⲗⲏⲑⲓⲛⲟⲛ
ⲁⲗⲏⲑⲓⲛⲟⲥ	ⲁⲗⲏⲑⲓⲛⲟⲥ
ⲁⲗⲏⲑⲱⲥ	ⲁⲗⲏⲑⲱⲥ
ⲁⲗⲗⲁⲅⲏ	ⲁⲗⲗⲁⲅⲏ
ⲁⲗⲗⲁⲥⲥⲉ	ⲁⲗⲗⲁⲥⲥⲉ
ⲁⲗⲗⲁ	ⲁⲗⲗⲁ
ⲁⲗⲗⲟⲅⲉⲛⲏⲥ	ⲁⲗⲗⲟⲅⲉⲛⲏⲥ
ⲁⲗⲗⲟⲅⲉⲛⲓⲟⲥ	ⲁⲗⲗⲟⲅⲉⲛⲓⲟⲥ
ⲁⲗⲗⲟⲧⲣⲓⲟⲛ	ⲁⲗⲗⲟⲧⲣⲓⲟⲛ
ⲁⲗⲗⲟⲧⲣⲓⲟⲥ	ⲁⲗⲗⲟⲧⲣⲓⲟⲥ
ⲁⲗⲗⲟⲫⲩⲗⲟⲥ	ⲁⲗⲗⲟⲫⲩⲗⲟⲥ
ⲁⲗⲗⲱⲏ	ⲁⲗⲗⲱⲏ
ⲁⲗⲟⲅⲟⲛ	ⲁⲗⲟⲅⲟⲛ
ⲁⲗⲟⲅⲟⲥ	ⲁⲗⲟⲅⲟⲥ
ⲁⲗⲥⲟⲥ	ⲁⲗⲥⲟⲥ
ⲁⲗⲫⲁⲃⲁⲧⲱⲛ	ⲁⲗⲫⲁⲃⲁⲧⲱⲛ
ⲁⲗⲫⲁ	ⲁⲗⲫⲁ
ⲁⲙⲁⲣⲁⲛⲧⲟⲥ	ⲁⲙⲁⲣⲁⲛⲧⲟⲥ
ⲁⲙⲉⲗⲉⲓⲁ	ⲁⲙⲉⲗⲉⲓⲁ
ⲁⲙⲉⲗⲉⲓ	ⲁⲙⲉⲗⲉⲓ
ⲁⲙⲉⲗⲏⲥ	ⲁⲙⲉⲗⲏⲥ
ⲁⲙⲉⲣⲓⲙⲛⲟⲥ	ⲁⲙⲉⲣⲓⲙⲛⲟⲥ
ⲁⲙⲉⲣⲓ	ⲁⲙⲉⲣⲓ
ⲁⲙⲉⲧⲣⲏⲧⲟⲛ	ⲁⲙⲉⲧⲣⲏⲧⲟⲛ
ⲁⲙⲏⲑⲓⲥⲧⲱⲥ	ⲁⲙⲏⲑⲓⲥⲧⲱⲥ
ⲁⲙⲏⲧⲣⲓⲧⲟⲥ	ⲁⲙⲏⲧⲣⲓⲧⲟⲥ
ⲁⲙⲓⲁⲛⲧⲟⲥ	ⲁⲙⲓⲁⲛⲧⲟⲥ
ⲁⲙⲓⲣⲁ	ⲁⲙⲓⲣⲁ
ⲁⲙⲙⲟⲣⲁⲓⲟⲥ	ⲁⲙⲙⲟⲣⲁⲓⲟⲥ
ⲁⲙⲙⲱⲛⲓⲧⲏⲥ	ⲁⲙⲙⲱⲛⲓⲧⲏⲥ
ⲁⲙⲡⲟⲩⲗⲉ	ⲁⲙⲡⲟⲩⲗⲉ
ⲁⲙⲩⲅⲇⲁⲗⲟⲛ	ⲁⲙⲩⲅⲇⲁⲗⲟⲛ
ⲁⲙⲫⲓⲃⲁⲗⲉ	ⲁⲙⲫⲓⲃⲁⲗⲉ
ⲁⲙⲫⲓⲃⲟⲗⲓⲁ	ⲁⲙⲫⲓⲃⲟⲗⲓⲁ
ⲁⲙⲫⲓⲧⲁⲡⲟⲥ	ⲁⲙⲫⲓⲧⲁⲡⲟⲥ
ⲁⲙⲱⲙⲟⲙ	ⲁⲙⲱⲙⲟⲙ
ⲁⲛϩⲁⲗⲓⲥⲕⲉ	ⲁⲛϩⲁⲗⲓⲥⲕⲉ
ⲁⲛϩⲁⲗⲱⲙⲁ	ⲁⲛϩⲁⲗⲱⲙⲁ
ⲁⲛϩⲉⲥⲓⲥ	ⲁⲛϩⲉⲥⲓⲥ
ⲁⲛϩⲏⲕⲉⲓⲥⲑⲁⲓ	ⲁⲛϩⲏⲕⲉⲓⲥⲑⲁⲓ
ⲁⲛϩⲟⲙⲟⲓⲟⲛ	ⲁⲛϩⲟⲙⲟⲓⲟⲛ
ⲁⲛϩⲟⲥⲓⲟⲥ	ⲁⲛϩⲟⲥⲓⲟⲥ
ⲁⲛϩⲱⲙⲁⲗⲓⲁ	ⲁⲛϩⲱⲙⲁⲗⲓⲁ
ⲁⲛⲁⲃⲁⲑⲙⲟⲥ	ⲁⲛⲁⲃⲁⲑⲙⲟⲥ
ⲁⲛⲁⲃⲁⲥⲓⲥ	ⲁⲛⲁⲃⲁⲥⲓⲥ
ⲁⲛⲁⲅⲕⲁⲍⲉ	ⲁⲛⲁⲅⲕⲁⲍⲉ
ⲁⲛⲁⲅⲕⲁⲓⲟⲛ	ⲁⲛⲁⲅⲕⲁⲓⲟⲛ
ⲁⲛⲁⲅⲕⲁⲓⲟⲥ	ⲁⲛⲁⲅⲕⲁⲓⲟⲥ
ⲁⲛⲁⲅⲕⲏ	ⲁⲛⲁⲅⲕⲏ
ⲁⲛⲁⲅⲕⲏ 	ⲁⲛⲁⲅⲕⲏ 
ⲁⲛⲁⲅⲛⲱⲥⲧⲏⲥ	ⲁⲛⲁⲅⲛⲱⲥⲧⲏⲥ
ⲁⲛⲁⲇⲓⲇⲟⲩ	ⲁⲛⲁⲇⲓⲇⲟⲩ
ⲁⲛⲁⲑⲉⲙⲁⲧⲓⲍⲉ	ⲁⲛⲁⲑⲉⲙⲁⲧⲓⲍⲉ
ⲁⲛⲁⲑⲉⲙⲁ	ⲁⲛⲁⲑⲉⲙⲁ
ⲁⲛⲁⲓⲥⲑⲏⲧⲟⲛ	ⲁⲛⲁⲓⲥⲑⲏⲧⲟⲛ
ⲁⲛⲁⲓⲥⲑⲏⲧⲟⲥ	ⲁⲛⲁⲓⲥⲑⲏⲧⲟⲥ
ⲁⲛⲁⲓⲧⲓⲟⲥ	ⲁⲛⲁⲓⲧⲓⲟⲥ
ⲁⲛⲁⲕⲁⲗⲉⲓ	ⲁⲛⲁⲕⲁⲗⲉⲓ
ⲁⲛⲁⲕⲣⲓⲛⲉ	ⲁⲛⲁⲕⲣⲓⲛⲉ
ⲁⲛⲁⲗⲁⲙⲃⲁⲛⲉ	ⲁⲛⲁⲗⲁⲙⲃⲁⲛⲉ
ⲁⲛⲁⲗⲏⲙⲯⲓⲥ	ⲁⲛⲁⲗⲏⲙⲯⲓⲥ
ⲁⲛⲁⲗⲏⲯⲓⲥ	ⲁⲛⲁⲗⲏⲯⲓⲥ
ⲁⲛⲁⲗⲟⲅⲓⲁ	ⲁⲛⲁⲗⲟⲅⲓⲁ
ⲁⲛⲁⲗⲟⲅⲓⲟⲛ	ⲁⲛⲁⲗⲟⲅⲓⲟⲛ
ⲁⲛⲁⲡⲁⲩⲉ	ⲁⲛⲁⲡⲁⲩⲉ
ⲁⲛⲁⲡⲁⲩⲥⲓⲥ	ⲁⲛⲁⲡⲁⲩⲥⲓⲥ
ⲁⲛⲁⲡⲗⲁⲥⲓⲥ	ⲁⲛⲁⲡⲗⲁⲥⲓⲥ
ⲁⲛⲁⲡⲛⲟⲏ	ⲁⲛⲁⲡⲛⲟⲏ
ⲁⲛⲁⲣⲭⲟⲥ	ⲁⲛⲁⲣⲭⲟⲥ
ⲁⲛⲁⲥⲕⲉⲡⲧⲉⲥⲑⲁⲓ	ⲁⲛⲁⲥⲕⲉⲡⲧⲉⲥⲑⲁⲓ
ⲁⲛⲁⲥⲧⲁⲥⲓⲙⲱⲛ	ⲁⲛⲁⲥⲧⲁⲥⲓⲙⲱⲛ
ⲁⲛⲁⲥⲧⲁⲥⲓⲥ	ⲁⲛⲁⲥⲧⲁⲥⲓⲥ
ⲁⲛⲁⲥⲧⲁⲥⲓ	ⲁⲛⲁⲥⲧⲁⲥⲓ
ⲁⲛⲁⲥⲧⲣⲉⲫⲉⲥⲑⲁⲓ	ⲁⲛⲁⲥⲧⲣⲉⲫⲉⲥⲑⲁⲓ
ⲁⲛⲁⲥⲧⲣⲟⲫⲏ	ⲁⲛⲁⲥⲧⲣⲟⲫⲏ
ⲁⲛⲁⲧⲟⲗⲏ	ⲁⲛⲁⲧⲟⲗⲏ
ⲁⲛⲁⲧⲣⲉⲡⲉ	ⲁⲛⲁⲧⲣⲉⲡⲉ
ⲁⲛⲁⲫⲟⲣⲁ	ⲁⲛⲁⲫⲟⲣⲁ
ⲁⲛⲁⲭⲱⲣⲉⲓ	ⲁⲛⲁⲭⲱⲣⲉⲓ
ⲁⲛⲁⲭⲱⲣⲓⲧⲏⲥ	ⲁⲛⲁⲭⲱⲣⲓⲧⲏⲥ
ⲁⲛⲅⲱⲛ	ⲁⲛⲅⲱⲛ
ⲁⲛⲇⲣⲉⲁⲥ	ⲁⲛⲇⲣⲉⲁⲥ
ⲁⲛⲇⲣⲉⲓⲁⲥ	ⲁⲛⲇⲣⲉⲓⲁⲥ
ⲁⲛⲉⲡⲓⲕⲱⲗⲩⲧⲏⲥ	ⲁⲛⲉⲡⲓⲕⲱⲗⲩⲧⲏⲥ
ⲁⲛⲉⲭⲉⲥⲑⲉ	ⲁⲛⲉⲭⲉⲥⲑⲉ
ⲁⲛⲉⲭⲉ	ⲁⲛⲉⲭⲉ
ⲁⲛⲍⲱⲛⲏ	ⲁⲛⲍⲱⲛⲏ
ⲁⲛⲑⲉⲙⲓⲟⲛ	ⲁⲛⲑⲉⲙⲓⲟⲛ
ⲁⲛⲑⲉⲱⲛⲟⲥ	ⲁⲛⲑⲉⲱⲛⲟⲥ
ⲁⲛⲑⲣⲁⲝ	ⲁⲛⲑⲣⲁⲝ
ⲁⲛⲑⲩⲡⲁⲧⲟⲥ	ⲁⲛⲑⲩⲡⲁⲧⲟⲥ
ⲁⲛⲟⲏⲧⲟⲛ	ⲁⲛⲟⲏⲧⲟⲛ
ⲁⲛⲟⲏⲧⲟⲥ	ⲁⲛⲟⲏⲧⲟⲥ
ⲁⲛⲟⲙⲉⲓ	ⲁⲛⲟⲙⲉⲓ
ⲁⲛⲟⲙⲓⲁ	ⲁⲛⲟⲙⲓⲁ
ⲁⲛⲟⲙⲟⲛ	ⲁⲛⲟⲙⲟⲛ
ⲁⲛⲟⲙⲟⲥ	ⲁⲛⲟⲙⲟⲥ
ⲁⲛⲟⲩⲥⲓⲟⲥ	ⲁⲛⲟⲩⲥⲓⲟⲥ
ⲁⲛⲟⲭⲏ	ⲁⲛⲟⲭⲏ
ⲁⲛⲧⲓⲅⲣⲁⲫⲉ	ⲁⲛⲧⲓⲅⲣⲁⲫⲉ
ⲁⲛⲧⲓⲅⲣⲁⲫⲟⲛ	ⲁⲛⲧⲓⲅⲣⲁⲫⲟⲛ
ⲁⲛⲧⲓⲇⲓⲕⲟⲥ	ⲁⲛⲧⲓⲇⲓⲕⲟⲥ
ⲁⲛⲧⲓⲕⲉⲓⲙⲉⲛⲏ	ⲁⲛⲧⲓⲕⲉⲓⲙⲉⲛⲏ
ⲁⲛⲧⲓⲕⲉⲓⲙⲉⲛⲟⲛ	ⲁⲛⲧⲓⲕⲉⲓⲙⲉⲛⲟⲛ
ⲁⲛⲧⲓⲕⲉⲓⲙⲉⲛⲟⲥ	ⲁⲛⲧⲓⲕⲉⲓⲙⲉⲛⲟⲥ
ⲁⲛⲧⲓⲗⲉⲅⲉ	ⲁⲛⲧⲓⲗⲉⲅⲉ
ⲁⲛⲧⲓⲗⲟⲅⲓⲁ	ⲁⲛⲧⲓⲗⲟⲅⲓⲁ
ⲁⲛⲧⲓⲙⲓⲙⲟⲛ	ⲁⲛⲧⲓⲙⲓⲙⲟⲛ
ⲁⲛⲧⲓⲧⲩⲡⲟⲛ	ⲁⲛⲧⲓⲧⲩⲡⲟⲛ
ⲁⲛⲧⲓⲧⲩⲡⲟⲥ	ⲁⲛⲧⲓⲧⲩⲡⲟⲥ
ⲁⲛⲧⲓⲭⲣⲓⲥⲧⲟⲥ	ⲁⲛⲧⲓⲭⲣⲓⲥⲧⲟⲥ
ⲁⲛⲧⲓ	ⲁⲛⲧⲓ
ⲁⲝⲓⲟⲛ	ⲁⲝⲓⲟⲛ
ⲁⲝⲓⲟⲡⲓⲥⲧⲟⲥ	ⲁⲝⲓⲟⲡⲓⲥⲧⲟⲥ
ⲁⲝⲓⲟⲥ	ⲁⲝⲓⲟⲥ
ⲁⲝⲓⲟⲩ	ⲁⲝⲓⲟⲩ
ⲁⲝⲓⲱⲙⲁⲧⲓⲕⲟⲥ	ⲁⲝⲓⲱⲙⲁⲧⲓⲕⲟⲥ
ⲁⲝⲓⲱⲙⲁⲧⲓⲕⲟⲥ 	ⲁⲝⲓⲱⲙⲁⲧⲓⲕⲟⲥ 
ⲁⲝⲓⲱⲙⲁ	ⲁⲝⲓⲱⲙⲁ
ⲁⲡⲁⲅⲅⲉⲓⲗⲉ	ⲁⲡⲁⲅⲅⲉⲓⲗⲉ
ⲁⲡⲁⲓⲇⲉ	ⲁⲡⲁⲓⲇⲉ
ⲁⲡⲁⲛⲑⲣⲟⲡⲓⲁ	ⲁⲡⲁⲛⲑⲣⲟⲡⲓⲁ
ⲁⲡⲁⲛⲧⲁ	ⲁⲡⲁⲛⲧⲁ
ⲁⲡⲁⲛⲧⲏ	ⲁⲡⲁⲛⲧⲏ
ⲁⲡⲁⲛⲧⲩⲙⲁ	ⲁⲡⲁⲛⲧⲩⲙⲁ
ⲁⲡⲁⲣⲛⲁ	ⲁⲡⲁⲣⲛⲁ
ⲁⲡⲁⲣⲭⲏ	ⲁⲡⲁⲣⲭⲏ
ⲁⲡⲁⲧⲁ	ⲁⲡⲁⲧⲁ
ⲁⲡⲁⲧⲏ	ⲁⲡⲁⲧⲏ
ⲁⲡⲁⲩⲥⲧⲱⲥ	ⲁⲡⲁⲩⲥⲧⲱⲥ
ⲁⲡⲉⲓⲗⲉ	ⲁⲡⲉⲓⲗⲉ
ⲁⲡⲉⲓⲗⲏ	ⲁⲡⲉⲓⲗⲏ
ⲁⲡⲉⲣⲁⲛⲧⲟⲛ	ⲁⲡⲉⲣⲁⲛⲧⲟⲛ
ⲁⲡⲉⲣⲁⲛⲧⲟⲥ	ⲁⲡⲉⲣⲁⲛⲧⲟⲥ
ⲁⲡⲓⲥⲧⲉⲓ	ⲁⲡⲓⲥⲧⲉⲓ
ⲁⲡⲓⲥⲧⲓⲁ	ⲁⲡⲓⲥⲧⲓⲁ
ⲁⲡⲓⲥⲧⲟⲛ	ⲁⲡⲓⲥⲧⲟⲛ
ⲁⲡⲓⲥⲧⲟⲥ	ⲁⲡⲓⲥⲧⲟⲥ
ⲁⲡⲟϩⲣⲏⲧⲟⲥ	ⲁⲡⲟϩⲣⲏⲧⲟⲥ
ⲁⲡⲟⲅⲣⲁⲫⲏ	ⲁⲡⲟⲅⲣⲁⲫⲏ
ⲁⲡⲟⲇⲉⲓⲝⲓⲥ	ⲁⲡⲟⲇⲉⲓⲝⲓⲥ
ⲁⲡⲟⲇⲏⲙⲉⲓ	ⲁⲡⲟⲇⲏⲙⲉⲓ
ⲁⲡⲟⲇⲏⲙⲓⲁ	ⲁⲡⲟⲇⲏⲙⲓⲁ
ⲁⲡⲟⲇⲓⲕⲛⲩⲉ	ⲁⲡⲟⲇⲓⲕⲛⲩⲉ
ⲁⲡⲟⲇⲓⲝⲓⲥ	ⲁⲡⲟⲇⲓⲝⲓⲥ
ⲁⲡⲟⲑⲏⲕⲏ	ⲁⲡⲟⲑⲏⲕⲏ
ⲁⲡⲟⲕⲁⲑⲓⲥⲧⲁ	ⲁⲡⲟⲕⲁⲑⲓⲥⲧⲁ
ⲁⲡⲟⲕⲁⲗⲩⲯⲓⲥ	ⲁⲡⲟⲕⲁⲗⲩⲯⲓⲥ
ⲁⲡⲟⲕⲁⲧⲁⲥⲧⲁⲥⲓⲥ	ⲁⲡⲟⲕⲁⲧⲁⲥⲧⲁⲥⲓⲥ
ⲁⲡⲟⲕⲗⲏⲣⲟⲥ	ⲁⲡⲟⲕⲗⲏⲣⲟⲥ
ⲁⲡⲟⲕⲣⲓⲥⲓⲥ	ⲁⲡⲟⲕⲣⲓⲥⲓⲥ
ⲁⲡⲟⲕⲣⲓⲧⲏⲥ	ⲁⲡⲟⲕⲣⲓⲧⲏⲥ
ⲁⲡⲟⲕⲣⲩⲫⲟⲛ	ⲁⲡⲟⲕⲣⲩⲫⲟⲛ
ⲁⲡⲟⲗⲁⲩⲉ	ⲁⲡⲟⲗⲁⲩⲉ
ⲁⲡⲟⲗⲁⲩⲥⲓⲥ	ⲁⲡⲟⲗⲁⲩⲥⲓⲥ
ⲁⲡⲟⲗⲗⲱⲛ	ⲁⲡⲟⲗⲗⲱⲛ
ⲁⲡⲟⲗⲟⲅⲓⲁ	ⲁⲡⲟⲗⲟⲅⲓⲁ
ⲁⲡⲟⲗⲟⲅⲓⲍⲉ	ⲁⲡⲟⲗⲟⲅⲓⲍⲉ
ⲁⲡⲟⲗⲩ	ⲁⲡⲟⲗⲩ
ⲁⲡⲟⲛⲉⲁ	ⲁⲡⲟⲛⲉⲁ
ⲁⲡⲟⲛⲟⲓⲁ	ⲁⲡⲟⲛⲟⲓⲁ
ⲁⲡⲟⲣⲉⲓ	ⲁⲡⲟⲣⲉⲓ
ⲁⲡⲟⲣⲓ	ⲁⲡⲟⲣⲓ
ⲁⲡⲟⲣⲣⲟⲓⲁ	ⲁⲡⲟⲣⲣⲟⲓⲁ
ⲁⲡⲟⲥⲕⲉⲩⲏ	ⲁⲡⲟⲥⲕⲉⲩⲏ
ⲁⲡⲟⲥⲧⲁⲗⲙⲉⲛⲟⲥ	ⲁⲡⲟⲥⲧⲁⲗⲙⲉⲛⲟⲥ
ⲁⲡⲟⲥⲧⲁⲧⲏⲥ	ⲁⲡⲟⲥⲧⲁⲧⲏⲥ
ⲁⲡⲟⲥⲧⲉⲣⲓ	ⲁⲡⲟⲥⲧⲉⲣⲓ
ⲁⲡⲟⲥⲧⲏⲑⲓⲍⲉ	ⲁⲡⲟⲥⲧⲏⲑⲓⲍⲉ
ⲁⲡⲟⲥⲧⲟⲗⲏ	ⲁⲡⲟⲥⲧⲟⲗⲏ
ⲁⲡⲟⲥⲧⲟⲗⲓⲕⲏ	ⲁⲡⲟⲥⲧⲟⲗⲓⲕⲏ
ⲁⲡⲟⲥⲧⲟⲗⲓⲕⲟⲛ	ⲁⲡⲟⲥⲧⲟⲗⲓⲕⲟⲛ
ⲁⲡⲟⲥⲧⲟⲗⲟⲥ	ⲁⲡⲟⲥⲧⲟⲗⲟⲥ
ⲁⲡⲟⲥⲩⲛⲁⲅⲱⲅⲟⲥ	ⲁⲡⲟⲥⲩⲛⲁⲅⲱⲅⲟⲥ
ⲁⲡⲟⲧⲁⲅⲏ	ⲁⲡⲟⲧⲁⲅⲏ
ⲁⲡⲟⲧⲁⲥⲥⲉ	ⲁⲡⲟⲧⲁⲥⲥⲉ
ⲁⲡⲟⲧⲉⲗⲉⲥⲙⲁ	ⲁⲡⲟⲧⲉⲗⲉⲥⲙⲁ
ⲁⲡⲟⲫⲁⲛⲉ	ⲁⲡⲟⲫⲁⲛⲉ
ⲁⲡⲟⲫⲁⲥⲓⲥ	ⲁⲡⲟⲫⲁⲥⲓⲥ
ⲁⲡⲟⲭⲁⲣⲓⲍⲉ	ⲁⲡⲟⲭⲁⲣⲓⲍⲉ
ⲁⲡⲟⲭⲏ	ⲁⲡⲟⲭⲏ
ⲁⲡⲣⲁⲕⲧⲟⲥ	ⲁⲡⲣⲁⲕⲧⲟⲥ
ⲁⲣⲁⲃⲟⲥ	ⲁⲣⲁⲃⲟⲥ
ⲁⲣⲁⲥⲑⲉ	ⲁⲣⲁⲥⲑⲉ
ⲁⲣⲁ	ⲁⲣⲁ
ⲁⲣⲅⲟⲛ	ⲁⲣⲅⲟⲛ
ⲁⲣⲅⲟⲥ	ⲁⲣⲅⲟⲥ
ⲁⲣⲉⲥⲕⲉ	ⲁⲣⲉⲥⲕⲉ
ⲁⲣⲉⲧⲏ	ⲁⲣⲉⲧⲏ
ⲁⲣⲓⲑⲙⲓⲁ	ⲁⲣⲓⲑⲙⲓⲁ
ⲁⲣⲓⲑⲙⲓⲟⲛ	ⲁⲣⲓⲑⲙⲓⲟⲛ
ⲁⲣⲓⲑⲙⲟⲥ	ⲁⲣⲓⲑⲙⲟⲥ
ⲁⲣⲓⲥⲧⲁ	ⲁⲣⲓⲥⲧⲁ
ⲁⲣⲓⲥⲧⲟⲛ	ⲁⲣⲓⲥⲧⲟⲛ
ⲁⲣⲕⲉⲩⲑⲟⲥ	ⲁⲣⲕⲉⲩⲑⲟⲥ
ⲁⲣⲕⲟⲥ	ⲁⲣⲕⲟⲥ
ⲁⲣⲕⲧⲟⲥ	ⲁⲣⲕⲧⲟⲥ
ⲁⲣⲛⲁ	ⲁⲣⲛⲁ
ⲁⲣⲛⲏⲥⲓⲥ	ⲁⲣⲛⲏⲥⲓⲥ
ⲁⲣⲛⲓⲥⲑⲉ	ⲁⲣⲛⲓⲥⲑⲉ
ⲁⲣⲝ	ⲁⲣⲝ
ⲁⲣⲣⲏⲧⲟⲛ	ⲁⲣⲣⲏⲧⲟⲛ
ⲁⲣⲣⲏⲧⲟⲥ	ⲁⲣⲣⲏⲧⲟⲥ
ⲁⲣⲥⲉⲛⲟⲅⲉⲛⲓⲁ	ⲁⲣⲥⲉⲛⲟⲅⲉⲛⲓⲁ
ⲁⲣⲥⲓⲛⲓⲕⲟⲛ	ⲁⲣⲥⲓⲛⲓⲕⲟⲛ
ⲁⲣⲧⲏⲣⲓⲁ	ⲁⲣⲧⲏⲣⲓⲁ
ⲁⲣⲧⲩⲙⲓⲥ	ⲁⲣⲧⲩⲙⲓⲥ
ⲁⲣⲭⲁⲅⲅⲉⲗⲓⲕⲏ	ⲁⲣⲭⲁⲅⲅⲉⲗⲓⲕⲏ
ⲁⲣⲭⲁⲅⲅⲉⲗⲟⲥ	ⲁⲣⲭⲁⲅⲅⲉⲗⲟⲥ
ⲁⲣⲭⲁⲓⲟⲛ	ⲁⲣⲭⲁⲓⲟⲛ
ⲁⲣⲭⲁⲓⲟⲥ	ⲁⲣⲭⲁⲓⲟⲥ
ⲁⲣⲭⲉⲓ	ⲁⲣⲭⲉⲓ
ⲁⲣⲭⲉⲥⲑⲁⲓ	ⲁⲣⲭⲉⲥⲑⲁⲓ
ⲁⲣⲭⲏϯϩⲁⲡ	ⲁⲣⲭⲏ|ϯ|ϩⲁⲡ
ⲁⲣⲭⲏⲅⲟⲥ	ⲁⲣⲭⲏⲅⲟⲥ
ⲁⲣⲭⲏⲇⲓⲁⲕⲟⲛⲟⲥ	ⲁⲣⲭⲏⲇⲓⲁⲕⲟⲛⲟⲥ
ⲁⲣⲭⲏⲇⲓⲁⲕⲱⲛ	ⲁⲣⲭⲏⲇⲓⲁⲕⲱⲛ
ⲁⲣⲭⲏⲉⲡⲓⲥⲕⲟⲡⲟⲥ	ⲁⲣⲭⲏⲉⲡⲓⲥⲕⲟⲡⲟⲥ
ⲁⲣⲭⲏⲑⲗⲓⲧⲏⲥ	ⲁⲣⲭⲏⲑⲗⲓⲧⲏⲥ
ⲁⲣⲭⲏⲕⲣⲓⲧⲏⲥ	ⲁⲣⲭⲏⲕⲣⲓⲧⲏⲥ
ⲁⲣⲭⲏⲡⲗⲁⲥⲙⲁ	ⲁⲣⲭⲏⲡⲗⲁⲥⲙⲁ
ⲁⲣⲭⲏⲡⲣⲉⲥⲃⲩⲧⲉⲣⲟⲥ	ⲁⲣⲭⲏⲡⲣⲉⲥⲃⲩⲧⲉⲣⲟⲥ
ⲁⲣⲭⲏⲡⲣⲟⲫⲏⲧⲏⲥ	ⲁⲣⲭⲏⲡⲣⲟⲫⲏⲧⲏⲥ
ⲁⲣⲭⲏⲥⲧⲣⲁⲧⲩⲗⲁⲧⲏⲥ	ⲁⲣⲭⲏⲥⲧⲣⲁⲧⲩⲗⲁⲧⲏⲥ
ⲁⲣⲭⲏ	ⲁⲣⲭⲏ
ⲁⲣⲭⲓⲅⲉⲛⲉⲧⲱⲣ	ⲁⲣⲭⲓⲅⲉⲛⲉⲧⲱⲣ
ⲁⲣⲭⲓⲅⲉⲛⲛⲏⲧⲱⲣ	ⲁⲣⲭⲓⲅⲉⲛⲛⲏⲧⲱⲣ
ⲁⲣⲭⲓⲉⲣⲉⲩⲥ	ⲁⲣⲭⲓⲉⲣⲉⲩⲥ
ⲁⲣⲭⲓⲙⲁⲅⲉⲣⲟⲥ	ⲁⲣⲭⲓⲙⲁⲅⲉⲣⲟⲥ
ⲁⲣⲭⲓⲙⲁⲛⲇⲣⲓⲧⲏⲥ	ⲁⲣⲭⲓⲙⲁⲛⲇⲣⲓⲧⲏⲥ
ⲁⲣⲭⲓⲥⲧⲣⲁⲧⲉⲩⲙⲁ	ⲁⲣⲭⲓⲥⲧⲣⲁⲧⲉⲩⲙⲁ
ⲁⲣⲭⲓⲥⲧⲣⲁⲧⲏⲅⲟⲥ	ⲁⲣⲭⲓⲥⲧⲣⲁⲧⲏⲅⲟⲥ
ⲁⲣⲭⲓⲥⲩⲛⲁⲅⲱⲅⲟⲥ	ⲁⲣⲭⲓⲥⲩⲛⲁⲅⲱⲅⲟⲥ
ⲁⲣⲭⲟⲛⲧⲓⲕⲏ	ⲁⲣⲭⲟⲛⲧⲓⲕⲏ
ⲁⲣⲭⲟⲛⲧⲓⲕⲟⲛ	ⲁⲣⲭⲟⲛⲧⲓⲕⲟⲛ
ⲁⲣⲭⲱⲛ	ⲁⲣⲭⲱⲛ
ⲁⲣⲱⲙⲁⲧⲁ	ⲁⲣⲱⲙⲁⲧⲁ
ⲁⲥⲁⲗⲉⲩⲧⲟⲥ	ⲁⲥⲁⲗⲉⲩⲧⲟⲥ
ⲁⲥⲉⲃⲏⲥ	ⲁⲥⲉⲃⲏⲥ
ⲁⲥⲏⲙⲁⲛⲧⲟⲥ	ⲁⲥⲏⲙⲁⲛⲧⲟⲥ
ⲁⲥⲏⲙⲓⲟⲥ	ⲁⲥⲏⲙⲓⲟⲥ
ⲁⲥⲑⲉⲛⲉⲓⲁ	ⲁⲥⲑⲉⲛⲉⲓⲁ
ⲁⲥⲑⲉⲛⲏⲥ	ⲁⲥⲑⲉⲛⲏⲥ
ⲁⲥⲕⲉⲓ	ⲁⲥⲕⲉⲓ
ⲁⲥⲕⲏⲥⲓⲥ	ⲁⲥⲕⲏⲥⲓⲥ
ⲁⲥⲕⲏⲧⲏⲥ	ⲁⲥⲕⲏⲧⲏⲥ
ⲁⲥⲕⲏⲧⲓⲕⲟⲛ	ⲁⲥⲕⲏⲧⲓⲕⲟⲛ
ⲁⲥⲕⲟⲥ	ⲁⲥⲕⲟⲥ
ⲁⲥⲡⲁⲍⲉ	ⲁⲥⲡⲁⲍⲉ
ⲁⲥⲡⲁⲗⲁⲑⲟⲥ	ⲁⲥⲡⲁⲗⲁⲑⲟⲥ
ⲁⲥⲡⲁⲥⲙⲟⲥ	ⲁⲥⲡⲁⲥⲙⲟⲥ
ⲁⲥⲥⲁⲣⲓⲟⲛ	ⲁⲥⲥⲁⲣⲓⲟⲛ
ⲁⲥⲥⲩⲣⲓⲟⲥ	ⲁⲥⲥⲩⲣⲓⲟⲥ
ⲁⲥⲧⲏⲣ	ⲁⲥⲧⲏⲣ
ⲁⲥⲧⲓⲟⲥ	ⲁⲥⲧⲓⲟⲥ
ⲁⲥⲩⲛⲑⲉⲧⲟⲛ	ⲁⲥⲩⲛⲑⲉⲧⲟⲛ
ⲁⲥⲫⲁⲗⲏⲥ	ⲁⲥⲫⲁⲗⲏⲥ
ⲁⲥⲫⲁⲗⲓⲁ	ⲁⲥⲫⲁⲗⲓⲁ
ⲁⲥⲫⲁⲗⲓⲍⲉ	ⲁⲥⲫⲁⲗⲓⲍⲉ
ⲁⲥⲫⲁⲗⲱⲥ	ⲁⲥⲫⲁⲗⲱⲥ
ⲁⲥⲭⲏⲙⲟⲛⲉⲓ	ⲁⲥⲭⲏⲙⲟⲛⲉⲓ
ⲁⲥⲭⲏⲙⲟⲥⲩⲛⲏ	ⲁⲥⲭⲏⲙⲟⲥⲩⲛⲏ
ⲁⲥⲱⲙⲁⲧⲟⲛ	ⲁⲥⲱⲙⲁⲧⲟⲛ
ⲁⲥⲱⲙⲁⲧⲟⲥ	ⲁⲥⲱⲙⲁⲧⲟⲥ
ⲁⲧϣⲁⲩ	ⲁⲧ|ϣⲁⲩ
ⲁⲧϣⲉⲗⲉⲉⲧ	ⲁⲧ|ϣⲉⲗⲉⲉⲧ
ⲁⲧϩⲏⲧ	ⲁⲧ|ϩⲏⲧ
ⲁⲧϩⲟⲧⲉ	ⲁⲧ|ϩⲟⲧⲉ
ⲁⲧϩⲩⲗⲏ	ⲁⲧ|ϩⲩⲗⲏ
ⲁⲧⲁⲑⲉⲧⲉⲓ	ⲁⲧ|ⲁⲑⲉⲧⲉⲓ
ⲁⲧⲁⲕⲧⲱⲥ	ⲁⲧⲁⲕⲧⲱⲥ
ⲁⲧⲁⲙⲁⲛⲇⲓⲛⲟⲛ	ⲁⲧⲁⲙⲁⲛⲇⲓⲛⲟⲛ
ⲁⲧⲁⲝⲓⲁ	ⲁⲧⲁⲝⲓⲁ
ⲁⲧⲇⲓⲁⲕⲣⲓⲛⲉ	ⲁⲧ|ⲇⲓⲁⲕⲣⲓⲛⲉ
ⲁⲧⲉⲗⲏⲥ	ⲁⲧⲉⲗⲏⲥ
ⲁⲧⲉⲛⲱⲭⲗⲓ	ⲁⲧ|ⲉⲛⲱⲭⲗⲓ
ⲁⲧⲉⲩⲁⲅⲅⲉⲗⲉⲓ	ⲁⲧ|ⲉⲩⲁⲅⲅⲉⲗⲉⲓ
ⲁⲧⲑⲁⲃ	ⲁⲧ|ⲑⲁⲃ
ⲁⲧⲓⲙⲓⲁ	ⲁⲧⲓⲙⲓⲁ
ⲁⲧⲓⲙⲟⲥ	ⲁⲧⲓⲙⲟⲥ
ⲁⲧⲕⲁϭⲓⲁ	ⲁⲧ|ⲕⲁϭⲓⲁ
ⲁⲧⲕⲁⲕⲓⲁ	ⲁⲧ|ⲕⲁⲕⲓⲁ
ⲁⲧⲕⲁⲣⲡⲟⲥ	ⲁⲧ|ⲕⲁⲣⲡⲟⲥ
ⲁⲧⲕⲁⲧⲁⲗⲩⲉ	ⲁⲧ|ⲕⲁⲧⲁⲗⲩⲉ
ⲁⲧⲗⲟⲅⲟⲥ	ⲁⲧ|ⲗⲟⲅⲟⲥ
ⲁⲧⲙⲛ̣ⲓ̣ⲁⲕⲟⲛ	ⲁⲧ|ⲙⲛ̣ⲓ̣ⲁⲕⲟⲛ
ⲁⲧⲙⲟⲩⲛⲅ	ⲁⲧ|ⲙⲟⲩⲛⲅ
ⲁⲧⲛⲁϩⲧⲉ	ⲁⲧ|ⲛⲁϩⲧⲉ
ⲁⲧⲛⲁ	ⲁⲧ|ⲛⲁ
ⲁⲧⲛⲟⲓ	ⲁⲧ|ⲛⲟⲓ
ⲁⲧⲛⲟⲩⲥ	ⲁⲧ|ⲛⲟⲩⲥ
ⲁⲧⲟⲩⲥⲓⲁ	ⲁⲧ|ⲟⲩⲥⲓⲁ
ⲁⲧⲟⲩⲱ	ⲁⲧ|ⲟⲩⲱ
ⲁⲧⲡⲁⲣⲁⲃⲁ	ⲁⲧ|ⲡⲁⲣⲁⲃⲁ
ⲁⲧⲡⲁⲣⲁⲥⲉⲗⲉⲩⲉ	ⲁⲧ|ⲡⲁⲣⲁⲥⲉⲗⲉⲩⲉ
ⲁⲧⲡⲛⲉⲩⲙⲁ	ⲁⲧ|ⲡⲛⲉⲩⲙⲁ
ⲁⲧⲣⲉⲡⲧⲟⲥ	ⲁⲧⲣⲉⲡⲧⲟⲥ
ⲁⲧⲣⲟⲟⲩϣ	ⲁⲧ|ⲣⲟⲟⲩϣ
ⲁⲧⲥⲁⲣⲁⲝ	ⲁⲧ|ⲥⲁⲣⲁⲝ
ⲁⲧⲥⲃⲃⲉ	ⲁⲧ|ⲥⲃⲃⲉ
ⲁⲧⲥⲃⲱ	ⲁⲧ|ⲥⲃⲱ
ⲁⲧⲥⲭⲏⲙⲁ	ⲁⲧ|ⲥⲭⲏⲙⲁ
ⲁⲧⲥⲱⲙⲁ	ⲁⲧ|ⲥⲱⲙⲁ
ⲁⲧⲥⲱⲧⲙ	ⲁⲧ|ⲥⲱⲧⲙ
ⲁⲧⲧⲁⲕⲟ	ⲁⲧ|ⲧⲁⲕⲟ
ⲁⲧⲭⲁⲣⲁⲕⲧⲏⲣ	ⲁⲧ|ⲭⲁⲣⲁⲕⲧⲏⲣ
ⲁⲩⲑⲁⲇⲏⲥ	ⲁⲩⲑⲁⲇⲏⲥ
ⲁⲩⲑⲉⲛⲧⲉⲓⲁ	ⲁⲩⲑⲉⲛⲧⲉⲓⲁ
ⲁⲩⲑⲉⲛⲧⲏⲥ	ⲁⲩⲑⲉⲛⲧⲏⲥ
ⲁⲩⲑⲉⲛⲧⲓⲕⲏ	ⲁⲩⲑⲉⲛⲧⲓⲕⲏ
ⲁⲩⲗⲏ	ⲁⲩⲗⲏ
ⲁⲩⲝⲁⲛⲉ	ⲁⲩⲝⲁⲛⲉ
ⲁⲩⲝⲓⲥⲓⲥ	ⲁⲩⲝⲓⲥⲓⲥ
ⲁⲩⲧⲟⲅⲉⲛⲏⲥ	ⲁⲩⲧⲟⲅⲉⲛⲏⲥ
ⲁⲩⲧⲟⲅⲉⲛⲏⲧⲟⲥ	ⲁⲩⲧⲟⲅⲉⲛⲏⲧⲟⲥ
ⲁⲩⲧⲟⲅⲉⲛⲛⲓⲟⲥ	ⲁⲩⲧⲟⲅⲉⲛⲛⲓⲟⲥ
ⲁⲩⲧⲟⲇⲟⲝⲁⲥⲧⲟⲥ	ⲁⲩⲧⲟⲇⲟⲝⲁⲥⲧⲟⲥ
ⲁⲩⲧⲟⲑⲉⲗⲏⲧⲟⲥ	ⲁⲩⲧⲟⲑⲉⲗⲏⲧⲟⲥ
ⲁⲩⲧⲟⲕⲣⲁⲧⲱⲣ	ⲁⲩⲧⲟⲕⲣⲁⲧⲱⲣ
ⲁⲩⲧⲟⲡⲁⲧⲱⲣ	ⲁⲩⲧⲟⲡⲁⲧⲱⲣ
ⲁⲩⲧⲟⲧⲉⲗⲏⲥ	ⲁⲩⲧⲟⲧⲉⲗⲏⲥ
ⲁⲩⲧⲟⲫⲩⲏⲥ	ⲁⲩⲧⲟⲫⲩⲏⲥ
ⲁⲫⲉⲇⲣⲱⲛ	ⲁⲫⲉⲇⲣⲱⲛ
ⲁⲫⲉⲗⲡⲓⲍⲉ	ⲁⲫⲉⲗⲡⲓⲍⲉ
ⲁⲫⲑⲁⲣⲥⲓⲁ	ⲁⲫⲑⲁⲣⲥⲓⲁ
ⲁⲫⲑⲁⲣⲧⲟⲛ	ⲁⲫⲑⲁⲣⲧⲟⲛ
ⲁⲫⲑⲁⲣⲧⲟⲥ	ⲁⲫⲑⲁⲣⲧⲟⲥ
ⲁⲫⲑⲟⲣⲟⲥ	ⲁⲫⲑⲟⲣⲟⲥ
ⲁⲫⲟⲣⲓⲥⲙⲟⲥ	ⲁⲫⲟⲣⲓⲥⲙⲟⲥ
ⲁⲫⲟⲣⲙⲏ	ⲁⲫⲟⲣⲙⲏ
ⲁⲫⲣⲏⲇⲱⲛⲓⲁ	ⲁⲫⲣⲏⲇⲱⲛⲓⲁ
ⲁⲫⲱⲣⲓⲥⲉ	ⲁⲫⲱⲣⲓⲥⲉ
ⲁⲭⲁⲧⲏⲥ	ⲁⲭⲁⲧⲏⲥ
ⲁⲭⲓⲗⲗⲓⲟⲛ	ⲁⲭⲓⲗⲗⲓⲟⲛ
ⲁⲭⲱⲣⲏⲧⲟⲥ	ⲁⲭⲱⲣⲏⲧⲟⲥ
ⲁⲯⲩⲭⲟⲛ	ⲁⲯⲩⲭⲟⲛ
ⲃⲁⲃⲉⲣⲱⲙⲉ	ⲃⲁⲃⲉ|ⲣⲱⲙⲉ
ⲃⲁⲑⲙⲟⲥ	ⲃⲁⲑⲙⲟⲥ
ⲃⲁⲑⲟⲛ	ⲃⲁⲑⲟⲛ
ⲃⲁⲑⲟⲥ	ⲃⲁⲑⲟⲥ
ⲃⲁⲕⲧⲏⲣⲓⲁ	ⲃⲁⲕⲧⲏⲣⲓⲁ
ⲃⲁⲗⲁⲧ	ⲃⲁⲗⲁⲧ
ⲃⲁⲡⲧⲓⲍⲉ	ⲃⲁⲡⲧⲓⲍⲉ
ⲃⲁⲡⲧⲓⲥⲙⲁ	ⲃⲁⲡⲧⲓⲥⲙⲁ
ⲃⲁⲡⲧⲓⲥⲙⲟⲥ	ⲃⲁⲡⲧⲓⲥⲙⲟⲥ
ⲃⲁⲡⲧⲓⲥⲧⲏⲥ	ⲃⲁⲡⲧⲓⲥⲧⲏⲥ
ⲃⲁⲣⲃⲁⲣⲟⲥ	ⲃⲁⲣⲃⲁⲣⲟⲥ
ⲃⲁⲣⲉⲓⲥⲑⲁⲓ	ⲃⲁⲣⲉⲓⲥⲑⲁⲓ
ⲃⲁⲣⲉⲓ	ⲃⲁⲣⲉⲓ
ⲃⲁⲣⲟⲥ	ⲃⲁⲣⲟⲥ
ⲃⲁⲥⲁⲛⲓⲍⲉ	ⲃⲁⲥⲁⲛⲓⲍⲉ
ⲃⲁⲥⲁⲛⲓⲥⲧⲏⲣⲓⲟⲛ	ⲃⲁⲥⲁⲛⲓⲥⲧⲏⲣⲓⲟⲛ
ⲃⲁⲥⲁⲛⲓⲥⲧⲏⲥ	ⲃⲁⲥⲁⲛⲓⲥⲧⲏⲥ
ⲃⲁⲥⲁⲛⲟⲥ	ⲃⲁⲥⲁⲛⲟⲥ
ⲃⲁⲥⲓⲗⲓⲕⲟⲥ	ⲃⲁⲥⲓⲗⲓⲕⲟⲥ
ⲃⲁⲥⲓⲥ	ⲃⲁⲥⲓⲥ
ⲃⲁⲥⲕⲁⲛⲟⲥ	ⲃⲁⲥⲕⲁⲛⲟⲥ
ⲃⲁⲥⲧⲉⲣⲛⲁ	ⲃⲁⲥⲧⲉⲣⲛⲁ
ⲃⲁⲧⲁⲛⲉ	ⲃⲁⲧⲁⲛⲉ
ⲃⲁⲧⲟⲥ	ⲃⲁⲧⲟⲥ
ⲃⲁⲧⲧⲁⲗⲟⲅⲓ	ⲃⲁⲧⲧⲁⲗⲟⲅⲓ
ⲃⲁⲧⲧⲟⲗⲟⲅⲓⲁ	ⲃⲁⲧⲧⲟⲗⲟⲅⲓⲁ
ⲃⲇⲉⲗⲗⲏ	ⲃⲇⲉⲗⲗⲏ
ⲃⲉⲃⲁⲓⲟⲩ	ⲃⲉⲃⲁⲓⲟⲩ
ⲃⲉⲣⲉⲧⲁⲣⲓⲟⲥ	ⲃⲉⲣⲉⲧⲁⲣⲓⲟⲥ
ⲃⲉⲥⲉ	ⲃⲉⲥⲉ
ⲃⲏⲙⲁ	ⲃⲏⲙⲁ
ⲃⲓⲁⲍⲉ	ⲃⲓⲁⲍⲉ
ⲃⲓⲁ	ⲃⲓⲁ
ⲃⲓⲃⲗⲓⲟⲑⲩⲕⲏ	ⲃⲓⲃⲗⲓⲟⲑⲩⲕⲏ
ⲃⲓⲃⲗⲟⲥ	ⲃⲓⲃⲗⲟⲥ
ⲃⲓⲕⲁⲣⲓⲟⲥ	ⲃⲓⲕⲁⲣⲓⲟⲥ
ⲃⲓⲟⲥ	ⲃⲓⲟⲥ
ⲃⲓⲱⲧⲓⲕⲟⲛ	ⲃⲓⲱⲧⲓⲕⲟⲛ
ⲃⲓⲱⲧⲓⲕⲟⲥ	ⲃⲓⲱⲧⲓⲕⲟⲥ
ⲃⲗⲁⲃⲏ	ⲃⲗⲁⲃⲏ
ⲃⲗⲁⲡⲧⲉⲓ	ⲃⲗⲁⲡⲧⲉⲓ
ⲃⲗⲁⲥⲫⲏⲙⲓⲁ	ⲃⲗⲁⲥⲫⲏⲙⲓⲁ
ⲃⲟⲏⲑⲉⲓⲁ	ⲃⲟⲏⲑⲉⲓⲁ
ⲃⲟⲏⲑⲉⲓ	ⲃⲟⲏⲑⲉⲓ
ⲃⲟⲏⲑⲟⲥ	ⲃⲟⲏⲑⲟⲥ
ⲃⲟⲣⲃⲟⲣⲟⲥ	ⲃⲟⲣⲃⲟⲣⲟⲥ
ⲃⲟⲧⲁⲛⲏ	ⲃⲟⲧⲁⲛⲏ
ⲃⲟⲩⲗⲏⲥⲓⲥ	ⲃⲟⲩⲗⲏⲥⲓⲥ
ⲃⲟⲩⲛⲉⲩⲣⲟⲛ	ⲃⲟⲩⲛⲉⲩⲣⲟⲛ
ⲃⲟⲩⲛⲟⲥ	ⲃⲟⲩⲛⲟⲥ
ⲃⲣⲁⲃⲓⲟⲛ	ⲃⲣⲁⲃⲓⲟⲛ
ⲃⲣⲁⲭⲙⲁⲛⲏⲥ	ⲃⲣⲁⲭⲙⲁⲛⲏⲥ
ⲃⲣⲟⲛⲧⲏ	ⲃⲣⲟⲛⲧⲏ
ⲃⲣⲟⲩⲭⲟⲥ	ⲃⲣⲟⲩⲭⲟⲥ
ⲃⲩⲃⲓⲟⲛ	ⲃⲩⲃⲓⲟⲛ
ⲃⲩⲣⲣⲩⲗⲗⲟⲥ	ⲃⲩⲣⲣⲩⲗⲗⲟⲥ
ⲃⲱⲗⲟⲥ	ⲃⲱⲗⲟⲥ
ⲃⲱⲙⲟⲥ	ⲃⲱⲙⲟⲥ
ⲅⲁⲍⲁ	ⲅⲁⲍⲁ
ⲅⲁⲍⲟⲫⲩⲗⲁⲕⲓⲟⲛ	ⲅⲁⲍⲟⲫⲩⲗⲁⲕⲓⲟⲛ
ⲅⲁⲗⲁⲕⲧⲓⲧⲏⲥ	ⲅⲁⲗⲁⲕⲧⲓⲧⲏⲥ
ⲅⲁⲗⲓⲗⲁⲓⲟⲥ	ⲅⲁⲗⲓⲗⲁⲓⲟⲥ
ⲅⲁⲗⲗⲓⲕⲟⲥ	ⲅⲁⲗⲗⲓⲕⲟⲥ
ⲅⲁⲙⲟⲥ	ⲅⲁⲙⲟⲥ
ⲅⲁⲡⲁⲣⲓ	ⲅⲁⲡⲁⲣⲓ
ⲅⲁⲣ	ⲅⲁⲣ
ⲅⲉⲑⲑⲁⲓⲟⲥ	ⲅⲉⲑⲑⲁⲓⲟⲥ
ⲅⲉⲛⲉⲁ	ⲅⲉⲛⲉⲁ
ⲅⲉⲛⲉⲥⲓⲥ	ⲅⲉⲛⲉⲥⲓⲥ
ⲅⲉⲛⲏⲙⲁ	ⲅⲉⲛⲏⲙⲁ
ⲅⲉⲛⲏⲧⲟⲛ	ⲅⲉⲛⲏⲧⲟⲛ
ⲅⲉⲛⲓⲕⲟⲥ	ⲅⲉⲛⲓⲕⲟⲥ
ⲅⲉⲛⲛⲉⲁ	ⲅⲉⲛⲛⲉⲁ
ⲅⲉⲛⲛⲉⲟⲥ	ⲅⲉⲛⲛⲉⲟⲥ
ⲅⲉⲛⲟⲓⲧⲟ	ⲅⲉⲛⲟⲓⲧⲟ
ⲅⲉⲛⲟⲥ	ⲅⲉⲛⲟⲥ
ⲅⲉⲣⲁⲍⲏⲛⲟⲥ	ⲅⲉⲣⲁⲍⲏⲛⲟⲥ
ⲅⲉⲣⲅⲉⲥⲁⲓⲟⲥ	ⲅⲉⲣⲅⲉⲥⲁⲓⲟⲥ
ⲅⲉⲱⲙⲓⲧⲣⲏⲥ	ⲅⲉⲱⲙⲓⲧⲣⲏⲥ
ⲅⲉⲱⲣⲅⲟⲥ	ⲅⲉⲱⲣⲅⲟⲥ
ⲅⲉ	ⲅⲉ
ⲅⲓⲅⲁⲥ	ⲅⲓⲅⲁⲥ
ⲅⲗⲩⲡⲧⲟⲛ	ⲅⲗⲩⲡⲧⲟⲛ
ⲅⲗⲱⲥⲥⲟⲕⲟⲙⲟⲛ	ⲅⲗⲱⲥⲥⲟⲕⲟⲙⲟⲛ
ⲅⲛⲏⲥⲓⲟⲥ	ⲅⲛⲏⲥⲓⲟⲥ
ⲅⲛⲟⲫⲟⲥ	ⲅⲛⲟⲫⲟⲥ
ⲅⲛⲱⲙⲏ	ⲅⲛⲱⲙⲏ
ⲅⲛⲱⲥⲉⲱⲥ	ⲅⲛⲱⲥⲉⲱⲥ
ⲅⲛⲱⲥⲓⲥ	ⲅⲛⲱⲥⲓⲥ
ⲅⲣⲁⲙⲙⲁⲧⲉⲩⲥ	ⲅⲣⲁⲙⲙⲁⲧⲉⲩⲥ
ⲅⲣⲁⲙⲙⲁⲧⲏⲫⲟⲣⲟⲥ	ⲅⲣⲁⲙⲙⲁⲧⲏⲫⲟⲣⲟⲥ
ⲅⲣⲁⲙⲙⲁⲧⲓⲕⲟⲥ	ⲅⲣⲁⲙⲙⲁⲧⲓⲕⲟⲥ
ⲅⲣⲁⲙⲙⲁ	ⲅⲣⲁⲙⲙⲁ
ⲅⲣⲁⲙⲡⲉ	ⲅⲣⲁⲙⲡⲉ
ⲅⲣⲁⲫⲉⲩⲥ	ⲅⲣⲁⲫⲉⲩⲥ
ⲅⲣⲁⲫⲏ	ⲅⲣⲁⲫⲏ
ⲅⲣⲁⲫⲟⲟⲩⲉ	ⲅⲣⲁⲫⲟⲟⲩⲉ
ⲅⲣⲩⲡⲁⲍⲉ	ⲅⲣⲩⲡⲁⲍⲉ
ⲅⲩⲙⲛⲁⲍⲉ	ⲅⲩⲙⲛⲁⲍⲉ
ⲅⲩⲙⲛⲁⲥⲓⲁ	ⲅⲩⲙⲛⲁⲥⲓⲁ
ⲇⲁⲓⲙⲟⲛⲓⲍⲉ	ⲇⲁⲓⲙⲟⲛⲓⲍⲉ
ⲇⲁⲓⲙⲟⲛⲓⲟⲛ	ⲇⲁⲓⲙⲟⲛⲓⲟⲛ
ⲇⲁⲓⲙⲱⲛ	ⲇⲁⲓⲙⲱⲛ
ⲇⲁⲛⲓⲥⲧⲏⲥ	ⲇⲁⲛⲓⲥⲧⲏⲥ
ⲇⲁⲡⲁⲛⲏ	ⲇⲁⲡⲁⲛⲏ
ⲇⲉⲓⲡⲛⲟⲛ	ⲇⲉⲓⲡⲛⲟⲛ
ⲇⲉⲕⲁⲛⲟⲥ	ⲇⲉⲕⲁⲛⲟⲥ
ⲇⲉⲕⲁⲥ	ⲇⲉⲕⲁⲥ
ⲇⲉⲥⲡⲟⲧⲉⲓⲁ	ⲇⲉⲥⲡⲟⲧⲉⲓⲁ
ⲇⲉⲥⲡⲟⲧⲏⲥ	ⲇⲉⲥⲡⲟⲧⲏⲥ
ⲇⲉⲥⲡⲱⲧⲁ	ⲇⲉⲥⲡⲱⲧⲁ
ⲇⲉⲩⲧⲉⲣⲁ	ⲇⲉⲩⲧⲉⲣⲁ
ⲇⲉⲩⲧⲉⲣⲟⲛ	ⲇⲉⲩⲧⲉⲣⲟⲛ
ⲇⲉ	ⲇⲉ
ⲇⲏⲗⲟⲩ	ⲇⲏⲗⲟⲩ
ⲇⲏⲙⲓⲟⲥ	ⲇⲏⲙⲓⲟⲥ
ⲇⲏⲙⲓⲟⲩⲣⲅⲟⲥ	ⲇⲏⲙⲓⲟⲩⲣⲅⲟⲥ
ⲇⲏⲙⲟⲥⲓⲁ	ⲇⲏⲙⲟⲥⲓⲁ
ⲇⲏⲙⲟⲥⲓⲟⲛ	ⲇⲏⲙⲟⲥⲓⲟⲛ
ⲇⲏⲛⲁⲣⲓⲟⲛ	ⲇⲏⲛⲁⲣⲓⲟⲛ
ⲇⲏ	ⲇⲏ
ⲇⲓⲁⲃⲁⲗⲗⲉ	ⲇⲓⲁⲃⲁⲗⲗⲉ
ⲇⲓⲁⲃⲟⲗⲏ	ⲇⲓⲁⲃⲟⲗⲏ
ⲇⲓⲁⲃⲟⲗⲓⲕⲟⲛ	ⲇⲓⲁⲃⲟⲗⲓⲕⲟⲛ
ⲇⲓⲁⲃⲟⲗⲟⲥ	ⲇⲓⲁⲃⲟⲗⲟⲥ
ⲇⲓⲁⲅⲣⲁⲫⲟⲛ	ⲇⲓⲁⲅⲣⲁⲫⲟⲛ
ⲇⲓⲁⲅⲱⲅⲏ	ⲇⲓⲁⲅⲱⲅⲏ
ⲇⲓⲁⲑⲉⲥⲓⲥ	ⲇⲓⲁⲑⲉⲥⲓⲥ
ⲇⲓⲁⲑⲏⲕⲏ	ⲇⲓⲁⲑⲏⲕⲏ
ⲇⲓⲁⲓⲣⲉⲥⲓⲥ	ⲇⲓⲁⲓⲣⲉⲥⲓⲥ
ⲇⲓⲁⲕⲟⲛⲉⲓ	ⲇⲓⲁⲕⲟⲛⲉⲓ
ⲇⲓⲁⲕⲟⲛⲓⲁ	ⲇⲓⲁⲕⲟⲛⲓⲁ
ⲇⲓⲁⲕⲟⲛⲟⲥ	ⲇⲓⲁⲕⲟⲛⲟⲥ
ⲇⲓⲁⲕⲣⲓⲛⲉ	ⲇⲓⲁⲕⲣⲓⲛⲉ
ⲇⲓⲁⲕⲣⲓⲥⲓⲥ	ⲇⲓⲁⲕⲣⲓⲥⲓⲥ
ⲇⲓⲁⲕⲱⲛ	ⲇⲓⲁⲕⲱⲛ
ⲇⲓⲁⲙⲟⲛⲏ	ⲇⲓⲁⲙⲟⲛⲏ
ⲇⲓⲁⲛⲟⲓⲁ	ⲇⲓⲁⲛⲟⲓⲁ
ⲇⲓⲁⲛⲟⲓⲥⲓⲥ	ⲇⲓⲁⲛⲟⲓⲥⲓⲥ
ⲇⲓⲁⲡⲉⲣⲁ	ⲇⲓⲁⲡⲉⲣⲁ
ⲇⲓⲁⲥⲡⲟⲣⲁ	ⲇⲓⲁⲥⲡⲟⲣⲁ
ⲇⲓⲁⲥⲧⲁⲗⲙⲟⲥ	ⲇⲓⲁⲥⲧⲁⲗⲙⲟⲥ
ⲇⲓⲁⲥⲧⲣⲟⲫⲏ	ⲇⲓⲁⲥⲧⲣⲟⲫⲏ
ⲇⲓⲁⲥⲱⲥⲟⲩ	ⲇⲓⲁⲥⲱⲥⲟⲩ
ⲇⲓⲁⲧⲁⲅⲏ	ⲇⲓⲁⲧⲁⲅⲏ
ⲇⲓⲁⲧⲁⲅⲙⲁ	ⲇⲓⲁⲧⲁⲅⲙⲁ
ⲇⲓⲁⲧⲁⲥⲥⲉ	ⲇⲓⲁⲧⲁⲥⲥⲉ
ⲇⲓⲁⲧⲉⲗⲉⲓ	ⲇⲓⲁⲧⲉⲗⲉⲓ
ⲇⲓⲁⲧⲣⲓⲃⲉ	ⲇⲓⲁⲧⲣⲓⲃⲉ
ⲇⲓⲁⲫⲟⲣⲁ	ⲇⲓⲁⲫⲟⲣⲁ
ⲇⲓⲁⲯⲁⲗⲙⲁ	ⲇⲓⲁⲯⲁⲗⲙⲁ
ⲇⲓⲇⲁⲥⲕⲁⲗⲓⲁ	ⲇⲓⲇⲁⲥⲕⲁⲗⲓⲁ
ⲇⲓⲇⲓⲡⲗⲁ	ⲇⲓⲇⲓⲡⲗⲁ
ⲇⲓⲇⲣⲁⲭⲙⲟⲛ	ⲇⲓⲇⲣⲁⲭⲙⲟⲛ
ⲇⲓⲏⲅⲏⲙⲁ	ⲇⲓⲏⲅⲏⲙⲁ
ⲇⲓⲕⲁⲍⲉ	ⲇⲓⲕⲁⲍⲉ
ⲇⲓⲕⲁⲓⲟⲗⲟⲅⲓⲁ	ⲇⲓⲕⲁⲓⲟⲗⲟⲅⲓⲁ
ⲇⲓⲕⲁⲓⲟⲛ	ⲇⲓⲕⲁⲓⲟⲛ
ⲇⲓⲕⲁⲓⲟⲥⲩⲛⲏ	ⲇⲓⲕⲁⲓⲟⲥⲩⲛⲏ
ⲇⲓⲕⲁⲓⲟⲥ	ⲇⲓⲕⲁⲓⲟⲥ
ⲇⲓⲕⲁⲓⲱⲙⲁ	ⲇⲓⲕⲁⲓⲱⲙⲁ
ⲇⲓⲕⲁⲓⲱⲥ	ⲇⲓⲕⲁⲓⲱⲥ
ⲇⲓⲕⲁⲥⲧⲏⲣⲓⲟⲛ	ⲇⲓⲕⲁⲥⲧⲏⲣⲓⲟⲛ
ⲇⲓⲕⲁⲥⲧⲏⲥ	ⲇⲓⲕⲁⲥⲧⲏⲥ
ⲇⲓⲕⲏ	ⲇⲓⲕⲏ
ⲇⲓⲙⲓⲟⲩⲣⲅⲓⲁ	ⲇⲓⲙⲓⲟⲩⲣⲅⲓⲁ
ⲇⲓⲙⲱⲣⲓⲧⲏⲥ	ⲇⲓⲙⲱⲣⲓⲧⲏⲥ
ⲇⲓⲛⲁ	ⲇⲓⲛⲁ
ⲇⲓⲟⲓⲕⲉⲓ	ⲇⲓⲟⲓⲕⲉⲓ
ⲇⲓⲟⲓⲕⲏⲥⲓⲥ	ⲇⲓⲟⲓⲕⲏⲥⲓⲥ
ⲇⲓⲟⲓⲕⲏⲧⲏⲥ	ⲇⲓⲟⲓⲕⲏⲧⲏⲥ
ⲇⲓⲟⲓⲕⲏ	ⲇⲓⲟⲓⲕⲏ
ⲇⲓⲟⲥⲙⲏ	ⲇⲓⲟⲥⲙⲏ
ⲇⲓⲡⲗⲁ	ⲇⲓⲡⲗⲁ
ⲇⲓⲥⲧⲁⲍⲉ	ⲇⲓⲥⲧⲁⲍⲉ
ⲇⲓⲥⲧⲓⲭⲟⲛ	ⲇⲓⲥⲧⲓⲭⲟⲛ
ⲇⲓⲧⲁⲥⲅⲁⲗⲟⲥ	ⲇⲓⲧⲁⲥⲅⲁⲗⲟⲥ
ⲇⲓⲱⲅⲙⲟⲥ	ⲇⲓⲱⲅⲙⲟⲥ
ⲇⲓⲱⲕⲉⲓ	ⲇⲓⲱⲕⲉⲓ
ⲇⲓⲱⲕⲉ	ⲇⲓⲱⲕⲉ
ⲇⲓⲱⲕⲧⲏⲥ	ⲇⲓⲱⲕⲧⲏⲥ
ⲇⲟϭⲓⲙⲁⲥⲧⲏⲥ	ⲇⲟϭⲓⲙⲁⲥⲧⲏⲥ
ⲇⲟϭⲓ	ⲇⲟϭⲓ
ⲇⲟⲅⲙⲁⲧⲓⲍⲉ	ⲇⲟⲅⲙⲁⲧⲓⲍⲉ
ⲇⲟⲅⲙⲁ	ⲇⲟⲅⲙⲁ
ⲇⲟⲕⲉⲓ	ⲇⲟⲕⲉⲓ
ⲇⲟⲕⲓⲙⲁⲍⲉ	ⲇⲟⲕⲓⲙⲁⲍⲉ
ⲇⲟⲕⲓⲙⲏ	ⲇⲟⲕⲓⲙⲏ
ⲇⲟⲕⲓⲙⲟⲛ	ⲇⲟⲕⲓⲙⲟⲛ
ⲇⲟⲕⲓⲙⲟⲥ	ⲇⲟⲕⲓⲙⲟⲥ
ⲇⲟⲗⲟⲥ	ⲇⲟⲗⲟⲥ
ⲇⲟⲝⲟⲅⲉⲛⲏⲥ	ⲇⲟⲝⲟⲅⲉⲛⲏⲥ
ⲇⲟⲝⲟⲅⲉⲛⲓⲁ	ⲇⲟⲝⲟⲅⲉⲛⲓⲁ
ⲇⲟⲝⲟⲕⲣⲁⲧⲓⲁ	ⲇⲟⲝⲟⲕⲣⲁⲧⲓⲁ
ⲇⲟⲝⲟⲕⲣⲁⲧⲱⲣ	ⲇⲟⲝⲟⲕⲣⲁⲧⲱⲣ
ⲇⲟⲝⲟⲗⲟⲅⲓⲁ	ⲇⲟⲝⲟⲗⲟⲅⲓⲁ
ⲇⲟⲝⲟⲛ	ⲇⲟⲝⲟⲛ
ⲇⲟⲝⲟⲫⲁⲛⲏⲥ	ⲇⲟⲝⲟⲫⲁⲛⲏⲥ
ⲇⲟⲝⲟⲫⲁⲛⲓⲁ	ⲇⲟⲝⲟⲫⲁⲛⲓⲁ
ⲇⲟⲣⲕⲁⲥ	ⲇⲟⲣⲕⲁⲥ
ⲇⲟⲩⲝ	ⲇⲟⲩⲝ
ⲇⲣⲁⲕⲱⲛ	ⲇⲣⲁⲕⲱⲛ
ⲇⲣⲓⲙⲙⲁ	ⲇⲣⲓⲙⲙⲁ
ⲇⲣⲟⲙⲉⲩⲥ	ⲇⲣⲟⲙⲉⲩⲥ
ⲇⲣⲟⲙⲟⲥ	ⲇⲣⲟⲙⲟⲥ
ⲇⲣⲩⲙⲟⲥ	ⲇⲣⲩⲙⲟⲥ
ⲇⲩⲁⲥ	ⲇⲩⲁⲥ
ⲇⲩⲙⲟⲧⲏⲥ	ⲇⲩⲙⲟⲧⲏⲥ
ⲇⲩⲛⲁⲙⲓⲥ	ⲇⲩⲛⲁⲙⲓⲥ
ⲇⲩⲛⲁⲥⲧⲏⲥ	ⲇⲩⲛⲁⲥⲧⲏⲥ
ⲇⲩⲛⲁⲧⲟⲥ	ⲇⲩⲛⲁⲧⲟⲥ
ⲇⲩⲣⲁⲛⲛⲉⲩⲉ	ⲇⲩⲣⲁⲛⲛⲉⲩⲉ
ⲇⲩⲥⲕⲟⲗⲟⲛ	ⲇⲩⲥⲕⲟⲗⲟⲛ
ⲇⲱⲇⲉⲕⲁⲥ	ⲇⲱⲇⲉⲕⲁⲥ
ⲇⲱⲣⲉⲁⲥϯⲕⲟⲛ	ⲇⲱⲣⲉⲁⲥϯⲕⲟⲛ
ⲇⲱⲣⲉⲁ	ⲇⲱⲣⲉⲁ
ⲇⲱⲣⲓⲁ	ⲇⲱⲣⲓⲁ
ⲇⲱⲣⲓⲍⲉ	ⲇⲱⲣⲓⲍⲉ
ⲇⲱⲣⲟⲛ	ⲇⲱⲣⲟⲛ
ⲉϣϩⲱⲡ	ⲉϣ|ϩⲱⲡ
ⲉϣⲉⲅⲕⲣⲁⲧⲉⲩⲉ	ⲉϣ|ⲉⲅⲕⲣⲁⲧⲉⲩⲉ
ⲉⲃⲇⲟⲙⲏ	ⲉⲃⲇⲟⲙⲏ
ⲉⲅⲅⲕⲗⲩⲙⲁⲥ	ⲉⲅⲅⲕⲗⲩⲙⲁⲥ
ⲉⲅⲅⲣⲁⲫⲟⲛ	ⲉⲅⲅⲣⲁⲫⲟⲛ
ⲉⲅⲅⲣⲁⲫⲱⲥ	ⲉⲅⲅⲣⲁⲫⲱⲥ
ⲉⲅⲅⲩⲁ	ⲉⲅⲅⲩⲁ
ⲉⲅⲉⲧⲉ	ⲉⲅⲉⲧⲉ
ⲉⲅⲕⲁⲕⲉⲓ	ⲉⲅⲕⲁⲕⲉⲓ
ⲉⲅⲕⲁⲗⲉⲓ	ⲉⲅⲕⲁⲗⲉⲓ
ⲉⲅⲕⲉⲫⲁⲗⲟⲥ	ⲉⲅⲕⲉⲫⲁⲗⲟⲥ
ⲉⲅⲕⲣⲁⲧⲉⲓⲁ	ⲉⲅⲕⲣⲁⲧⲉⲓⲁ
ⲉⲅⲕⲣⲁⲧⲉⲩⲉ	ⲉⲅⲕⲣⲁⲧⲉⲩⲉ
ⲉⲅⲕⲣⲁⲧⲏⲥ	ⲉⲅⲕⲣⲁⲧⲏⲥ
ⲉⲅⲕⲣⲩⲫⲓⲟⲛ	ⲉⲅⲕⲣⲩⲫⲓⲟⲛ
ⲉⲅⲕⲱⲙⲓⲁⲍⲉ	ⲉⲅⲕⲱⲙⲓⲁⲍⲉ
ⲉⲅⲕⲱⲙⲓⲟⲛ	ⲉⲅⲕⲱⲙⲓⲟⲛ
ⲉⲑⲏⲣ	ⲉⲑⲏⲣ
ⲉⲑⲟⲥ	ⲉⲑⲟⲥ
ⲉⲓⲇⲉⲁ	ⲉⲓⲇⲉⲁ
ⲉⲓⲇⲟⲥ	ⲉⲓⲇⲟⲥ
ⲉⲓⲇⲱⲗⲟⲛ	ⲉⲓⲇⲱⲗⲟⲛ
ⲉⲓⲕⲏ	ⲉⲓⲕⲏ
ⲉⲓⲙⲏⲧⲓ	ⲉⲓⲙⲏⲧⲓ
ⲉⲓⲣⲏⲛⲏ	ⲉⲓⲣⲏⲛⲏ
ⲉⲓⲣⲏⲛⲓⲕⲏ	ⲉⲓⲣⲏⲛⲓⲕⲏ
ⲉⲓⲣⲏⲛⲓⲕⲟⲛ	ⲉⲓⲣⲏⲛⲓⲕⲟⲛ
ⲉⲓⲣⲏⲛⲓⲕⲟⲥ	ⲉⲓⲣⲏⲛⲓⲕⲟⲥ
ⲉⲓⲧⲁ	ⲉⲓⲧⲁ
ⲉⲓⲧⲉ	ⲉⲓⲧⲉ
ⲉⲓ	ⲉⲓ
ⲉⲕⲇⲓⲕⲏⲥⲓⲥ	ⲉⲕⲇⲓⲕⲏⲥⲓⲥ
ⲉⲕⲕⲗⲏⲥⲓⲁⲥⲧⲏⲥ	ⲉⲕⲕⲗⲏⲥⲓⲁⲥⲧⲏⲥ
ⲉⲕⲕⲗⲏⲥⲓⲁⲥⲧⲓⲕⲟⲛ	ⲉⲕⲕⲗⲏⲥⲓⲁⲥⲧⲓⲕⲟⲛ
ⲉⲕⲕⲗⲏⲥⲓⲁ	ⲉⲕⲕⲗⲏⲥⲓⲁ
ⲉⲕⲗⲉⲕⲧⲏ	ⲉⲕⲗⲉⲕⲧⲏ
ⲉⲕⲗⲉⲕⲧⲟⲥ	ⲉⲕⲗⲉⲕⲧⲟⲥ
ⲉⲕⲗⲟⲅⲏ	ⲉⲕⲗⲟⲅⲏ
ⲉⲕⲡⲗⲏⲝⲓⲥ	ⲉⲕⲡⲗⲏⲝⲓⲥ
ⲉⲕⲥⲁⲕⲧⲱⲣ	ⲉⲕⲥⲁⲕⲧⲱⲣ
ⲉⲕⲥⲧⲁⲥⲓⲥ	ⲉⲕⲥⲧⲁⲥⲓⲥ
ⲉⲕⲧⲏ	ⲉⲕⲧⲏ
ⲉⲗⲁⲙⲓⲧⲏⲥ	ⲉⲗⲁⲙⲓⲧⲏⲥ
ⲉⲗⲁⲥⲥⲟⲙⲁ	ⲉⲗⲁⲥⲥⲟⲙⲁ
ⲉⲗⲁⲭⲓⲥⲧⲟⲛ	ⲉⲗⲁⲭⲓⲥⲧⲟⲛ
ⲉⲗⲁⲭⲓⲥⲧⲟⲥ	ⲉⲗⲁⲭⲓⲥⲧⲟⲥ
ⲉⲗⲉⲅⲭⲉ	ⲉⲗⲉⲅⲭⲉ
ⲉⲗⲉⲏⲙⲟⲥⲩⲛⲏ	ⲉⲗⲉⲏⲙⲟⲥⲩⲛⲏ
ⲉⲗⲉⲩⲑⲉⲣⲁ	ⲉⲗⲉⲩⲑⲉⲣⲁ
ⲉⲗⲉⲩⲑⲉⲣⲓⲁ	ⲉⲗⲉⲩⲑⲉⲣⲓⲁ
ⲉⲗⲉⲩⲑⲉⲣⲟⲥ	ⲉⲗⲉⲩⲑⲉⲣⲟⲥ
ⲉⲗⲉⲩⲑⲉⲣⲟⲩ	ⲉⲗⲉⲩⲑⲉⲣⲟⲩ
ⲉⲗⲉⲫⲁⲛⲧⲓⲛⲟⲛ	ⲉⲗⲉⲫⲁⲛⲧⲓⲛⲟⲛ
ⲉⲗⲗⲉⲃⲟⲣⲟⲛ	ⲉⲗⲗⲉⲃⲟⲣⲟⲛ
ⲉⲙⲡⲉⲣⲟⲥ	ⲉⲙⲡⲉⲣⲟⲥ
ⲉⲙⲡⲟⲣⲟⲥ	ⲉⲙⲡⲟⲣⲟⲥ
ⲉⲙⲫⲁⲛⲓⲍⲉ	ⲉⲙⲫⲁⲛⲓⲍⲉ
ⲉⲙⲫⲁⲛⲓⲥⲑⲁⲓ	ⲉⲙⲫⲁⲛⲓⲥⲑⲁⲓ
ⲉⲙⲯⲩⲭⲟⲛ	ⲉⲙⲯⲩⲭⲟⲛ
ⲉⲛⲁⲅⲉ	ⲉⲛⲁⲅⲉ
ⲉⲛⲇⲏⲙⲁ	ⲉⲛⲇⲏⲙⲁ
ⲉⲛⲇⲟⲝ⸌ⲧ⸍	ⲉⲛⲇⲟⲝ⸌ⲧ⸍
ⲉⲛⲇⲩⲙⲁ	ⲉⲛⲇⲩⲙⲁ
ⲉⲛⲉⲣⲅⲉⲓⲁ	ⲉⲛⲉⲣⲅⲉⲓⲁ
ⲉⲛⲉⲣⲅⲉⲓ	ⲉⲛⲉⲣⲅⲉⲓ
ⲉⲛⲉⲭⲉⲣⲟⲛ	ⲉⲛⲉⲭⲉⲣⲟⲛ
ⲉⲛⲑⲩⲙⲏⲥⲓⲥ	ⲉⲛⲑⲩⲙⲏⲥⲓⲥ
ⲉⲛⲛⲁⲥ	ⲉⲛⲛⲁⲥ
ⲉⲛⲛⲁⲧⲏ	ⲉⲛⲛⲁⲧⲏ
ⲉⲛⲛⲟⲓⲁ	ⲉⲛⲛⲟⲓⲁ
ⲉⲛⲟⲭⲗⲉⲓ	ⲉⲛⲟⲭⲗⲉⲓ
ⲉⲛⲟⲭⲟⲥ	ⲉⲛⲟⲭⲟⲥ
ⲉⲛⲧⲁⲅⲓⲟⲛ	ⲉⲛⲧⲁⲅⲓⲟⲛ
ⲉⲛⲧⲓⲛⲁⲥⲥⲉ	ⲉⲛⲧⲓⲛⲁⲥⲥⲉ
ⲉⲛⲧⲟⲗⲏ	ⲉⲛⲧⲟⲗⲏ
ⲉⲝϩⲟⲙⲟⲗⲟⲅⲏⲥⲓⲥ	ⲉⲝϩⲟⲙⲟⲗⲟⲅⲏⲥⲓⲥ
ⲉⲝⲁⲅⲉ	ⲉⲝⲁⲅⲉ
ⲉⲝⲁⲡⲁⲧⲁ	ⲉⲝⲁⲡⲁⲧⲁ
ⲉⲝⲁⲡⲓⲛⲁ	ⲉⲝⲁⲡⲓⲛⲁ
ⲉⲝⲁⲥ	ⲉⲝⲁⲥ
ⲉⲝⲉⲇⲣⲁ	ⲉⲝⲉⲇⲣⲁ
ⲉⲝⲉⲥⲧⲓ	ⲉⲝⲉⲥⲧⲓ
ⲉⲝⲉⲧⲁⲍⲉ	ⲉⲝⲉⲧⲁⲍⲉ
ⲉⲝⲉⲧⲁⲥⲓⲥ	ⲉⲝⲉⲧⲁⲥⲓⲥ
ⲉⲝⲏⲅⲉⲓⲥⲓⲥ	ⲉⲝⲏⲅⲉⲓⲥⲓⲥ
ⲉⲝⲏⲅⲏⲧⲏⲥ	ⲉⲝⲏⲅⲏⲧⲏⲥ
ⲉⲝⲏⲕⲏⲥⲓⲥ	ⲉⲝⲏⲕⲏⲥⲓⲥ
ⲉⲝⲓⲗⲉ	ⲉⲝⲓⲗⲉ
ⲉⲝⲟⲇⲟⲥ	ⲉⲝⲟⲇⲟⲥ
ⲉⲝⲟⲙⲟⲗⲟⲅⲉⲓ	ⲉⲝⲟⲙⲟⲗⲟⲅⲉⲓ
ⲉⲝⲟⲣⲅⲓⲥⲧⲏⲥ	ⲉⲝⲟⲣⲅⲓⲥⲧⲏⲥ
ⲉⲝⲟⲩⲑⲉⲛⲓ	ⲉⲝⲟⲩⲑⲉⲛⲓ
ⲉⲝⲟⲩⲥⲓⲁⲍⲓⲛ	ⲉⲝⲟⲩⲥⲓⲁⲍⲓⲛ
ⲉⲝⲟⲩⲥⲓⲁⲥⲧⲏⲥ	ⲉⲝⲟⲩⲥⲓⲁⲥⲧⲏⲥ
ⲉⲝⲟⲩⲥⲓⲁ	ⲉⲝⲟⲩⲥⲓⲁ
ⲉⲝⲟⲩⲥⲓⲁ 	ⲉⲝⲟⲩⲥⲓⲁ 
ⲉⲝⲱⲇⲓⲕⲟⲥ	ⲉⲝⲱⲇⲓⲕⲟⲥ
ⲉⲝⲱⲣⲉⲓⲥⲧⲓⲁ	ⲉⲝⲱⲣⲉⲓⲥⲧⲓⲁ
ⲉⲝⲱⲣⲓⲍⲓⲛ	ⲉⲝⲱⲣⲓⲍⲓⲛ
ⲉⲡⲁⲓⲛⲟⲩ	ⲉⲡⲁⲓⲛⲟⲩ
ⲉⲡⲁⲣⲭⲓⲁ	ⲉⲡⲁⲣⲭⲓⲁ
ⲉⲡⲁⲣⲭⲟⲥ	ⲉⲡⲁⲣⲭⲟⲥ
ⲉⲡⲉⲓⲇⲏ	ⲉⲡⲉⲓⲇⲏ
ⲉⲡⲉⲓⲧⲁ	ⲉⲡⲉⲓⲧⲁ
ⲉⲡⲉⲓ	ⲉⲡⲉⲓ
ⲉⲡⲉⲛⲇⲩⲧⲏⲥ	ⲉⲡⲉⲛⲇⲩⲧⲏⲥ
ⲉⲡⲉⲭⲏⲣⲓ	ⲉⲡⲉⲭⲏⲣⲓ
ⲉⲡⲏⲣⲉⲁⲍⲉ	ⲉⲡⲏⲣⲉⲁⲍⲉ
ⲉⲡⲏⲣⲓⲁ	ⲉⲡⲏⲣⲓⲁ
ⲉⲡⲓⲃⲟⲗⲏ	ⲉⲡⲓⲃⲟⲗⲏ
ⲉⲡⲓⲃⲟⲩⲗⲉⲩⲉ	ⲉⲡⲓⲃⲟⲩⲗⲉⲩⲉ
ⲉⲡⲓⲃⲟⲩⲗⲏ	ⲉⲡⲓⲃⲟⲩⲗⲏ
ⲉⲡⲓⲅⲉⲁⲉⲓ	ⲉⲡⲓⲅⲉⲁⲉⲓ
ⲉⲡⲓⲅⲉⲛⲛⲓⲟⲥ	ⲉⲡⲓⲅⲉⲛⲛⲓⲟⲥ
ⲉⲡⲓⲅⲣⲁⲫⲏ	ⲉⲡⲓⲅⲣⲁⲫⲏ
ⲉⲡⲓⲉⲓⲕⲏⲥ	ⲉⲡⲓⲉⲓⲕⲏⲥ
ⲉⲡⲓⲑⲩⲙⲉⲓ	ⲉⲡⲓⲑⲩⲙⲉⲓ
ⲉⲡⲓⲑⲩⲙⲓⲁ	ⲉⲡⲓⲑⲩⲙⲓⲁ
ⲉⲡⲓⲕⲁⲗⲉⲓ	ⲉⲡⲓⲕⲁⲗⲉⲓ
ⲉⲡⲓⲛⲟⲓⲁ	ⲉⲡⲓⲛⲟⲓⲁ
ⲉⲡⲓⲥⲏⲙⲟⲥ	ⲉⲡⲓⲥⲏⲙⲟⲥ
ⲉⲡⲓⲥⲕⲟⲡⲏ	ⲉⲡⲓⲥⲕⲟⲡⲏ
ⲉⲡⲓⲥⲕⲟⲡⲓⲟⲛ	ⲉⲡⲓⲥⲕⲟⲡⲓⲟⲛ
ⲉⲡⲓⲥⲕⲟⲡⲟⲥ	ⲉⲡⲓⲥⲕⲟⲡⲟⲥ
ⲉⲡⲓⲥⲧⲏⲙⲏ	ⲉⲡⲓⲥⲧⲏⲙⲏ
ⲉⲡⲓⲥⲧⲟⲗⲏ	ⲉⲡⲓⲥⲧⲟⲗⲏ
ⲉⲡⲓⲧⲁⲕⲏ	ⲉⲡⲓⲧⲁⲕⲏ
ⲉⲡⲓⲧⲁⲥⲥⲉ	ⲉⲡⲓⲧⲁⲥⲥⲉ
ⲉⲡⲓⲧⲉⲗⲓⲛ	ⲉⲡⲓⲧⲉⲗⲓⲛ
ⲉⲡⲓⲧⲓⲙⲁ	ⲉⲡⲓⲧⲓⲙⲁ
ⲉⲡⲓⲧⲓⲙⲓⲁ	ⲉⲡⲓⲧⲓⲙⲓⲁ
ⲉⲡⲓⲧⲣⲉⲡⲉ	ⲉⲡⲓⲧⲣⲉⲡⲉ
ⲉⲡⲓⲧⲣⲟⲡⲏ	ⲉⲡⲓⲧⲣⲟⲡⲏ
ⲉⲡⲓⲧⲣⲟⲡⲟⲥ	ⲉⲡⲓⲧⲣⲟⲡⲟⲥ
ⲉⲡⲟⲓⲕⲓⲟⲛ	ⲉⲡⲟⲓⲕⲓⲟⲛ
ⲉⲡⲟⲩⲣⲁⲛⲓⲟⲛ	ⲉⲡⲟⲩⲣⲁⲛⲓⲟⲛ
ⲉⲣϩⲩⲙⲛⲟⲥ	ⲉⲣ|ϩⲩⲙⲛⲟⲥ
ⲉⲣⲁⲑⲉⲧⲓⲛ	ⲉⲣ|ⲁⲑⲉⲧⲓⲛ
ⲉⲣⲁⲛⲁⲭⲱⲣⲓⲛ	ⲉⲣ|ⲁⲛⲁⲭⲱⲣⲓⲛ
ⲉⲣⲁⲡⲁⲛⲧⲁⲛ	ⲉⲣ|ⲁⲡⲁⲛⲧⲁⲛ
ⲉⲣⲁⲡⲁⲧⲁⲛ	ⲉⲣ|ⲁⲡⲁⲧⲁⲛ
ⲉⲣⲁⲡⲟⲧⲁⲍⲉⲥⲑⲉ	ⲉⲣ|ⲁⲡⲟⲧⲁⲍⲉⲥⲑⲉ
ⲉⲣⲁⲥⲡⲁⲍⲉⲥⲑⲉ	ⲉⲣ|ⲁⲥⲡⲁⲍⲉⲥⲑⲉ
ⲉⲣⲃⲁⲥⲁⲛⲓⲍⲓⲛ	ⲉⲣ|ⲃⲁⲥⲁⲛⲓⲍⲓⲛ
ⲉⲣⲃⲗⲁⲡⲧⲓⲛ	ⲉⲣ|ⲃⲗⲁⲡⲧⲓⲛ
ⲉⲣⲃⲟⲏⲑⲓⲛ	ⲉⲣ|ⲃⲟⲏⲑⲓⲛ
ⲉⲣⲅⲁⲥⲓⲁ	ⲉⲣⲅⲁⲥⲓⲁ
ⲉⲣⲅⲁⲥⲧⲏⲣⲓⲟⲛ	ⲉⲣⲅⲁⲥⲧⲏⲣⲓⲟⲛ
ⲉⲣⲅⲁⲧⲏⲥ	ⲉⲣⲅⲁⲧⲏⲥ
ⲉⲣⲅⲟⲇⲓⲱⲕⲧⲏⲥ	ⲉⲣⲅⲟⲇⲓⲱⲕⲧⲏⲥ
ⲉⲣⲅⲟⲗⲁⲃⲓⲁ	ⲉⲣⲅⲟⲗⲁⲃⲓⲁ
ⲉⲣⲅⲟⲛ	ⲉⲣⲅⲟⲛ
ⲉⲣⲇⲓⲁⲕⲟⲛⲓⲛ	ⲉⲣ|ⲇⲓⲁⲕⲟⲛⲓⲛ
ⲉⲣⲉⲙⲡⲟⲇⲁⲍⲓⲛ	ⲉⲣ|ⲉⲙⲡⲟⲇⲁⲍⲓⲛ
ⲉⲣⲉⲛⲕⲁⲕⲓⲛ	ⲉⲣ|ⲉⲛⲕⲁⲕⲓⲛ
ⲉⲣⲉⲡⲓⲛⲟⲓⲛ	ⲉⲣ|ⲉⲡⲓⲛⲟⲓⲛ
ⲉⲣⲉⲥⲑⲁⲛⲉⲥⲑⲉ	ⲉⲣ|ⲉⲥⲑⲁⲛⲉⲥⲑⲉ
ⲉⲣⲏⲙⲓⲁ	ⲉⲣⲏⲙⲓⲁ
ⲉⲣⲏⲙⲟⲥ	ⲉⲣⲏⲙⲟⲥ
ⲉⲣⲑⲉⲱⲣⲓⲛ	ⲉⲣ|ⲑⲉⲱⲣⲓⲛ
ⲉⲣⲓⲍⲉ	ⲉⲣⲓⲍⲉ
ⲉⲣⲕⲉⲗⲉⲩⲓⲛ	ⲉⲣ|ⲕⲉⲗⲉⲩⲓⲛ
ⲉⲣⲕⲣⲓⲛⲓⲛ	ⲉⲣ|ⲕⲣⲓⲛⲓⲛ
ⲉⲣⲗⲓⲧⲟⲩⲣⲅⲓⲁ	ⲉⲣ|ⲗⲓⲧⲟⲩⲣⲅⲓⲁ
ⲉⲣⲙⲁⲑⲏⲧⲏⲥ	ⲉⲣ|ⲙⲁⲑⲏⲧⲏⲥ
ⲉⲣⲙⲏⲧⲁⲣⲓⲟⲛ	ⲉⲣⲙⲏⲧⲁⲣⲓⲟⲛ
ⲉⲣⲟⲙⲟⲗⲟⲅⲓⲛ	ⲉⲣ|ⲟⲙⲟⲗⲟⲅⲓⲛ
ⲉⲣⲡⲣⲟⲥⲫⲉⲣⲓⲛ	ⲉⲣ|ⲡⲣⲟⲥⲫⲉⲣⲓⲛ
ⲉⲣⲣⲏⲧⲱⲣⲉⲩⲓⲛ	ⲉⲣ|ⲣⲏⲧⲱⲣⲉⲩⲓⲛ
ⲉⲣⲥⲕⲉⲡⲁⲍⲓⲛ	ⲉⲣ|ⲥⲕⲉⲡⲁⲍⲓⲛ
ⲉⲣⲥⲱⲙⲁ	ⲉⲣ|ⲥⲱⲙⲁ
ⲉⲣⲧⲉⲗⲉⲓⲟⲥ	ⲉⲣ|ⲧⲉⲗⲉⲓⲟⲥ
ⲉⲣⲱⲥ	ⲉⲣⲱⲥ
ⲉⲥⲑⲏⲥⲓⲥ	ⲉⲥⲑⲏⲥⲓⲥ
ⲉⲥⲧⲱ	ⲉⲥⲧⲱ
ⲉⲥⲩⲭⲁⲍⲉ	ⲉⲥⲩⲭⲁⲍⲉ
ⲉⲥⲭⲁⲣⲁ	ⲉⲥⲭⲁⲣⲁ
ⲉⲧⲓ	ⲉⲧⲓ
ⲉⲩϩⲁⲓⲟⲥ	ⲉⲩϩⲁⲓⲟⲥ
ⲉⲩⲁⲅⲅⲉⲗⲓⲍⲉ	ⲉⲩⲁⲅⲅⲉⲗⲓⲍⲉ
ⲉⲩⲁⲅⲅⲉⲗⲓⲟⲛ	ⲉⲩⲁⲅⲅⲉⲗⲓⲟⲛ
ⲉⲩⲁⲅⲅⲉⲗⲓⲥⲧⲏⲥ	ⲉⲩⲁⲅⲅⲉⲗⲓⲥⲧⲏⲥ
ⲉⲩⲅⲉⲛⲏⲥ	ⲉⲩⲅⲉⲛⲏⲥ
ⲉⲩⲅⲉ	ⲉⲩⲅⲉ
ⲉⲩⲇⲁⲓⲙⲟⲛⲓⲁ	ⲉⲩⲇⲁⲓⲙⲟⲛⲓⲁ
ⲉⲩⲇⲟⲕⲉⲓ	ⲉⲩⲇⲟⲕⲉⲓ
ⲉⲩⲉⲣⲅⲉⲥⲓⲁ	ⲉⲩⲉⲣⲅⲉⲥⲓⲁ
ⲉⲩⲉⲣⲅⲉⲧⲏⲥ	ⲉⲩⲉⲣⲅⲉⲧⲏⲥ
ⲉⲩⲑⲉⲱⲥ	ⲉⲩⲑⲉⲱⲥ
ⲉⲩⲑⲩⲥ	ⲉⲩⲑⲩⲥ
ⲉⲩⲕⲉⲣⲓⲁ	ⲉⲩⲕⲉⲣⲓⲁ
ⲉⲩⲕⲉⲣⲓ	ⲉⲩⲕⲉⲣⲓ
ⲉⲩⲕⲗⲉⲉⲥⲧⲁⲧⲟⲥ	ⲉⲩⲕⲗⲉⲉⲥⲧⲁⲧⲟⲥ
ⲉⲩⲕⲟⲡⲟⲛ	ⲉⲩⲕⲟⲡⲟⲛ
ⲉⲩⲕⲣⲁⲥⲓⲁ	ⲉⲩⲕⲣⲁⲥⲓⲁ
ⲉⲩⲗⲁⲃⲉⲥⲧⲁⲧⲟⲥ	ⲉⲩⲗⲁⲃⲉⲥⲧⲁⲧⲟⲥ
ⲉⲩⲗⲁⲃⲓⲁ	ⲉⲩⲗⲁⲃⲓⲁ
ⲉⲩⲗⲟⲅⲓⲁ	ⲉⲩⲗⲟⲅⲓⲁ
ⲉⲩⲗⲟⲅⲟⲛ	ⲉⲩⲗⲟⲅⲟⲛ
ⲉⲩⲛⲟⲓⲁ	ⲉⲩⲛⲟⲓⲁ
ⲉⲩⲡⲟⲣⲉⲓ	ⲉⲩⲡⲟⲣⲉⲓ
ⲉⲩⲡⲟⲣⲓⲁ	ⲉⲩⲡⲟⲣⲓⲁ
ⲉⲩⲡⲟⲣⲓ	ⲉⲩⲡⲟⲣⲓ
ⲉⲩⲡⲟⲣⲟⲥ	ⲉⲩⲡⲟⲣⲟⲥ
ⲉⲩⲡⲣⲉⲡⲉⲓⲁ	ⲉⲩⲡⲣⲉⲡⲉⲓⲁ
ⲉⲩⲥⲉⲃⲉⲓⲁ	ⲉⲩⲥⲉⲃⲉⲓⲁ
ⲉⲩⲥⲉⲃⲏⲥ	ⲉⲩⲥⲉⲃⲏⲥ
ⲉⲩⲥⲧⲁⲑⲓⲟⲥ	ⲉⲩⲥⲧⲁⲑⲓⲟⲥ
ⲉⲩⲥⲭⲏⲙⲱⲛ	ⲉⲩⲥⲭⲏⲙⲱⲛ
ⲉⲩⲧⲉⲗⲉⲓⲁ	ⲉⲩⲧⲉⲗⲉⲓⲁ
ⲉⲩⲫⲣⲁⲛⲉ	ⲉⲩⲫⲣⲁⲛⲉ
ⲉⲩⲫⲣⲟⲥⲩⲛⲏ	ⲉⲩⲫⲣⲟⲥⲩⲛⲏ
ⲉⲩⲫⲩⲏⲥ	ⲉⲩⲫⲩⲏⲥ
ⲉⲩⲭⲁⲣⲓⲥⲧⲉⲓ	ⲉⲩⲭⲁⲣⲓⲥⲧⲉⲓ
ⲉⲩⲭⲁⲣⲓⲥⲧⲓⲁ	ⲉⲩⲭⲁⲣⲓⲥⲧⲓⲁ
ⲉⲩⲭⲏ	ⲉⲩⲭⲏ
ⲉⲫⲟⲇⲓⲟⲛ	ⲉⲫⲟⲇⲓⲟⲛ
ⲉⲱⲛ	ⲉⲱⲛ
ⲉⲱⲥ	ⲉⲱⲥ
ⲍⲉⲩⲥ	ⲍⲉⲩⲥ
ⲍⲏⲧⲏⲙⲁ	ⲍⲏⲧⲏⲙⲁ
ⲍⲏⲧⲏⲥⲓⲥ	ⲍⲏⲧⲏⲥⲓⲥ
ⲍⲓⲍⲁⲛⲓⲟⲛ	ⲍⲓⲍⲁⲛⲓⲟⲛ
ⲍⲩⲅⲓⲥⲕⲟⲛ	ⲍⲩⲅⲓⲥⲕⲟⲛ
ⲍⲱⲅⲣⲁⲫⲉⲓⲁ	ⲍⲱⲅⲣⲁⲫⲉⲓⲁ
ⲍⲱⲅⲣⲁⲫⲉⲓ	ⲍⲱⲅⲣⲁⲫⲉⲓ
ⲍⲱⲏ	ⲍⲱⲏ
ⲍⲱⲛⲏ	ⲍⲱⲛⲏ
ⲍⲱⲟⲛ	ⲍⲱⲟⲛ
ⲏⲇⲏ	ⲏⲇⲏ
ⲏⲛⲓⲟⲭⲟⲥ	ⲏⲛⲓⲟⲭⲟⲥ
ⲏⲝⲧⲁⲥⲓⲥ	ⲏⲝⲧⲁⲥⲓⲥ
ⲏⲣⲉⲙⲓⲟⲥ	ⲏⲣⲉⲙⲓⲟⲥ
ⲏⲣⲉⲙⲟⲥ	ⲏⲣⲉⲙⲟⲥ
ⲏⲥⲓⲭⲓⲁ	ⲏⲥⲓⲭⲓⲁ
ⲏ	ⲏ
ⲑⲁⲗⲁⲥⲥⲁ	ⲑⲁⲗⲁⲥⲥⲁ
ⲑⲁⲗⲗⲓⲥ	ⲑⲁⲗⲗⲓⲥ
ⲑⲁⲗⲡⲉⲓ	ⲑⲁⲗⲡⲉⲓ
ⲑⲁⲣⲓ	ⲑⲁⲣⲓ
ⲑⲁⲩⲙⲁⲍⲉ	ⲑⲁⲩⲙⲁⲍⲉ
ⲑⲁⲩⲙⲁⲥⲓⲱⲧⲁⲧⲟⲥ	ⲑⲁⲩⲙⲁⲥⲓⲱⲧⲁⲧⲟⲥ
ⲑⲁⲩⲙⲁⲥⲧⲟⲛ	ⲑⲁⲩⲙⲁⲥⲧⲟⲛ
ⲑⲁⲩⲙⲁ	ⲑⲁⲩⲙⲁ
ⲑⲉⲁⲧⲣⲟⲛ	ⲑⲉⲁⲧⲣⲟⲛ
ⲑⲉⲃⲇⲟⲙⲁⲥ	ⲑⲉⲃⲇⲟⲙⲁⲥ
ⲑⲉⲃⲟⲃⲟⲗⲏ	ⲑⲉⲃⲟⲃⲟⲗⲏ
ⲑⲉⲓⲟⲛ	ⲑⲉⲓⲟⲛ
ⲑⲉⲓⲟⲥ	ⲑⲉⲓⲟⲥ
ⲑⲉⲗⲏⲙⲁ	ⲑⲉⲗⲏⲙⲁ
ⲑⲉⲟⲇⲟⲕⲟⲥ	ⲑⲉⲟⲇⲟⲕⲟⲥ
ⲑⲉⲟⲗⲟⲅⲓⲁ	ⲑⲉⲟⲗⲟⲅⲓⲁ
ⲑⲉⲟⲗⲟⲅⲟⲥ	ⲑⲉⲟⲗⲟⲅⲟⲥ
ⲑⲉⲟⲥⲉⲃⲉⲓⲁ	ⲑⲉⲟⲥⲉⲃⲉⲓⲁ
ⲑⲉⲟⲥⲉⲃⲉⲥⲧⲁⲧⲟⲥ	ⲑⲉⲟⲥⲉⲃⲉⲥⲧⲁⲧⲟⲥ
ⲑⲉⲟⲥⲥⲉⲃⲏⲥ	ⲑⲉⲟⲥⲥⲉⲃⲏⲥ
ⲑⲉⲟⲫⲓⲗⲉⲥⲧⲁⲧⲟⲥ	ⲑⲉⲟⲫⲓⲗⲉⲥⲧⲁⲧⲟⲥ
ⲑⲉⲟⲫⲓⲗⲓⲁ	ⲑⲉⲟⲫⲓⲗⲓⲁ
ⲑⲉⲟⲫⲟⲣⲟⲥ	ⲑⲉⲟⲫⲟⲣⲟⲥ
ⲑⲉⲣⲁⲡⲉⲩⲉ	ⲑⲉⲣⲁⲡⲉⲩⲉ
ⲑⲉⲣⲁⲡⲓⲁ	ⲑⲉⲣⲁⲡⲓⲁ
ⲑⲉⲣⲙⲟⲫⲩⲗⲁⲕⲉ	ⲑⲉⲣⲙⲟⲫⲩⲗⲁⲕⲉ
ⲑⲉⲥⲓⲥ	ⲑⲉⲥⲓⲥ
ⲑⲉⲱⲣⲉⲓ	ⲑⲉⲱⲣⲉⲓ
ⲑⲉⲱⲣⲓⲁ	ⲑⲉⲱⲣⲓⲁ
ⲑⲏⲗⲩⲕⲟⲛ	ⲑⲏⲗⲩⲕⲟⲛ
ⲑⲏⲛ	ⲑⲏⲛ
ⲑⲏⲣⲓⲟⲛ	ⲑⲏⲣⲓⲟⲛ
ⲑⲏⲥⲁⲩⲣⲟⲥ	ⲑⲏⲥⲁⲩⲣⲟⲥ
ⲑⲏⲥⲅⲉ	ⲑⲏⲥⲅⲉ
ⲑⲗⲓⲃⲉ	ⲑⲗⲓⲃⲉ
ⲑⲗⲓⲯⲓⲥ	ⲑⲗⲓⲯⲓⲥ
ⲑⲛⲏⲧⲟⲛ	ⲑⲛⲏⲧⲟⲛ
ⲑⲟⲗⲟⲥ	ⲑⲟⲗⲟⲥ
ⲑⲟⲩⲣⲁⲕⲓⲟⲛ	ⲑⲟⲩⲣⲁⲕⲓⲟⲛ
ⲑⲣⲓⲥⲕⲓⲁ	ⲑⲣⲓⲥⲕⲓⲁ
ⲑⲣⲟⲛⲟⲥ	ⲑⲣⲟⲛⲟⲥ
ⲑⲩⲕⲏ	ⲑⲩⲕⲏ
ⲑⲩⲗⲓⲕⲓⲁ	ⲑⲩⲗⲓⲕⲓⲁ
ⲑⲩⲙⲓⲁⲧⲏⲣⲓⲟⲛ	ⲑⲩⲙⲓⲁⲧⲏⲣⲓⲟⲛ
ⲑⲩⲙⲟⲥ	ⲑⲩⲙⲟⲥ
ⲑⲩⲡⲟⲩⲣⲅⲓⲁ	ⲑⲩⲡⲟⲩⲣⲅⲓⲁ
ⲑⲩⲣⲟⲣⲟⲥ	ⲑⲩⲣⲟⲣⲟⲥ
ⲑⲩⲥⲁⲩⲣⲟⲥ	ⲑⲩⲥⲁⲩⲣⲟⲥ
ⲑⲩⲥⲓⲁⲍⲉ	ⲑⲩⲥⲓⲁⲍⲉ
ⲑⲩⲥⲓⲁⲥⲧⲏⲣⲓⲟⲛ	ⲑⲩⲥⲓⲁⲥⲧⲏⲣⲓⲟⲛ
ⲑⲩⲥⲓⲁ	ⲑⲩⲥⲓⲁ
ⲓ̈ⲱⲧⲁ	ⲓ̈ⲱⲧⲁ
ⲓ̈<ⲥⲟ>ⲯⲩⲭⲟⲛ	ⲓ̈<ⲥⲟ>ⲯⲩⲭⲟⲛ
ⲓⲁⲥⲡⲓⲥ	ⲓⲁⲥⲡⲓⲥ
ⲓⲃⲉⲣⲟⲥ	ⲓⲃⲉⲣⲟⲥ
ⲓⲇⲟⲩⲙⲁⲓⲟⲥ	ⲓⲇⲟⲩⲙⲁⲓⲟⲥ
ⲓⲉⲣⲟⲯⲁⲗⲧⲏⲥ	ⲓⲉⲣⲟⲯⲁⲗⲧⲏⲥ
ⲓⲕⲧⲉⲣⲟⲥ	ⲓⲕⲧⲉⲣⲟⲥ
ⲓⲗⲗⲟⲩⲥⲧⲣ/	ⲓⲗⲗⲟⲩⲥⲧⲣ/
ⲓⲟⲩⲇⲁⲓⲟⲥ	ⲓⲟⲩⲇⲁⲓⲟⲥ
ⲓⲟⲩⲇⲁⲓ	ⲓⲟⲩⲇⲁⲓ
ⲓⲥⲧⲟⲣⲓⲁ	ⲓⲥⲧⲟⲣⲓⲁ
ⲓⲭⲛⲟⲥ	ⲓⲭⲛⲟⲥ
ⲕⲩ̅	ⲕⲩ̅
ⲕⲁⲃⲓⲧⲁⲣⲉ	ⲕⲁⲃⲓⲧⲁⲣⲉ
ⲕⲁⲇⲁⲝⲓⲁⲣⲭⲏⲥ	ⲕⲁⲇⲁⲝⲓⲁⲣⲭⲏⲥ
ⲕⲁⲑⲁⲓⲣⲉⲥⲓⲥ	ⲕⲁⲑⲁⲓⲣⲉⲥⲓⲥ
ⲕⲁⲑⲁⲓⲣⲟⲩ	ⲕⲁⲑⲁⲓⲣⲟⲩ
ⲕⲁⲑⲁⲣⲓⲍⲉ	ⲕⲁⲑⲁⲣⲓⲍⲉ
ⲕⲁⲑⲁⲣⲓⲥⲙⲟⲥ	ⲕⲁⲑⲁⲣⲓⲥⲙⲟⲥ
ⲕⲁⲑⲁⲣⲓⲱⲧⲏⲥ	ⲕⲁⲑⲁⲣⲓⲱⲧⲏⲥ
ⲕⲁⲑⲁⲣⲟⲛ	ⲕⲁⲑⲁⲣⲟⲛ
ⲕⲁⲑⲁⲣⲟⲥ	ⲕⲁⲑⲁⲣⲟⲥ
ⲕⲁⲑⲉⲇⲣⲁ	ⲕⲁⲑⲉⲇⲣⲁ
ⲕⲁⲑⲉⲇⲣⲟⲥ	ⲕⲁⲑⲉⲇⲣⲟⲥ
ⲕⲁⲑⲏⲅⲓ	ⲕⲁⲑⲏⲅⲓ
ⲕⲁⲑⲏⲕⲏⲥⲓⲥ	ⲕⲁⲑⲏⲕⲏⲥⲓⲥ
ⲕⲁⲑⲏⲕⲟⲩⲙⲉⲛⲓⲧⲏⲥ	ⲕⲁⲑⲏⲕⲟⲩⲙⲉⲛⲓⲧⲏⲥ
ⲕⲁⲑⲏⲕⲟⲩⲙⲉⲛⲟⲥ	ⲕⲁⲑⲏⲕⲟⲩⲙⲉⲛⲟⲥ
ⲕⲁⲑⲓⲥⲧⲁ	ⲕⲁⲑⲓⲥⲧⲁ
ⲕⲁⲑⲟⲗⲓⲕⲏ	ⲕⲁⲑⲟⲗⲓⲕⲏ
ⲕⲁⲑⲟⲗⲓⲕⲟⲛ	ⲕⲁⲑⲟⲗⲓⲕⲟⲛ
ⲕⲁⲑⲟⲧⲓ	ⲕⲁⲑⲟⲧⲓ
ⲕⲁⲓⲅⲁⲣ	ⲕⲁⲓⲅⲁⲣ
ⲕⲁⲓⲕⲟⲛ	ⲕⲁⲓⲕⲟⲛ
ⲕⲁⲓⲡⲉⲣ	ⲕⲁⲓⲡⲉⲣ
ⲕⲁⲓⲣⲟⲥ	ⲕⲁⲓⲣⲟⲥ
ⲕⲁⲓⲥⲁⲣ	ⲕⲁⲓⲥⲁⲣ
ⲕⲁⲓⲧⲟⲓ	ⲕⲁⲓⲧⲟⲓ
ⲕⲁⲓ	ⲕⲁⲓ
ⲕⲁⲕⲓⲁ	ⲕⲁⲕⲓⲁ
ⲕⲁⲕⲓⲛⲕⲁⲕⲱⲥ	ⲕⲁⲕⲓⲛⲕⲁⲕⲱⲥ
ⲕⲁⲕⲟⲅⲏⲣⲟⲥ	ⲕⲁⲕⲟⲅⲏⲣⲟⲥ
ⲕⲁⲕⲟⲏⲑⲉⲓⲁ	ⲕⲁⲕⲟⲏⲑⲉⲓⲁ
ⲕⲁⲕⲟⲛⲟⲓⲁ	ⲕⲁⲕⲟⲛⲟⲓⲁ
ⲕⲁⲕⲟⲛ	ⲕⲁⲕⲟⲛ
ⲕⲁⲕⲟⲥ	ⲕⲁⲕⲟⲥ
ⲕⲁⲕⲟⲩⲣⲅⲓⲁ	ⲕⲁⲕⲟⲩⲣⲅⲓⲁ
ⲕⲁⲕⲟⲩⲣⲅⲟⲥ	ⲕⲁⲕⲟⲩⲣⲅⲟⲥ
ⲕⲁⲕⲟⲩ	ⲕⲁⲕⲟⲩ
ⲕⲁⲕⲱⲥⲓⲥ	ⲕⲁⲕⲱⲥⲓⲥ
ⲕⲁⲕⲱⲥ	ⲕⲁⲕⲱⲥ
ⲕⲁⲗⲁⲉⲓⲛⲟⲥ	ⲕⲁⲗⲁⲉⲓⲛⲟⲥ
ⲕⲁⲗⲁⲕⲓⲁ	ⲕⲁⲗⲁⲕⲓⲁ
ⲕⲁⲗⲁⲙⲁⲣⲓⲟⲛ	ⲕⲁⲗⲁⲙⲁⲣⲓⲟⲛ
ⲕⲁⲗⲉⲓ	ⲕⲁⲗⲉⲓ
ⲕⲁⲗⲗⲁⲉⲓⲛⲏ	ⲕⲁⲗⲗⲁⲉⲓⲛⲏ
ⲕⲁⲗⲗⲓⲅⲣⲁⲫⲟⲥ	ⲕⲁⲗⲗⲓⲅⲣⲁⲫⲟⲥ
ⲕⲁⲗⲗⲓⲛⲓⲕⲟⲥ	ⲕⲁⲗⲗⲓⲛⲓⲕⲟⲥ
ⲕⲁⲗⲗⲟⲥ	ⲕⲁⲗⲗⲟⲥ
ⲕⲁⲗⲩⲙⲙⲁ	ⲕⲁⲗⲩⲙⲙⲁ
ⲕⲁⲗⲩⲡⲧⲟⲥ	ⲕⲁⲗⲩⲡⲧⲟⲥ
ⲕⲁⲗⲱⲥ	ⲕⲁⲗⲱⲥ
ⲕⲁⲙⲁⲇⲓⲟⲛ	ⲕⲁⲙⲁⲇⲓⲟⲛ
ⲕⲁⲙⲁⲣⲉ	ⲕⲁⲙⲁⲣⲉ
ⲕⲁⲙⲃⲏ	ⲕⲁⲙⲃⲏ
ⲕⲁⲙⲓⲛⲟⲥ	ⲕⲁⲙⲓⲛⲟⲥ
ⲕⲁⲙⲓⲥⲓⲟⲛ	ⲕⲁⲙⲓⲥⲓⲟⲛ
ⲕⲁⲛⲁⲛⲁⲓⲟⲥ	ⲕⲁⲛⲁⲛⲁⲓⲟⲥ
ⲕⲁⲛⲁⲛⲓⲧⲏⲥ	ⲕⲁⲛⲁⲛⲓⲧⲏⲥ
ⲕⲁⲛⲱⲛⲓⲍⲉ	ⲕⲁⲛⲱⲛⲓⲍⲉ
ⲕⲁⲛⲱⲛ	ⲕⲁⲛⲱⲛ
ⲕⲁⲛ	ⲕⲁⲛ
ⲕⲁⲡⲏⲗⲟⲥ	ⲕⲁⲡⲏⲗⲟⲥ
ⲕⲁⲡⲛⲟⲥ	ⲕⲁⲡⲛⲟⲥ
ⲕⲁⲣⲟⲓⲁ	ⲕⲁⲣⲟⲓⲁ
ⲕⲁⲣⲡⲟⲥ	ⲕⲁⲣⲡⲟⲥ
ⲕⲁⲣⲡⲟⲫⲟⲣⲓⲁ	ⲕⲁⲣⲡⲟⲫⲟⲣⲓⲁ
ⲕⲁⲣⲱ	ⲕⲁ|ⲣⲱ
ⲕⲁⲥⲓⲁ	ⲕⲁⲥⲓⲁ
ⲕⲁⲥⲧⲣⲟⲛ	ⲕⲁⲥⲧⲣⲟⲛ
ⲕⲁⲧⲁϩⲣⲁⲕⲧⲏⲥ	ⲕⲁⲧⲁϩⲣⲁⲕⲧⲏⲥ
ⲕⲁⲧⲁⲃⲁⲥⲓⲥ	ⲕⲁⲧⲁⲃⲁⲥⲓⲥ
ⲕⲁⲧⲁⲃⲟⲗⲏ	ⲕⲁⲧⲁⲃⲟⲗⲏ
ⲕⲁⲧⲁⲅⲓⲛⲱⲥⲕⲉ	ⲕⲁⲧⲁⲅⲓⲛⲱⲥⲕⲉ
ⲕⲁⲧⲁⲅⲛⲱⲥⲓⲥ	ⲕⲁⲧⲁⲅⲛⲱⲥⲓⲥ
ⲕⲁⲧⲁⲇⲓⲕⲏ	ⲕⲁⲧⲁⲇⲓⲕⲏ
ⲕⲁⲧⲁⲇⲓⲕⲱⲥ	ⲕⲁⲧⲁⲇⲓⲕⲱⲥ
ⲕⲁⲧⲁⲕⲉⲛⲉ	ⲕⲁⲧⲁⲕⲉⲛⲉ
ⲕⲁⲧⲁⲕⲓⲟⲛ	ⲕⲁⲧⲁⲕⲓⲟⲛ
ⲕⲁⲧⲁⲕⲗⲩⲥⲙⲟⲥ	ⲕⲁⲧⲁⲕⲗⲩⲥⲙⲟⲥ
ⲕⲁⲧⲁⲕⲣⲓⲙⲁ	ⲕⲁⲧⲁⲕⲣⲓⲙⲁ
ⲕⲁⲧⲁⲕⲣⲓⲛⲉ	ⲕⲁⲧⲁⲕⲣⲓⲛⲉ
ⲕⲁⲧⲁⲕⲣⲓⲥⲓⲥ	ⲕⲁⲧⲁⲕⲣⲓⲥⲓⲥ
ⲕⲁⲧⲁⲗⲁⲗⲉⲓ	ⲕⲁⲧⲁⲗⲁⲗⲉⲓ
ⲕⲁⲧⲁⲗⲁⲗⲓⲁ	ⲕⲁⲧⲁⲗⲁⲗⲓⲁ
ⲕⲁⲧⲁⲗⲁⲙⲃⲁⲛⲉ	ⲕⲁⲧⲁⲗⲁⲙⲃⲁⲛⲉ
ⲕⲁⲧⲁⲗⲁⲥⲉ	ⲕⲁⲧⲁⲗⲁⲥⲉ
ⲕⲁⲧⲁⲗⲗⲁⲅⲏ	ⲕⲁⲧⲁⲗⲗⲁⲅⲏ
ⲕⲁⲧⲁⲗⲩⲉ	ⲕⲁⲧⲁⲗⲩⲉ
ⲕⲁⲧⲁⲛⲟⲓ	ⲕⲁⲧⲁⲛⲟⲓ
ⲕⲁⲧⲁⲛⲧⲁ	ⲕⲁⲧⲁⲛⲧⲁ
ⲕⲁⲧⲁⲝⲓⲟⲩ	ⲕⲁⲧⲁⲝⲓⲟⲩ
ⲕⲁⲧⲁⲡⲁⲧⲓ	ⲕⲁⲧⲁⲡⲁⲧⲓ
ⲕⲁⲧⲁⲡⲉⲧⲁⲥⲙⲁ	ⲕⲁⲧⲁⲡⲉⲧⲁⲥⲙⲁ
ⲕⲁⲧⲁⲣⲅⲉⲓ	ⲕⲁⲧⲁⲣⲅⲉⲓ
ⲕⲁⲧⲁⲥⲕⲟⲡⲟⲥ	ⲕⲁⲧⲁⲥⲕⲟⲡⲟⲥ
ⲕⲁⲧⲁⲥⲧⲁⲥⲓⲥ	ⲕⲁⲧⲁⲥⲧⲁⲥⲓⲥ
ⲕⲁⲧⲁⲧⲁⲝⲓⲥ	ⲕⲁⲧⲁⲧⲁⲝⲓⲥ
ⲕⲁⲧⲁⲫⲣⲟⲛⲉⲓ	ⲕⲁⲧⲁⲫⲣⲟⲛⲉⲓ
ⲕⲁⲧⲁⲫⲣⲟⲛⲏⲥⲓⲥ	ⲕⲁⲧⲁⲫⲣⲟⲛⲏⲥⲓⲥ
ⲕⲁⲧⲁⲫⲣⲟⲛⲏⲧⲏⲥ	ⲕⲁⲧⲁⲫⲣⲟⲛⲏⲧⲏⲥ
ⲕⲁⲧⲁ	ⲕⲁⲧⲁ
ⲕⲁⲧⲉⲭⲉ	ⲕⲁⲧⲉⲭⲉ
ⲕⲁⲧⲏⲅⲟⲣⲉⲓ	ⲕⲁⲧⲏⲅⲟⲣⲉⲓ
ⲕⲁⲧⲏⲅⲟⲣⲓⲁ	ⲕⲁⲧⲏⲅⲟⲣⲓⲁ
ⲕⲁⲧⲏⲅⲟⲣⲟⲥ	ⲕⲁⲧⲏⲅⲟⲣⲟⲥ
ⲕⲁⲧⲏⲭⲏ	ⲕⲁⲧⲏⲭⲏ
ⲕⲁⲧⲓⲗⲁ	ⲕⲁⲧⲓⲗⲁ
ⲕⲁⲧⲟⲟⲧ	ⲕⲁ|ⲧⲟⲟⲧ
ⲕⲁⲧⲟⲣⲑⲟⲩ	ⲕⲁⲧⲟⲣⲑⲟⲩ
ⲕⲁⲧⲟⲣⲑⲱⲙⲁ	ⲕⲁⲧⲟⲣⲑⲱⲙⲁ
ⲕⲁⲧⲟⲥ	ⲕⲁⲧⲟⲥ
ⲕⲁⲧⲟⲭⲏ	ⲕⲁⲧⲟⲭⲏ
ⲕⲁⲩⲙⲁ	ⲕⲁⲩⲙⲁ
ⲕⲁⲩⲥⲱⲛ	ⲕⲁⲩⲥⲱⲛ
ⲕⲁⲩⲧⲏⲣⲓⲍⲉ	ⲕⲁⲩⲧⲏⲣⲓⲍⲉ
ⲕⲁⲯⲁ	ⲕⲁⲯⲁ
ⲕⲉⲃⲉⲣⲛⲓⲧⲏⲥ	ⲕⲉⲃⲉⲣⲛⲓⲧⲏⲥ
ⲕⲉⲃⲓⲱⲛ	ⲕⲉⲃⲓⲱⲛ
ⲕⲉⲇⲣⲟⲥ	ⲕⲉⲇⲣⲟⲥ
ⲕⲉⲕⲗⲉⲩⲧⲏⲥ	ⲕⲉⲕⲗⲉⲩⲧⲏⲥ
ⲕⲉⲗⲉⲩⲉⲥⲑⲁⲓ	ⲕⲉⲗⲉⲩⲉⲥⲑⲁⲓ
ⲕⲉⲗⲉⲩⲉ	ⲕⲉⲗⲉⲩⲉ
ⲕⲉⲗⲉⲩⲥⲓⲥ	ⲕⲉⲗⲉⲩⲥⲓⲥ
ⲕⲉⲛⲉⲅⲓⲟⲥ	ⲕⲉⲛⲉⲅⲓⲟⲥ
ⲕⲉⲛⲟⲇⲟⲝⲟⲥ	ⲕⲉⲛⲟⲇⲟⲝⲟⲥ
ⲕⲉⲛⲧⲉⲣⲓⲟⲛ	ⲕⲉⲛⲧⲉⲣⲓⲟⲛ
ⲕⲉⲛⲧⲏⲛⲁⲣⲓⲟⲛ	ⲕⲉⲛⲧⲏⲛⲁⲣⲓⲟⲛ
ⲕⲉⲣⲁⲍⲉ	ⲕⲉⲣⲁⲍⲉ
ⲕⲉⲣⲁⲓⲁ	ⲕⲉⲣⲁⲓⲁ
ⲕⲉⲣⲁⲙⲉⲩⲥ	ⲕⲉⲣⲁⲙⲉⲩⲥ
ⲕⲉⲣⲁⲡⲧⲉⲥ	ⲕⲉⲣⲁⲡⲧⲉⲥ
ⲕⲉⲣⲁⲥⲙⲁ	ⲕⲉⲣⲁⲥⲙⲁ
ⲕⲉⲣⲁⲧⲥⲉ	ⲕⲉⲣⲁⲧⲥⲉ
ⲕⲉⲣⲁ	ⲕⲉⲣⲁ
ⲕⲉⲣⲃⲟⲩ	ⲕⲉⲣⲃⲟⲩ
ⲕⲉⲣⲉⲁ	ⲕⲉⲣⲉⲁ
ⲕⲉⲣⲉⲓⲁ	ⲕⲉⲣⲉⲓⲁ
ⲕⲉⲣⲙⲁ	ⲕⲉⲣⲙⲁ
ⲕⲉⲧⲱⲛ	ⲕⲉⲧⲱⲛ
ⲕⲉⲫⲁⲗⲁⲓⲟⲛ	ⲕⲉⲫⲁⲗⲁⲓⲟⲛ
ⲕⲉⲫⲁⲗⲁⲓⲱⲧⲏⲥ	ⲕⲉⲫⲁⲗⲁⲓⲱⲧⲏⲥ
ⲕⲉⲫⲁⲗⲏ	ⲕⲉⲫⲁⲗⲏ
ⲕⲉⲫⲁⲗⲓⲥ	ⲕⲉⲫⲁⲗⲓⲥ
ⲕⲉ	ⲕⲉ
ⲕⲏⲕⲁϩⲏⲩ	ⲕⲏⲕ|ⲁϩⲏⲩ
ⲕⲏⲙⲏⲧⲉⲣⲓⲟⲛ	ⲕⲏⲙⲏⲧⲉⲣⲓⲟⲛ
ⲕⲏⲛⲥⲟⲥ	ⲕⲏⲛⲥⲟⲥ
ⲕⲏⲛⲱⲧⲏⲥ	ⲕⲏⲛⲱⲧⲏⲥ
ⲕⲏⲡⲟⲥ	ⲕⲏⲡⲟⲥ
ⲕⲏⲡⲟⲩⲣⲟⲥ	ⲕⲏⲡⲟⲩⲣⲟⲥ
ⲕⲏⲣⲩⲅⲙⲁ	ⲕⲏⲣⲩⲅⲙⲁ
ⲕⲏⲣⲩⲝ	ⲕⲏⲣⲩⲝ
ⲕⲏⲣⲩⲥⲥⲉ	ⲕⲏⲣⲩⲥⲥⲉ
ⲕⲏⲧⲟⲥ	ⲕⲏⲧⲟⲥ
ⲕⲓⲃⲱⲧⲟⲥ	ⲕⲓⲃⲱⲧⲟⲥ
ⲕⲓⲇⲁⲣⲓⲥ	ⲕⲓⲇⲁⲣⲓⲥ
ⲕⲓⲇⲣⲓⲟⲛ	ⲕⲓⲇⲣⲓⲟⲛ
ⲕⲓⲑⲁⲣⲁ	ⲕⲓⲑⲁⲣⲁ
ⲕⲓⲛⲇⲩⲛⲉⲩⲉ	ⲕⲓⲛⲇⲩⲛⲉⲩⲉ
ⲕⲓⲛⲇⲩⲛⲟⲥ	ⲕⲓⲛⲇⲩⲛⲟⲥ
ⲕⲓⲛⲏⲥⲓⲥ	ⲕⲓⲛⲏⲥⲓⲥ
ⲕⲓⲛⲛⲁⲙⲱⲙⲟⲛ	ⲕⲓⲛⲛⲁⲙⲱⲙⲟⲛ
ⲕⲓⲧⲣⲁ	ⲕⲓⲧⲣⲁ
ⲕⲗⲁⲃⲉⲕⲟⲗⲗⲁⲣⲓⲟⲥ	ⲕⲗⲁⲃⲉⲕⲟⲗⲗⲁⲣⲓⲟⲥ
ⲕⲗⲁⲇⲟⲥ	ⲕⲗⲁⲇⲟⲥ
ⲕⲗⲁⲥⲙⲁⲧⲓⲍⲉ	ⲕⲗⲁⲥⲙⲁⲧⲓⲍⲉ
ⲕⲗⲁⲥⲙⲁ	ⲕⲗⲁⲥⲙⲁ
ⲕⲗⲏⲙⲁ	ⲕⲗⲏⲙⲁ
ⲕⲗⲏⲣⲓⲕⲟⲥ	ⲕⲗⲏⲣⲓⲕⲟⲥ
ⲕⲗⲏⲣⲟⲛⲟⲙⲉⲓ	ⲕⲗⲏⲣⲟⲛⲟⲙⲉⲓ
ⲕⲗⲏⲣⲟⲛⲟⲙⲓⲁ	ⲕⲗⲏⲣⲟⲛⲟⲙⲓⲁ
ⲕⲗⲏⲣⲟⲛⲟⲙⲟⲥ	ⲕⲗⲏⲣⲟⲛⲟⲙⲟⲥ
ⲕⲗⲏⲣⲟⲥ	ⲕⲗⲏⲣⲟⲥ
ⲕⲗⲏⲣⲟⲩ	ⲕⲗⲏⲣⲟⲩ
ⲕⲗⲓⲙⲁ	ⲕⲗⲓⲙⲁ
ⲕⲟⲇⲣⲁⲛⲧⲏⲥ	ⲕⲟⲇⲣⲁⲛⲧⲏⲥ
ⲕⲟⲓⲗⲁⲥ	ⲕⲟⲓⲗⲁⲥ
ⲕⲟⲓⲗⲓⲁ	ⲕⲟⲓⲗⲓⲁ
ⲕⲟⲓⲛⲟⲃⲓⲟⲥ	ⲕⲟⲓⲛⲟⲃⲓⲟⲥ
ⲕⲟⲓⲛⲟⲛ	ⲕⲟⲓⲛⲟⲛ
ⲕⲟⲓⲛⲟⲥ	ⲕⲟⲓⲛⲟⲥ
ⲕⲟⲓⲛⲱⲛⲉⲓ	ⲕⲟⲓⲛⲱⲛⲉⲓ
ⲕⲟⲓⲛⲱⲛⲓⲁ	ⲕⲟⲓⲛⲱⲛⲓⲁ
ⲕⲟⲓⲛⲱⲛⲓ	ⲕⲟⲓⲛⲱⲛⲓ
ⲕⲟⲓⲛⲱⲛⲟⲥ	ⲕⲟⲓⲛⲱⲛⲟⲥ
ⲕⲟⲓⲧⲱⲛ	ⲕⲟⲓⲧⲱⲛ
ⲕⲟⲕⲕⲓⲛⲟⲥ	ⲕⲟⲕⲕⲓⲛⲟⲥ
ⲕⲟⲕⲕⲟⲥ	ⲕⲟⲕⲕⲟⲥ
ⲕⲟⲗⲁⲍⲉ	ⲕⲟⲗⲁⲍⲉ
ⲕⲟⲗⲁⲕⲉⲩⲉ	ⲕⲟⲗⲁⲕⲉⲩⲉ
ⲕⲟⲗⲁⲥⲓⲥ	ⲕⲟⲗⲁⲥⲓⲥ
ⲕⲟⲗⲁⲥⲧⲏⲣⲓⲟⲛ	ⲕⲟⲗⲁⲥⲧⲏⲣⲓⲟⲛ
ⲕⲟⲗⲗⲁⲣⲓⲟⲛ	ⲕⲟⲗⲗⲁⲣⲓⲟⲛ
ⲕⲟⲗⲗⲁ	ⲕⲟⲗⲗⲁ
ⲕⲟⲗⲟⲃⲟⲥ	ⲕⲟⲗⲟⲃⲟⲥ
ⲕⲟⲗⲡⲟⲥ	ⲕⲟⲗⲡⲟⲥ
ⲕⲟⲗⲩⲙⲃⲏⲑⲣⲁ	ⲕⲟⲗⲩⲙⲃⲏⲑⲣⲁ
ⲕⲟⲙⲁⲣⲓⲧⲏⲥ	ⲕⲟⲙⲁⲣⲓⲧⲏⲥ
ⲕⲟⲙⲉⲥ	ⲕⲟⲙⲉⲥ
ⲕⲟⲙⲏⲛⲧⲁⲣⲓⲥⲓⲟⲥ	ⲕⲟⲙⲏⲛⲧⲁⲣⲓⲥⲓⲟⲥ
ⲕⲟⲙⲏⲧⲁⲧⲟⲛ	ⲕⲟⲙⲏⲧⲁⲧⲟⲛ
ⲕⲟⲙⲡⲗⲉⲩⲥⲓⲥ	ⲕⲟⲙⲡⲗⲉⲩⲥⲓⲥ
ⲕⲟⲛⲇⲣⲁⲛⲧⲏⲥ	ⲕⲟⲛⲇⲣⲁⲛⲧⲏⲥ
ⲕⲟⲛⲓⲁ	ⲕⲟⲛⲓⲁ
ⲕⲟⲛⲧⲁⲣⲓⲟⲛ	ⲕⲟⲛⲧⲁⲣⲓⲟⲛ
ⲕⲟⲡⲣⲓⲁ	ⲕⲟⲡⲣⲓⲁ
ⲕⲟⲣⲏ	ⲕⲟⲣⲏ
ⲕⲟⲣⲓⲛⲑⲟⲥ	ⲕⲟⲣⲓⲛⲑⲟⲥ
ⲕⲟⲣⲝ	ⲕⲟⲣⲝ
ⲕⲟⲥⲙⲉⲓⲥⲑⲁⲓ	ⲕⲟⲥⲙⲉⲓⲥⲑⲁⲓ
ⲕⲟⲥⲙⲉⲓ	ⲕⲟⲥⲙⲉⲓ
ⲕⲟⲥⲙⲏⲥⲓⲥ	ⲕⲟⲥⲙⲏⲥⲓⲥ
ⲕⲟⲥⲙⲓⲕⲟⲛ	ⲕⲟⲥⲙⲓⲕⲟⲛ
ⲕⲟⲥⲙⲓⲕⲟⲥ	ⲕⲟⲥⲙⲓⲕⲟⲥ
ⲕⲟⲥⲙⲟⲕⲣⲁⲧⲱⲣ	ⲕⲟⲥⲙⲟⲕⲣⲁⲧⲱⲣ
ⲕⲟⲥⲙⲟⲥ	ⲕⲟⲥⲙⲟⲥ
ⲕⲟⲩⲕⲗⲓⲟⲛ	ⲕⲟⲩⲕⲗⲓⲟⲛ
ⲕⲟⲩⲕⲟⲩⲙⲓⲟⲛ	ⲕⲟⲩⲕⲟⲩⲙⲓⲟⲛ
ⲕⲟⲩⲗⲁⲑⲉ	ⲕⲟⲩⲗⲁⲑⲉ
ⲕⲟⲩⲙⲫⲟⲥ	ⲕⲟⲩⲙⲫⲟⲥ
ⲕⲟⲩⲝ	ⲕⲟⲩⲝ
ⲕⲟⲩⲫⲓⲍⲉ	ⲕⲟⲩⲫⲓⲍⲉ
ⲕⲟⲩⲫⲟⲛ	ⲕⲟⲩⲫⲟⲛ
ⲕⲟⲭⲗⲓⲁⲣⲓⲛ	ⲕⲟⲭⲗⲓⲁⲣⲓⲛ
ⲕⲣⲁⲛⲓⲟⲛ	ⲕⲣⲁⲛⲓⲟⲛ
ⲕⲣⲁⲥⲓⲥ	ⲕⲣⲁⲥⲓⲥ
ⲕⲣⲁⲧⲏⲣ	ⲕⲣⲁⲧⲏⲣ
ⲕⲣⲁⲧⲟⲥ	ⲕⲣⲁⲧⲟⲥ
ⲕⲣⲁⲩⲅⲏ	ⲕⲣⲁⲩⲅⲏ
ⲕⲣⲏⲧⲉⲥ	ⲕⲣⲏⲧⲉⲥ
ⲕⲣⲓⲙⲁ	ⲕⲣⲓⲙⲁ
ⲕⲣⲓⲛⲉ	ⲕⲣⲓⲛⲉ
ⲕⲣⲓⲛⲟⲛ	ⲕⲣⲓⲛⲟⲛ
ⲕⲣⲓⲥⲓⲥ	ⲕⲣⲓⲥⲓⲥ
ⲕⲣⲓⲧⲏⲣⲓⲟⲛ	ⲕⲣⲓⲧⲏⲣⲓⲟⲛ
ⲕⲣⲓⲧⲏⲥ	ⲕⲣⲓⲧⲏⲥ
ⲕⲣⲟϥ	ⲕⲣⲟϥ
ⲕⲣⲟⲕⲟⲥ	ⲕⲣⲟⲕⲟⲥ
ⲕⲣⲩⲥⲧⲁⲗⲗⲟⲛ	ⲕⲣⲩⲥⲧⲁⲗⲗⲟⲛ
ⲕⲣⲩⲥⲧⲁⲗⲗⲟⲥ	ⲕⲣⲩⲥⲧⲁⲗⲗⲟⲥ
ⲕⲧⲉⲓⲁⲧ	ⲕⲧ|ⲉⲓⲁⲧ
ⲕⲧⲏⲙⲁ	ⲕⲧⲏⲙⲁ
ⲕⲧⲓⲥⲓⲥ	ⲕⲧⲓⲥⲓⲥ
ⲕⲧⲓⲥⲙⲁ	ⲕⲧⲓⲥⲙⲁ
ⲕⲩⲇⲁⲣⲓⲧⲏⲥ	ⲕⲩⲇⲁⲣⲓⲧⲏⲥ
ⲕⲩⲕⲗⲟⲥ	ⲕⲩⲕⲗⲟⲥ
ⲕⲩⲗⲗⲟⲥ	ⲕⲩⲗⲗⲟⲥ
ⲕⲩⲙⲃⲁⲗⲟⲛ	ⲕⲩⲙⲃⲁⲗⲟⲛ
ⲕⲩⲙⲏⲗⲓⲟⲛ	ⲕⲩⲙⲏⲗⲓⲟⲛ
ⲕⲩⲡⲁⲣⲓⲥⲥⲟⲥ	ⲕⲩⲡⲁⲣⲓⲥⲥⲟⲥ
ⲕⲩⲡⲏ	ⲕⲩⲡⲏ
ⲕⲩⲡⲣⲓⲟⲥ	ⲕⲩⲡⲣⲓⲟⲥ
ⲕⲩⲡⲣⲟⲥ	ⲕⲩⲡⲣⲟⲥ
ⲕⲩⲣⲏⲛⲁⲓⲟⲥ	ⲕⲩⲣⲏⲛⲁⲓⲟⲥ
ⲕⲩⲣⲓⲁⲕⲏ	ⲕⲩⲣⲓⲁⲕⲏ
ⲕⲩⲣⲓⲉⲩⲉⲥⲑⲁⲓ	ⲕⲩⲣⲓⲉⲩⲉⲥⲑⲁⲓ
ⲕⲩⲣⲓⲱⲥ	ⲕⲩⲣⲓⲱⲥ
ⲕⲩⲣⲓ	ⲕⲩⲣⲓ
ⲕⲩⲣⲟⲥ	ⲕⲩⲣⲟⲥ
ⲕⲱⲗⲩⲉ	ⲕⲱⲗⲩⲉ
ⲕⲱⲙⲏ	ⲕⲱⲙⲏ
ⲕⲱⲛⲓⲁⲍⲉ	ⲕⲱⲛⲓⲁⲍⲉ
ⲕⲱⲡⲓⲥ	ⲕⲱⲡⲓⲥ
ⲕⲱⲣⲉⲝ	ⲕⲱⲣⲉⲝ
ⲕⲱⲥⲧⲱϯⲁ	ⲕⲱⲥⲧⲱϯⲁ
ⲕⲱⲧⲱⲛ	ⲕⲱⲧⲱⲛ
ⲕⲱⲫⲟⲛ	ⲕⲱⲫⲟⲛ
ⲗⲁⲓⲕⲟⲥ	ⲗⲁⲓⲕⲟⲥ
ⲗⲁⲕⲁⲛⲏ	ⲗⲁⲕⲁⲛⲏ
ⲗⲁⲕⲕⲟⲥ	ⲗⲁⲕⲕⲟⲥ
ⲗⲁⲕⲟⲛ	ⲗⲁⲕⲟⲛ
ⲗⲁⲕⲧⲓⲍⲉ	ⲗⲁⲕⲧⲓⲍⲉ
ⲗⲁⲗⲓⲁ	ⲗⲁⲗⲓⲁ
ⲗⲁⲙⲡⲁⲥ	ⲗⲁⲙⲡⲁⲥ
ⲗⲁⲙⲡⲣⲟⲧⲁⲧⲟⲥ	ⲗⲁⲙⲡⲣⲟⲧⲁⲧⲟⲥ
ⲗⲁⲙⲡⲣⲟⲧⲏⲥ	ⲗⲁⲙⲡⲣⲟⲧⲏⲥ
ⲗⲁⲙⲯⲁⲛⲉ	ⲗⲁⲙⲯⲁⲛⲉ
ⲗⲁⲛⲑⲁⲛⲉ	ⲗⲁⲛⲑⲁⲛⲉ
ⲗⲁⲟⲥ	ⲗⲁⲟⲥ
ⲗⲁⲩⲣⲁ	ⲗⲁⲩⲣⲁ
ⲗⲉϥⲇⲓⲙⲟⲣⲓ	ⲗⲉϥ|ⲇⲓⲙⲟⲣⲓ
ⲗⲉⲃⲏⲥ	ⲗⲉⲃⲏⲥ
ⲗⲉⲅⲅⲉⲓⲣⲓⲟⲛ	ⲗⲉⲅⲅⲉⲓⲣⲓⲟⲛ
ⲗⲉⲅⲉⲱⲛ	ⲗⲉⲅⲉⲱⲛ
ⲗⲉⲓⲧⲟⲩⲣⲅⲓⲁ	ⲗⲉⲓⲧⲟⲩⲣⲅⲓⲁ
ⲗⲉⲓⲧⲟⲩⲣⲅⲟⲥ	ⲗⲉⲓⲧⲟⲩⲣⲅⲟⲥ
ⲗⲉⲕⲧⲟⲩⲙⲉⲛⲟⲥ	ⲗⲉⲕⲧⲟⲩⲙⲉⲛⲟⲥ
ⲗⲉⲛⲧⲓⲟⲛ	ⲗⲉⲛⲧⲓⲟⲛ
ⲗⲉⲝⲓⲥ	ⲗⲉⲝⲓⲥ
ⲗⲉⲟⲡⲁⲣⲇⲁⲗⲓⲥ	ⲗⲉⲟⲡⲁⲣⲇⲁⲗⲓⲥ
ⲗⲉⲡⲧⲟⲛ	ⲗⲉⲡⲧⲟⲛ
ⲗⲉⲥⲭⲏ	ⲗⲉⲥⲭⲏ
ⲗⲉⲩⲓⲧⲏⲥ	ⲗⲉⲩⲓⲧⲏⲥ
ⲗⲉⲩⲕⲏ	ⲗⲉⲩⲕⲏ
ⲗⲏⲙⲙⲁ	ⲗⲏⲙⲙⲁ
ⲗⲏⲥⲧⲏⲥ	ⲗⲏⲥⲧⲏⲥ
ⲗⲓⲃⲁⲛⲟⲥ	ⲗⲓⲃⲁⲛⲟⲥ
ⲗⲓⲃⲉⲣⲧⲓⲛⲟⲥ	ⲗⲓⲃⲉⲣⲧⲓⲛⲟⲥ
ⲗⲓⲇⲣⲁ	ⲗⲓⲇⲣⲁ
ⲗⲓⲕⲛⲟⲛ	ⲗⲓⲕⲛⲟⲛ
ⲗⲓⲙⲏⲛ	ⲗⲓⲙⲏⲛ
ⲗⲓⲙⲛⲏ	ⲗⲓⲙⲛⲏ
ⲗⲓⲧⲟⲩⲣⲅⲓⲁ	ⲗⲓⲧⲟⲩⲣⲅⲓⲁ
ⲗⲓⲧⲣⲁ	ⲗⲓⲧⲣⲁ
ⲗⲟⲅⲓⲍⲉ	ⲗⲟⲅⲓⲍⲉ
ⲗⲟⲅⲓⲕⲏ	ⲗⲟⲅⲓⲕⲏ
ⲗⲟⲅⲓⲕⲟⲛ	ⲗⲟⲅⲓⲕⲟⲛ
ⲗⲟⲅⲓⲕⲟⲥ	ⲗⲟⲅⲓⲕⲟⲥ
ⲗⲟⲅⲓⲥⲙⲟⲥ	ⲗⲟⲅⲓⲥⲙⲟⲥ
ⲗⲟⲅⲟⲅⲉⲛⲏⲥ	ⲗⲟⲅⲟⲅⲉⲛⲏⲥ
ⲗⲟⲅⲟⲅⲣⲁⲫⲟⲥ	ⲗⲟⲅⲟⲅⲣⲁⲫⲟⲥ
ⲗⲟⲅⲟⲥ	ⲗⲟⲅⲟⲥ
ⲗⲟⲅⲭⲏ	ⲗⲟⲅⲭⲏ
ⲗⲟⲅⲭⲓⲍⲉ	ⲗⲟⲅⲭⲓⲍⲉ
ⲗⲟⲓⲙⲟⲥ	ⲗⲟⲓⲙⲟⲥ
ⲗⲟⲓⲡⲁⲥ	ⲗⲟⲓⲡⲁⲥ
ⲗⲟⲓⲡⲟⲛ	ⲗⲟⲓⲡⲟⲛ
ⲗⲟⲣⲟⲥ	ⲗⲟⲣⲟⲥ
ⲗⲟⲩⲡⲁⲥ	ⲗⲟⲩⲡⲁⲥ
ⲗⲟⲩⲥⲓⲙⲟⲛ	ⲗⲟⲩⲥⲓⲙⲟⲛ
ⲗⲩⲕⲁⲟⲛⲓⲥⲧⲓ	ⲗⲩⲕⲁⲟⲛⲓⲥⲧⲓ
ⲗⲩⲙⲏⲛ	ⲗⲩⲙⲏⲛ
ⲗⲩⲡⲉⲓ	ⲗⲩⲡⲉⲓ
ⲗⲩⲡⲏ	ⲗⲩⲡⲏ
ⲗⲩⲭⲛⲓⲁ	ⲗⲩⲭⲛⲓⲁ
ⲗⲭⲩⲛⲓⲕⲟⲛ	ⲗⲭⲩⲛⲓⲕⲟⲛ
ⲗⲱⲧⲉⲝ	ⲗⲱⲧⲉⲝ
ⲙⲁⲅⲁⲛⲟⲛ	ⲙⲁⲅⲁⲛⲟⲛ
ⲙⲁⲅⲇⲁⲗⲏⲛⲏ	ⲙⲁⲅⲇⲁⲗⲏⲛⲏ
ⲙⲁⲅⲉⲓⲁ	ⲙⲁⲅⲉⲓⲁ
ⲙⲁⲅⲓⲣⲟⲥ	ⲙⲁⲅⲓⲣⲟⲥ
ⲙⲁⲅⲟⲥ	ⲙⲁⲅⲟⲥ
ⲙⲁⲅⲟⲩⲥⲁⲓⲟⲥ	ⲙⲁⲅⲟⲩⲥⲁⲓⲟⲥ
ⲙⲁⲑⲏⲧⲉⲩⲉ	ⲙⲁⲑⲏⲧⲉⲩⲉ
ⲙⲁⲑⲏⲧⲏⲥ	ⲙⲁⲑⲏⲧⲏⲥ
ⲙⲁⲑⲙⲥⲟ	ⲙⲁ|ⲑⲙⲥⲟ
ⲙⲁⲓ̈ⲛⲏⲥⲧⲓ̈ⲁ	ⲙⲁⲓ̈|ⲛⲏⲥⲧⲓ̈ⲁ
ⲙⲁⲓⲁⲅⲁⲑⲟⲛ	ⲙⲁⲓ|ⲁⲅⲁⲑⲟⲛ
ⲙⲁⲓⲁⲅⲁⲡⲏ	ⲙⲁⲓ|ⲁⲅⲁⲡⲏ
ⲙⲁⲓⲛⲟⲩⲧⲉ	ⲙⲁⲓ|ⲛⲟⲩⲧⲉ
ⲙⲁⲓⲡⲁⲑⲟⲥ	ⲙⲁⲓ|ⲡⲁⲑⲟⲥ
ⲙⲁⲓⲧⲟ	ⲙⲁⲓ|ⲧⲟ
ⲙⲁⲓⲭⲣⲏⲙⲁ	ⲙⲁⲓ|ⲭⲣⲏⲙⲁ
ⲙⲁⲓ(ⲡⲉ)ⲭⲣⲓⲥⲧⲟⲥ	ⲙⲁⲓ|(ⲡⲉ)ⲭⲣⲓⲥⲧⲟⲥ
ⲙⲁⲕⲁⲣⲓⲁ	ⲙⲁⲕⲁⲣⲓⲁ
ⲙⲁⲕⲁⲣⲓⲍⲉ	ⲙⲁⲕⲁⲣⲓⲍⲉ
ⲙⲁⲕⲁⲣⲓⲟⲛ	ⲙⲁⲕⲁⲣⲓⲟⲛ
ⲙⲁⲕⲁⲣⲓⲟⲥ	ⲙⲁⲕⲁⲣⲓⲟⲥ
ⲙⲁⲕⲁⲣⲓⲟⲧⲏⲥ	ⲙⲁⲕⲁⲣⲓⲟⲧⲏⲥ
ⲙⲁⲕⲁⲣⲓⲥⲙⲟⲥ	ⲙⲁⲕⲁⲣⲓⲥⲙⲟⲥ
ⲙⲁⲕⲓⲥ	ⲙⲁⲕⲓⲥ
ⲙⲁⲗⲁⲕⲟⲥ	ⲙⲁⲗⲁⲕⲟⲥ
ⲙⲁⲗⲓⲥⲧⲁ	ⲙⲁⲗⲓⲥⲧⲁ
ⲙⲁⲗⲗⲟⲛ	ⲙⲁⲗⲗⲟⲛ
ⲙⲁⲙⲱⲛⲁⲥ	ⲙⲁⲙⲱⲛⲁⲥ
ⲙⲁⲛⲅⲁⲛⲟⲛ	ⲙⲁⲛⲅⲁⲛⲟⲛ
ⲙⲁⲛⲓⲁ	ⲙⲁⲛⲓⲁ
ⲙⲁⲛⲡⲉⲧⲣⲁ	ⲙⲁ|ⲛ|ⲡⲉⲧⲣⲁ
ⲙⲁⲛⲧⲁⲕⲏ	ⲙⲁⲛⲧⲁⲕⲏ
ⲙⲁⲡⲡⲁ	ⲙⲁⲡⲡⲁ
ⲙⲁⲣⲅⲁⲣⲓⲧⲏⲥ	ⲙⲁⲣⲅⲁⲣⲓⲧⲏⲥ
ⲙⲁⲣⲧⲉⲣⲓⲍⲉ	ⲙⲁⲣⲧⲉⲣⲓⲍⲉ
ⲙⲁⲣⲧⲩⲣⲓⲁ	ⲙⲁⲣⲧⲩⲣⲓⲁ
ⲙⲁⲣⲧⲩⲣⲓⲕⲟⲛ	ⲙⲁⲣⲧⲩⲣⲓⲕⲟⲛ
ⲙⲁⲣⲧⲩⲣⲓⲛ	ⲙⲁⲣⲧⲩⲣⲓⲛ
ⲙⲁⲣⲧⲩⲣⲓⲟⲛ	ⲙⲁⲣⲧⲩⲣⲓⲟⲛ
ⲙⲁⲣⲧⲩⲣⲟⲗⲟⲅⲓⲟⲛ	ⲙⲁⲣⲧⲩⲣⲟⲗⲟⲅⲓⲟⲛ
ⲙⲁⲣⲧⲩⲣⲟⲥ	ⲙⲁⲣⲧⲩⲣⲟⲥ
ⲙⲁⲣⲧⲩⲥ	ⲙⲁⲣⲧⲩⲥ
ⲙⲁⲥϯⲭⲉ	ⲙⲁⲥϯⲭⲉ
ⲙⲁⲥⲟⲩⲣ	ⲙⲁⲥⲟⲩⲣ
ⲙⲁⲥⲧⲓⲅⲝ	ⲙⲁⲥⲧⲓⲅⲝ
ⲙⲁⲥⲧⲓⲅⲟⲩ	ⲙⲁⲥⲧⲓⲅⲟⲩ
ⲙⲁⲥⲧⲓⲕⲟⲥ	ⲙⲁⲥⲧⲓⲕⲟⲥ
ⲙⲁⲧⲣⲱⲛⲁ	ⲙⲁⲧⲣⲱⲛⲁ
ⲙⲁⲩⲗⲓⲍⲉ	ⲙⲁⲩⲗⲓⲍⲉ
ⲙⲉϩϣⲟⲙⲛⲧ	ⲙⲉϩ|ϣⲟⲙⲛⲧ
ⲙⲉϩϣⲟⲙⲧⲥⲱⲱⲡ	ⲙⲉϩ|ϣⲟⲙⲧ|ⲥⲱⲱⲡ
ⲙⲉϩϥⲧⲟⲟⲩ	ⲙⲉϩ|ϥⲧⲟⲟⲩ
ⲙⲉϩⲥⲁϣϥ	ⲙⲉϩ|ⲥⲁϣϥ
ⲙⲉϩⲥⲉⲡⲥⲛⲁⲩ	ⲙⲉϩ|ⲥⲉⲡ|ⲥⲛⲁⲩ
ⲙⲉϩⲥⲛⲁⲩ	ⲙⲉϩ|ⲥⲛⲁⲩ
ⲙⲉϩⲥⲛⲧⲉ	ⲙⲉϩ|ⲥⲛⲧⲉ
ⲙⲉⲅⲉⲑⲟⲥ	ⲙⲉⲅⲉⲑⲟⲥ
ⲙⲉⲅⲓⲥⲧⲁⲛⲟⲥ	ⲙⲉⲅⲓⲥⲧⲁⲛⲟⲥ
ⲙⲉⲓⲗⲓⲟⲛ	ⲙⲉⲓⲗⲓⲟⲛ
ⲙⲉⲗⲁⲛ	ⲙⲉⲗⲁⲛ
ⲙⲉⲗⲉⲓ	ⲙⲉⲗⲉⲓ
ⲙⲉⲗⲉⲧⲁ	ⲙⲉⲗⲉⲧⲁ
ⲙⲉⲗⲉⲧⲏⲥⲓⲥ	ⲙⲉⲗⲉⲧⲏⲥⲓⲥ
ⲙⲉⲗⲉⲧⲏ	ⲙⲉⲗⲉⲧⲏ
ⲙⲉⲗⲓ	ⲙⲉⲗⲓ
ⲙⲉⲗⲟⲅⲣⲁⲫⲟⲥ	ⲙⲉⲗⲟⲅⲣⲁⲫⲟⲥ
ⲙⲉⲗⲟⲥ	ⲙⲉⲗⲟⲥ
ⲙⲉⲙⲫⲓ	ⲙⲉⲙⲫⲓ
ⲙⲉⲛⲉⲩⲉ	ⲙⲉⲛⲉⲩⲉ
ⲙⲉⲛⲧϩⲏⲙⲉⲣⲟⲥ	ⲙⲉⲛⲧ|ϩⲏⲙⲉⲣⲟⲥ
ⲙⲉⲛⲧⲟⲓⲅⲉ	ⲙⲉⲛⲧⲟⲓⲅⲉ
ⲙⲉⲛⲧⲟⲓ	ⲙⲉⲛⲧⲟⲓ
ⲙⲉⲛ	ⲙⲉⲛ
ⲙⲉⲣⲉⲟⲩⲱϩ	ⲙⲉⲣⲉ|ⲟⲩⲱϩ
ⲙⲉⲣⲓⲍⲉ	ⲙⲉⲣⲓⲍⲉ
ⲙⲉⲣⲓⲕⲟⲥ	ⲙⲉⲣⲓⲕⲟⲥ
ⲙⲉⲣⲓⲥⲙⲟⲥ	ⲙⲉⲣⲓⲥⲙⲟⲥ
ⲙⲉⲣⲓⲥ	ⲙⲉⲣⲓⲥ
ⲙⲉⲣⲟⲥ	ⲙⲉⲣⲟⲥ
ⲙⲉⲥⲏⲙⲃⲣⲓⲁ	ⲙⲉⲥⲏⲙⲃⲣⲓⲁ
ⲙⲉⲥⲓⲧⲏⲥ	ⲙⲉⲥⲓⲧⲏⲥ
ⲙⲉⲥⲟⲧⲏⲥ	ⲙⲉⲥⲟⲧⲏⲥ
ⲙⲉⲧⲁⲃⲟⲗⲏ	ⲙⲉⲧⲁⲃⲟⲗⲏ
ⲙⲉⲧⲁⲅⲅⲓⲥⲙⲟⲥ	ⲙⲉⲧⲁⲅⲅⲓⲥⲙⲟⲥ
ⲙⲉⲧⲁⲗⲗⲟⲛ	ⲙⲉⲧⲁⲗⲗⲟⲛ
ⲙⲉⲧⲁⲛⲟⲉⲓ	ⲙⲉⲧⲁⲛⲟⲉⲓ
ⲙⲉⲧⲁⲛⲟⲓⲁ	ⲙⲉⲧⲁⲛⲟⲓⲁ
ⲙⲉⲧⲁ	ⲙⲉⲧⲁ
ⲙⲉⲧⲉⲭⲉ	ⲙⲉⲧⲉⲭⲉ
ⲙⲉⲧⲟⲭⲟⲥ	ⲙⲉⲧⲟⲭⲟⲥ
ⲙⲉⲧⲡⲁⲧⲣⲓⲁⲣⲭⲏⲥ	ⲙⲉⲧ|ⲡⲁⲧⲣⲓⲁⲣⲭⲏⲥ
ⲙⲉⲧⲣⲏⲧⲏⲥ	ⲙⲉⲧⲣⲏⲧⲏⲥ
ⲙⲉⲧⲣⲟⲛ	ⲙⲉⲧⲣⲟⲛ
ⲙⲉⲧⲥⲭⲟⲗⲁⲥⲧⲓⲕⲟⲥ	ⲙⲉⲧ|ⲥⲭⲟⲗⲁⲥⲧⲓⲕⲟⲥ
ⲙⲉⲧⲧⲉⲭⲛⲓⲧⲏⲥ	ⲙⲉⲧ|ⲧⲉⲭⲛⲓⲧⲏⲥ
ⲙⲉⲭⲣⲓ	ⲙⲉⲭⲣⲓ
ⲙⲏⲃⲣⲁⲛⲟⲛ	ⲙⲏⲃⲣⲁⲛⲟⲛ
ⲙⲏⲇⲟⲥ	ⲙⲏⲇⲟⲥ
ⲙⲏⲛ	ⲙⲏⲛ
ⲙⲏⲡⲟⲧⲉ	ⲙⲏⲡⲟⲧⲉ
ⲙⲏⲡⲱⲥ	ⲙⲏⲡⲱⲥ
ⲙⲏⲣⲟⲥ	ⲙⲏⲣⲟⲥ
ⲙⲏⲧⲓ	ⲙⲏⲧⲓ
ⲙⲏⲧⲣⲁ	ⲙⲏⲧⲣⲁ
ⲙⲏⲧⲣⲟⲡⲁⲧⲱⲣ	ⲙⲏⲧⲣⲟⲡⲁⲧⲱⲣ
ⲙⲏⲧⲣⲟⲡⲟⲗⲓⲥ	ⲙⲏⲧⲣⲟⲡⲟⲗⲓⲥ
ⲙⲏⲭⲁⲛⲏ	ⲙⲏⲭⲁⲛⲏ
ⲙⲏ	ⲙⲏ
ⲙⲓⲗⲓⲟⲛ	ⲙⲓⲗⲓⲟⲛ
ⲙⲓⲥⲑⲱⲥⲓⲥ	ⲙⲓⲥⲑⲱⲥⲓⲥ
ⲙⲓⲥⲑⲱⲧⲏⲥ	ⲙⲓⲥⲑⲱⲧⲏⲥ
ⲙⲓⲧⲁⲧⲱⲣ	ⲙⲓⲧⲁⲧⲱⲣ
ⲙⲓⲧⲣⲁ	ⲙⲓⲧⲣⲁ
ⲙⲛⲏⲙⲏ	ⲙⲛⲏⲙⲏ
ⲙⲛⲧϣⲁϥⲧⲉ	ⲙⲛⲧ|ϣⲁϥⲧⲉ
ⲙⲛⲧϣⲁⲛϩⲧⲏ	ⲙⲛⲧ|ϣⲁⲛ|ϩⲧⲏ
ⲙⲛⲧϣⲁⲩ	ⲙⲛⲧ|ϣⲁⲩ
ⲙⲛⲧϩⲁⲡⲗⲟⲩⲥ	ⲙⲛⲧ|ϩⲁⲡⲗⲟⲩⲥ
ⲙⲛⲧϩⲁⲣϣϩⲏⲧ	ⲙⲛⲧ|ϩⲁⲣϣ|ϩⲏⲧ
ⲙⲛⲧϩⲉⲃⲣⲁⲓⲟⲥ	ⲙⲛⲧϩⲉⲃⲣⲁⲓⲟⲥ
ⲙⲛⲧϩⲉⲃⲣⲁⲓⲟⲥ	ⲙⲛⲧ|ϩⲉⲃⲣⲁⲓⲟⲥ
ⲙⲛⲧϩⲉⲣⲉⲥⲓⲥ	ⲙⲛⲧ|ϩⲉⲣⲉⲥⲓⲥ
ⲙⲛⲧϩⲏⲕⲉ	ⲙⲛⲧ|ϩⲏⲕⲉ
ⲙⲛⲧϩⲏⲙⲉⲣⲟⲥ	ⲙⲛⲧ|ϩⲏⲙⲉⲣⲟⲥ
ⲙⲛⲧϩⲗⲗⲟ	ⲙⲛⲧ|ϩⲗⲗⲟ
ⲙⲛⲧϩⲗⲗⲱ	ⲙⲛⲧ|ϩⲗⲗⲱ
ⲙⲛⲧϩⲙϩⲁⲗ	ⲙⲛⲧ|ϩⲙϩⲁⲗ
ⲙⲛⲧϩⲣⲱⲙⲁⲓⲟⲥ	ⲙⲛⲧ|ϩⲣⲱⲙⲁⲓⲟⲥ
ⲙⲛⲧϫⲁϫⲉ	ⲙⲛⲧ|ϫⲁϫⲉ
ⲙⲛⲧϫⲁⲥⲓϩⲏⲧ	ⲙⲛⲧ|ϫⲁⲥⲓ|ϩⲏⲧ
ⲙⲛⲧϫⲱⲱⲣⲉ	ⲙⲛⲧ|ϫⲱⲱⲣⲉ
ⲙⲛⲧϭⲁⲃϩⲏⲧ	ⲙⲛⲧ|ϭⲁⲃ|ϩⲏⲧ
ⲙⲛⲧϭⲱⲃ	ⲙⲛⲧ|ϭⲱⲃ
ⲙⲛⲧⲁⲅⲁⲑⲟⲥ	ⲙⲛⲧⲁⲅⲁⲑⲟⲥ
ⲙⲛⲧⲁⲅⲁⲑⲟⲥ	ⲙⲛⲧ|ⲁⲅⲁⲑⲟⲥ
ⲙⲛⲧⲁⲅⲉⲛⲛⲏⲧⲟⲥ	ⲙⲛⲧ|ⲁⲅⲉⲛⲛⲏⲧⲟⲥ
ⲙⲛⲧⲁⲅⲣⲟⲓⲕⲟⲥ	ⲙⲛⲧ|ⲁⲅⲣⲟⲓⲕⲟⲥ
ⲙⲛⲧⲁⲑⲏⲧ	ⲙⲛⲧ|ⲁⲧ|ϩⲏⲧ
ⲙⲛⲧⲁⲕⲁⲑⲁⲣⲧⲟⲥ	ⲙⲛⲧ|ⲁⲕⲁⲑⲁⲣⲧⲟⲥ
ⲙⲛⲧⲁⲕⲁⲕⲟⲥ	ⲙⲛⲧ|ⲁⲕⲁⲕⲟⲥ
ⲙⲛⲧⲁⲕⲉⲣⲁⲓⲟⲥ	ⲙⲛⲧ|ⲁⲕⲉⲣⲁⲓⲟⲥ
ⲙⲛⲧⲁⲕⲣⲓⲃⲏⲥ	ⲙⲛⲧ|ⲁⲕⲣⲓⲃⲏⲥ
ⲙⲛⲧⲁⲗⲁⲍⲱⲛ	ⲙⲛⲧ|ⲁⲗⲁⲍⲱⲛ
ⲙⲛⲧⲁⲙⲉⲗⲏⲥ	ⲙⲛⲧ|ⲁⲙⲉⲗⲏⲥ
ⲙⲛⲧⲁⲛⲁⲓⲥⲑⲏⲧⲟⲥ	ⲙⲛⲧ|ⲁⲛⲁⲓⲥⲑⲏⲧⲟⲥ
ⲙⲛⲧⲁⲛⲟⲏⲧⲟⲥ	ⲙⲛⲧ|ⲁⲛⲟⲏⲧⲟⲥ
ⲙⲛⲧⲁⲛⲟⲩⲥⲓⲟⲥ	ⲙⲛⲧ|ⲁⲛⲟⲩⲥⲓⲟⲥ
ⲙⲛⲧⲁⲡⲓⲥⲧⲟⲥ	ⲙⲛⲧ|ⲁⲡⲓⲥⲧⲟⲥ
ⲙⲛⲧⲁⲡⲟⲥⲧⲁⲧⲏⲥ	ⲙⲛⲧ|ⲁⲡⲟⲥⲧⲁⲧⲏⲥ
ⲙⲛⲧⲁⲡⲟⲥⲧⲟⲗⲟⲥ	ⲙⲛⲧ|ⲁⲡⲟⲥⲧⲟⲗⲟⲥ
ⲙⲛⲧⲁⲡⲟⲥⲧⲟⲥ	ⲙⲛⲧ|ⲁⲡⲟⲥⲧⲟⲥ
ⲙⲛⲧⲁⲡⲟⲧⲁⲕⲧⲓⲕⲟⲥ	ⲙⲛⲧ|ⲁⲡⲟⲧⲁⲕⲧⲓⲕⲟⲥ
ⲙⲛⲧⲁⲣⲅⲟⲥ	ⲙⲛⲧ|ⲁⲣⲅⲟⲥ
ⲙⲛⲧⲁⲥⲉⲃⲏⲥ	ⲙⲛⲧ|ⲁⲥⲉⲃⲏⲥ
ⲙⲛⲧⲁⲥⲑⲉⲛⲏⲥ	ⲙⲛⲧ|ⲁⲥⲑⲉⲛⲏⲥ
ⲙⲛⲧⲁⲧϩⲏⲧ	ⲙⲛⲧ|ⲁⲧ|ϩⲏⲧ
ⲙⲛⲧⲁⲧϩⲛⲁⲁⲩ	ⲙⲛⲧ|ⲁⲧ|ϩⲛⲁⲁⲩ
ⲙⲛⲧⲁⲧⲁⲙⲁϩⲧⲉ	ⲙⲛⲧ|ⲁⲧ|ⲁⲙⲁϩⲧⲉ
ⲙⲛⲧⲁⲧⲁⲝⲓⲁ	ⲙⲛⲧ|ⲁⲧⲁⲝⲓⲁ
ⲙⲛⲧⲁⲧⲇⲓⲁⲕⲣⲓⲛⲉ	ⲙⲛⲧ|ⲁⲧ|ⲇⲓⲁⲕⲣⲓⲛⲉ
ⲙⲛⲧⲁⲧⲛⲁϩⲧⲉ	ⲙⲛⲧ|ⲁⲧ|ⲛⲁϩⲧⲉ
ⲙⲛⲧⲁⲧⲛⲟⲩⲧⲉ	ⲙⲛⲧ|ⲁⲧ|ⲛⲟⲩⲧⲉ
ⲙⲛⲧⲁⲧⲥⲃⲃⲉ	ⲙⲛⲧ|ⲁⲧ|ⲥⲃⲃⲉ
ⲙⲛⲧⲁⲧⲥⲃⲱ	ⲙⲛⲧ|ⲁⲧ|ⲥⲃⲱ
ⲙⲛⲧⲁⲧⲥⲟⲟⲩⲛ	ⲙⲛⲧ|ⲁⲧ|ⲥⲟⲟⲩⲛ
ⲙⲛⲧⲁⲧⲥⲱⲧⲙ	ⲙⲛⲧ|ⲁⲧ|ⲥⲱⲧⲙ
ⲙⲛⲧⲁⲧⲫⲑⲟⲛⲟⲥ	ⲙⲛⲧ|ⲁⲧ|ⲫⲑⲟⲛⲟⲥ
ⲙⲛⲧⲁⲩⲑⲁⲇⲏⲥ	ⲙⲛⲧ|ⲁⲩⲑⲁⲇⲏⲥ
ⲙⲛⲧⲁⲩⲑⲉⲛⲧⲏⲥ	ⲙⲛⲧ|ⲁⲩⲑⲉⲛⲧⲏⲥ
ⲙⲛⲧⲁⲩⲥⲧⲏⲣⲟⲥ	ⲙⲛⲧ|ⲁⲩⲥⲧⲏⲣⲟⲥ
ⲙⲛⲧⲃⲁⲃⲉⲣⲱⲙⲉ	ⲙⲛⲧ|ⲃⲁⲃⲉ|ⲣⲱⲙⲉ
ⲙⲛⲧⲃⲗⲗⲉ	ⲙⲛⲧ|ⲃⲗⲗⲉ
ⲙⲛⲧⲅⲉⲛⲛⲉⲟⲥ	ⲙⲛⲧ|ⲅⲉⲛⲛⲉⲟⲥ
ⲙⲛⲧⲇⲓⲁⲃⲟⲗⲟⲥ	ⲙⲛⲧ|ⲇⲓⲁⲃⲟⲗⲟⲥ
ⲙⲛⲧⲉⲕⲗⲉⲕⲧⲟⲥ	ⲙⲛⲧ|ⲉⲕⲗⲉⲕⲧⲟⲥ
ⲙⲛⲧⲉⲗⲁⲭⲓⲥⲧⲟⲥ	ⲙⲛⲧ|ⲉⲗⲁⲭⲓⲥⲧⲟⲥ
ⲙⲛⲧⲉⲗⲉⲩⲑⲉⲣⲟⲥ	ⲙⲛⲧ|ⲉⲗⲉⲩⲑⲉⲣⲟⲥ
ⲙⲛⲧⲉⲡⲓⲉⲓⲕⲏⲥ	ⲙⲛⲧ|ⲉⲡⲓⲉⲓⲕⲏⲥ
ⲙⲛⲧⲉⲡⲓⲥⲕⲟⲡⲟⲥ	ⲙⲛⲧ|ⲉⲡⲓⲥⲕⲟⲡⲟⲥ
ⲙⲛⲧⲉⲥⲭⲣⲟⲥ	ⲙⲛⲧ|ⲉⲥⲭⲣⲟⲥ
ⲙⲛⲧⲉⲩⲅⲉⲛⲏⲥ	ⲙⲛⲧ|ⲉⲩⲅⲉⲛⲏⲥ
ⲙⲛⲧⲉⲩⲥⲉⲃⲏⲥ	ⲙⲛⲧ|ⲉⲩⲥⲉⲃⲏⲥ
ⲙⲛⲧⲉⲩⲧⲁⲕⲧⲟⲥ	ⲙⲛⲧ|ⲉⲩⲧⲁⲕⲧⲟⲥ
ⲙⲛⲧⲕⲁⲑⲁⲣⲟⲥ	ⲙⲛⲧ|ⲕⲁⲑⲁⲣⲟⲥ
ⲙⲛⲧⲕⲗⲏⲣⲓⲕⲟⲥ	ⲙⲛⲧ|ⲕⲗⲏⲣⲓⲕⲟⲥ
ⲙⲛⲧⲕⲟⲓⲛⲱⲛⲟⲥ	ⲙⲛⲧ|ⲕⲟⲓⲛⲱⲛⲟⲥ
ⲙⲛⲧⲕⲟⲥⲙⲓⲕⲟⲛ	ⲙⲛⲧ|ⲕⲟⲥⲙⲓⲕⲟⲛ
ⲙⲛⲧⲕⲟⲩⲓ	ⲙⲛⲧ|ⲕⲟⲩⲓ
ⲙⲛⲧⲗⲁⲙⲡⲣⲟⲥ	ⲙⲛⲧ|ⲗⲁⲙⲡⲣⲟⲥ
ⲙⲛⲧⲗⲏⲥⲧⲏⲥ	ⲙⲛⲧ|ⲗⲏⲥⲧⲏⲥ
ⲙⲛⲧⲙⲁⲅⲟⲥ	ⲙⲛⲧ|ⲙⲁⲅⲟⲥ
ⲙⲛⲧⲙⲁⲓⲛⲟⲩⲧⲉ	ⲙⲛⲧ|ⲙⲁⲓ|ⲛⲟⲩⲧⲉ
ⲙⲛⲧⲙⲁⲓ	ⲙⲛⲧ|ⲙⲁⲓ
ⲙⲛⲧⲙⲁⲕⲁⲣⲓⲟⲥ	ⲙⲛⲧ|ⲙⲁⲕⲁⲣⲓⲟⲥ
ⲙⲛⲧⲙⲁⲣⲧⲩⲣⲟⲥ	ⲙⲛⲧ|ⲙⲁⲣⲧⲩⲣⲟⲥ
ⲙⲛⲧⲙⲉⲧⲣⲓⲟⲥ	ⲙⲛⲧ|ⲙⲉⲧⲣⲓⲟⲥ
ⲙⲛⲧⲙⲛⲧⲣⲉ	ⲙⲛⲧ|ⲙⲛⲧⲣⲉ
ⲙⲛⲧⲙⲟⲛⲁⲭⲟⲥ	ⲙⲛⲧ|ⲙⲟⲛⲁⲭⲟⲥ
ⲙⲛⲧⲛⲁϣⲧϩⲏⲧ	ⲙⲛⲧ|ⲛⲁϣⲧ|ϩⲏⲧ
ⲙⲛⲧⲛⲁ	ⲙⲛⲧ|ⲛⲁ
ⲙⲛⲧⲛⲟⲉⲓⲕ	ⲙⲛⲧ|ⲛⲟⲉⲓⲕ
ⲙⲛⲧⲛⲟⲩⲧⲉ	ⲙⲛⲧ|ⲛⲟⲩⲧⲉ
ⲙⲛⲧⲟⲩⲉⲓⲉⲛⲓⲛ	ⲙⲛⲧ|ⲟⲩⲉⲓⲉⲛⲓⲛ
ⲙⲛⲧⲟⲩⲥⲓⲁ	ⲙⲛⲧ|ⲟⲩⲥⲓⲁ
ⲙⲛⲧⲡⲁⲛⲟⲩⲣⲅⲟⲥ	ⲙⲛⲧ|ⲡⲁⲛⲟⲩⲣⲅⲟⲥ
ⲙⲛⲧⲡⲁⲛⲧⲟⲕⲣⲁⲧⲱⲣ	ⲙⲛⲧ|ⲡⲁⲛⲧⲟⲕⲣⲁⲧⲱⲣ
ⲙⲛⲧⲡⲁⲣⲁⲛⲟⲙⲟⲥ	ⲙⲛⲧ|ⲡⲁⲣⲁⲛⲟⲙⲟⲥ
ⲙⲛⲧⲡⲁⲣⲑⲉⲛⲟⲥ	ⲙⲛⲧ|ⲡⲁⲣⲑⲉⲛⲟⲥ
ⲙⲛⲧⲡⲉⲣⲓⲟⲩⲣⲅⲟⲥ	ⲙⲛⲧ|ⲡⲉⲣⲓⲟⲩⲣⲅⲟⲥ
ⲙⲛⲧⲡⲣⲉⲥⲃⲩⲧⲉⲣⲟⲥ	ⲙⲛⲧ|ⲡⲣⲉⲥⲃⲩⲧⲉⲣⲟⲥ
ⲙⲛⲧⲡⲣⲟⲇⲟⲧⲏⲥ	ⲙⲛⲧ|ⲡⲣⲟⲇⲟⲧⲏⲥ
ⲙⲛⲧⲡⲣⲟⲡⲉⲧⲏⲥ	ⲙⲛⲧ|ⲡⲣⲟⲡⲉⲧⲏⲥ
ⲙⲛⲧⲡⲣⲟⲫⲏⲧⲏⲥ	ⲙⲛⲧ|ⲡⲣⲟⲫⲏⲧⲏⲥ
ⲙⲛⲧⲣⲉϥϣⲙϣⲉⲛⲟⲩⲧⲉ	ⲙⲛⲧ|ⲣⲉϥ|ϣⲙϣⲉ|ⲛⲟⲩⲧⲉ
ⲙⲛⲧⲣⲉϥϣⲙϣⲉ	ⲙⲛⲧ|ⲣⲉϥ|ϣⲙϣⲉ
ⲙⲛⲧⲣⲉϥϩⲉⲧⲃⲯⲩⲭⲏ	ⲙⲛⲧ|ⲣⲉϥ|ϩⲉⲧⲃ|ⲯⲩⲭⲏ
ⲙⲛⲧⲣⲉϥϩⲓⲗⲁ	ⲙⲛⲧ|ⲣⲉϥ|ϩⲓⲗⲁ
ⲙⲛⲧⲣⲉϥϫⲓⲟⲩⲁ	ⲙⲛⲧ|ⲣⲉϥ|ϫⲓⲟⲩⲁ
ⲙⲛⲧⲣⲉϥϫⲓ	ⲙⲛⲧ|ⲣⲉϥ|ϫⲓ
ⲙⲛⲧⲣⲉϥϫⲱϩⲙ	ⲙⲛⲧ|ⲣⲉϥ|ϫⲱϩⲙ
ⲙⲛⲧⲣⲉϥϯϭⲱⲛⲧ	ⲙⲛⲧ|ⲣⲉϥ|ϯ|ϭⲱⲛⲧ
ⲙⲛⲧⲣⲉϥⲧⲱϩ	ⲙⲛⲧ|ⲣⲉϥ|ⲧⲱϩ
ⲙⲛⲧⲣⲉⲩⲉ	ⲙⲛⲧⲣⲉⲩⲉ
ⲙⲛⲧⲣⲉ	ⲙⲛⲧⲣⲉ
ⲙⲛⲧⲣⲙϩⲉ	ⲙⲛⲧ|ⲣⲙϩⲉ
ⲙⲛⲧⲣⲙⲙⲁⲟ	ⲙⲛⲧ|ⲣⲙⲙⲁⲟ
ⲙⲛⲧⲣⲙⲛϩⲏⲧ	ⲙⲛⲧ|ⲣⲙ|ⲛ|ϩⲏⲧ
ⲙⲛⲧⲣⲙⲣⲁϣ	ⲙⲛⲧ|ⲣⲙ|ⲣⲁϣ
ⲙⲛⲧⲣⲣⲟ	ⲙⲛⲧ|ⲣⲣⲟ
ⲙⲛⲧⲥⲁⲃⲉ	ⲙⲛⲧ|ⲥⲁⲃⲉ
ⲙⲛⲧⲥⲉⲙⲛⲟⲥ	ⲙⲛⲧ|ⲥⲉⲙⲛⲟⲥ
ⲙⲛⲧⲥⲕⲗⲏⲣⲟⲥ	ⲙⲛⲧ|ⲥⲕⲗⲏⲣⲟⲥ
ⲙⲛⲧⲥⲛⲟⲟⲩⲥ	ⲙⲛⲧ|ⲥⲛⲟⲟⲩⲥ
ⲙⲛⲧⲥⲟϭ	ⲙⲛⲧ|ⲥⲟϭ
ⲙⲛⲧⲥⲧⲙⲏⲧ	ⲙⲛⲧ|ⲥⲧⲙⲏⲧ
ⲙⲛⲧⲥⲩⲅⲅⲉⲛⲏⲥ	ⲙⲛⲧ|ⲥⲩⲅⲅⲉⲛⲏⲥ
ⲙⲛⲧⲧⲁⲗⲁⲓⲡⲱⲣⲟⲥ	ⲙⲛⲧ|ⲧⲁⲗⲁⲓⲡⲱⲣⲟⲥ
ⲙⲛⲧⲧⲉⲗⲉⲓⲟⲥ	ⲙⲛⲧ|ⲧⲉⲗⲉⲓⲟⲥ
ⲙⲛⲧⲧⲉⲗⲓⲟⲥ	ⲙⲛⲧ|ⲧⲉⲗⲓⲟⲥ
ⲙⲛⲧⲧⲟⲗⲙⲏⲣⲟⲥ	ⲙⲛⲧ|ⲧⲟⲗⲙⲏⲣⲟⲥ
ⲙⲛⲧⲧⲩⲣⲁⲛⲛⲟⲥ	ⲙⲛⲧ|ⲧⲩⲣⲁⲛⲛⲟⲥ
ⲙⲛⲧⲫⲓⲗⲁⲧⲉⲗⲫⲟⲥ	ⲙⲛⲧ|ⲫⲓⲗⲁⲧⲉⲗⲫⲟⲥ
ⲙⲛⲧⲫⲗⲩⲁⲣⲟⲥ	ⲙⲛⲧ|ⲫⲗⲩⲁⲣⲟⲥ
ⲙⲛⲧⲭⲏⲣⲁ	ⲙⲛⲧ|ⲭⲏⲣⲁ
ⲙⲛⲧⲭⲣⲏⲥⲧⲟⲥ	ⲙⲛⲧ|ⲭⲣⲏⲥⲧⲟⲥ
ⲙⲛⲧⲭⲣⲓⲥⲧⲓⲁⲛⲟⲥ	ⲙⲛⲧ|ⲭⲣⲓⲥⲧⲓⲁⲛⲟⲥ
ⲙⲟⲅⲓⲥ	ⲙⲟⲅⲓⲥ
ⲙⲟⲇⲓⲟⲛ	ⲙⲟⲇⲓⲟⲛ
ⲙⲟⲓⲣⲁ	ⲙⲟⲓⲣⲁ
ⲙⲟⲓⲭⲉⲓⲁ	ⲙⲟⲓⲭⲉⲓⲁ
ⲙⲟⲛⲁⲍⲉⲓ	ⲙⲟⲛⲁⲍⲉⲓ
ⲙⲟⲛⲁⲣⲭⲏⲥ	ⲙⲟⲛⲁⲣⲭⲏⲥ
ⲙⲟⲛⲁⲣⲭⲓⲁ	ⲙⲟⲛⲁⲣⲭⲓⲁ
ⲙⲟⲛⲁⲥⲧⲏⲣⲓⲟⲛ	ⲙⲟⲛⲁⲥⲧⲏⲣⲓⲟⲛ
ⲙⲟⲛⲁⲥ	ⲙⲟⲛⲁⲥ
ⲙⲟⲛⲁⲭⲟⲥ	ⲙⲟⲛⲁⲭⲟⲥ
ⲙⲟⲛⲏ	ⲙⲟⲛⲏ
ⲙⲟⲛⲑⲩⲗⲟⲥ	ⲙⲟⲛⲑⲩⲗⲟⲥ
ⲙⲟⲛⲟⲅⲉⲛⲏⲥ	ⲙⲟⲛⲟⲅⲉⲛⲏⲥ
ⲙⲟⲛⲟⲛ	ⲙⲟⲛⲟⲛ
ⲙⲟⲣⲫⲏ	ⲙⲟⲣⲫⲏ
ⲙⲟⲩⲗⲗⲁ	ⲙⲟⲩⲗⲗⲁ
ⲙⲟⲩⲣ	ⲙⲟⲩⲣ
ⲙⲟⲩⲥⲓⲕⲉ	ⲙⲟⲩⲥⲓⲕⲉ
ⲙⲟⲩⲥⲓⲕⲟⲛ	ⲙⲟⲩⲥⲓⲕⲟⲛ
ⲙⲟⲩⲥⲭⲁⲧⲱⲛ	ⲙⲟⲩⲥⲭⲁⲧⲱⲛ
ⲙⲟⲭⲗⲟⲥ	ⲙⲟⲭⲗⲟⲥ
ⲙⲡⲟⲇⲓⲍⲉ	ⲙⲡⲟⲇⲓⲍⲉ
ⲙⲩⲣⲓⲁⲣⲭⲟⲥ	ⲙⲩⲣⲓⲁⲣⲭⲟⲥ
ⲙⲩⲥⲧⲏⲣⲓⲟⲛ	ⲙⲩⲥⲧⲏⲣⲓⲟⲛ
ⲙⲱⲁⲃⲓⲧⲏⲥ	ⲙⲱⲁⲃⲓⲧⲏⲥ
ⲙⲱⲛⲁⲭⲏ	ⲙⲱⲛⲁⲭⲏ
ⲛⲁϯⲡⲟⲗⲓⲥ	ⲛⲁ|ϯ|ⲡⲟⲗⲓⲥ
ⲛⲁⲓ	ⲛⲁⲓ
ⲛⲁⲟⲥ	ⲛⲁⲟⲥ
ⲛⲁⲣⲇⲓⲝ	ⲛⲁⲣⲇⲓⲝ
ⲛⲁⲣⲇⲟⲥ	ⲛⲁⲣⲇⲟⲥ
ⲛⲁⲣⲧⲟⲥ	ⲛⲁⲣⲧⲟⲥ
ⲛⲁⲩⲕⲗⲏⲣⲟⲥ	ⲛⲁⲩⲕⲗⲏⲣⲟⲥ
ⲛⲃⲓⲁ	ⲛ|ⲃⲓⲁ
ⲛⲉϩⲥⲉ	ⲛⲉϩⲥⲉ
ⲛⲉϫⲧⲁϥ	ⲛⲉϫ|ⲧⲁϥ
ⲛⲉⲁⲛⲓⲥⲕⲟⲥ	ⲛⲉⲁⲛⲓⲥⲕⲟⲥ
ⲛⲉⲛⲉⲭⲉⲣⲟⲛ	ⲛ|ⲉⲛⲉⲭⲉⲣⲟⲛ
ⲛⲉⲩⲣⲟⲛ	ⲛⲉⲩⲣⲟⲛ
ⲛⲏⲥⲟⲥ	ⲛⲏⲥⲟⲥ
ⲛⲏⲥⲧⲉⲓⲁ	ⲛⲏⲥⲧⲉⲓⲁ
ⲛⲏⲥⲧⲉⲩⲉ	ⲛⲏⲥⲧⲉⲩⲉ
ⲛⲏⲫⲉ	ⲛⲏⲫⲉ
ⲛⲓⲕⲟⲫⲟⲣⲟⲥ	ⲛⲓⲕⲟⲫⲟⲣⲟⲥ
ⲛⲙⲁⲣⲧⲩⲣⲟⲥ	ⲛ|ⲙⲁⲣⲧⲩⲣⲟⲥ
ⲛⲟⲉⲓⲛ	ⲛⲟⲉⲓⲛ
ⲛⲟⲉⲓ	ⲛⲟⲉⲓ
ⲛⲟⲉⲣⲁ	ⲛⲟⲉⲣⲁ
ⲛⲟⲉⲣⲟⲛ	ⲛⲟⲉⲣⲟⲛ
ⲛⲟⲉⲣⲟⲥ	ⲛⲟⲉⲣⲟⲥ
ⲛⲟⲏⲙⲁ	ⲛⲟⲏⲙⲁ
ⲛⲟⲏⲥⲓⲥ	ⲛⲟⲏⲥⲓⲥ
ⲛⲟⲏⲧⲟⲛ	ⲛⲟⲏⲧⲟⲛ
ⲛⲟⲏⲧⲟⲥ	ⲛⲟⲏⲧⲟⲥ
ⲛⲟⲙⲏ	ⲛⲟⲙⲏ
ⲛⲟⲙⲓⲕⲟⲛ	ⲛⲟⲙⲓⲕⲟⲛ
ⲛⲟⲙⲓⲕⲟⲥ	ⲛⲟⲙⲓⲕⲟⲥ
ⲛⲟⲙⲓⲙⲟⲛ	ⲛⲟⲙⲓⲙⲟⲛ
ⲛⲟⲙⲓⲥⲙⲁ	ⲛⲟⲙⲓⲥⲙⲁ
ⲛⲟⲙⲟⲇⲓⲇⲁⲥⲕⲁⲗⲟⲥ	ⲛⲟⲙⲟⲇⲓⲇⲁⲥⲕⲁⲗⲟⲥ
ⲛⲟⲙⲟⲑⲉⲧⲏⲥ	ⲛⲟⲙⲟⲑⲉⲧⲏⲥ
ⲛⲟⲙⲟⲑⲉⲧⲓ	ⲛⲟⲙⲟⲑⲉⲧⲓ
ⲛⲟⲙⲟⲥ	ⲛⲟⲙⲟⲥ
ⲛⲟⲩϩⲉ	ⲛⲟⲩϩⲉ
ⲛⲟⲩϩⲙ	ⲛⲟⲩϩⲙ
ⲛⲟⲩⲑⲉⲧⲉⲓ	ⲛⲟⲩⲑⲉⲧⲉⲓ
ⲛⲟⲩⲙⲉⲣⲟⲛ	ⲛⲟⲩⲙⲉⲣⲟⲛ
ⲛⲟⲩⲙⲟⲥ	ⲛⲟⲩⲙⲟⲥ
ⲛⲟⲩⲛ	ⲛⲟⲩⲛ
ⲛⲟⲩⲥ	ⲛⲟⲩⲥ
ⲛⲩⲕⲏⲥⲓⲥ	ⲛⲩⲕⲏⲥⲓⲥ
ⲛⲩⲙⲫⲏ	ⲛⲩⲙⲫⲏ
ⲛⲩⲙⲫⲓⲟⲥ	ⲛⲩⲙⲫⲓⲟⲥ
ⲛⲩⲙⲫⲱⲛ	ⲛⲩⲙⲫⲱⲛ
ⲛⲩⲙⲯⲓⲥ	ⲛⲩⲙⲯⲓⲥ
ⲛⲩⲥⲁⲉⲩⲥ	ⲛⲩⲥⲁⲉⲩⲥ
ⲝⲉⲛⲉⲓⲟⲥ	ⲝⲉⲛⲉⲓⲟⲥ
ⲝⲉⲛⲓⲟⲛ	ⲝⲉⲛⲓⲟⲛ
ⲝⲉⲥⲧⲏⲥ	ⲝⲉⲥⲧⲏⲥ
ⲟⲃⲣⲩⲍⲟⲛ	ⲟⲃⲣⲩⲍⲟⲛ
ⲟⲅⲇⲟⲁⲥ	ⲟⲅⲇⲟⲁⲥ
ⲟⲓⲕⲟⲇⲉⲥⲡⲟⲧⲏⲥ	ⲟⲓⲕⲟⲇⲉⲥⲡⲟⲧⲏⲥ
ⲟⲓⲕⲟⲑⲉⲛ	ⲟⲓⲕⲟⲑⲉⲛ
ⲟⲓⲕⲟⲛⲟⲙⲉⲓ	ⲟⲓⲕⲟⲛⲟⲙⲉⲓ
ⲟⲓⲕⲟⲛⲟⲙⲓⲁ	ⲟⲓⲕⲟⲛⲟⲙⲓⲁ
ⲟⲓⲕⲟⲛⲟⲙⲟⲥ	ⲟⲓⲕⲟⲛⲟⲙⲟⲥ
ⲟⲓⲕⲟⲥ	ⲟⲓⲕⲟⲥ
ⲟⲓⲕⲟⲩⲙⲉⲛⲏ	ⲟⲓⲕⲟⲩⲙⲉⲛⲏ
ⲟⲕⲧⲟⲏⲥ	ⲟⲕⲧⲟⲏⲥ
ⲟⲗⲓⲅⲱⲣⲉⲓ	ⲟⲗⲓⲅⲱⲣⲉⲓ
ⲟⲗⲓⲕⲉ	ⲟⲗⲓⲕⲉ
ⲟⲗⲗⲁⲣⲓⲟⲛ	ⲟⲗⲗⲁⲣⲓⲟⲛ
ⲟⲙⲟⲓⲱⲥ	ⲟⲙⲟⲓⲱⲥ
ⲟⲛⲅⲓⲁ	ⲟⲛⲅⲓⲁ
ⲟⲛⲟⲙⲁⲍⲉ	ⲟⲛⲟⲙⲁⲍⲉ
ⲟⲛⲟⲙⲁⲥⲓⲁ	ⲟⲛⲟⲙⲁⲥⲓⲁ
ⲟⲛⲟⲙⲁⲥⲧⲟⲥ	ⲟⲛⲟⲙⲁⲥⲧⲟⲥ
ⲟⲛⲧⲱⲥ	ⲟⲛⲧⲱⲥ
ⲟⲡⲓⲥⲱ	ⲟⲡⲓⲥⲱ
ⲟⲡⲧⲁⲥⲓⲁ	ⲟⲡⲧⲁⲥⲓⲁ
ⲟⲡⲱⲣⲁ	ⲟⲡⲱⲣⲁ
ⲟⲣⲁⲝ	ⲟⲣⲁⲝ
ⲟⲣⲅⲁⲛⲟⲛ	ⲟⲣⲅⲁⲛⲟⲛ
ⲟⲣⲅⲏ	ⲟⲣⲅⲏ
ⲟⲣⲇⲓⲛⲟⲛ	ⲟⲣⲇⲓⲛⲟⲛ
ⲟⲣⲑⲏⲥⲓⲥ	ⲟⲣⲑⲏⲥⲓⲥ
ⲟⲣⲑⲟⲇⲟⲝⲟⲥ	ⲟⲣⲑⲟⲇⲟⲝⲟⲥ
ⲟⲣⲑⲟⲛ	ⲟⲣⲑⲟⲛ
ⲟⲣⲑⲱⲧⲱⲕⲝⲏⲓⲁ	ⲟⲣⲑⲱⲧⲱⲕⲝⲏⲓⲁ
ⲟⲣⲫⲁⲛⲟⲥ	ⲟⲣⲫⲁⲛⲟⲥ
ⲟⲣⲭⲉⲓ	ⲟⲣⲭⲉⲓ
ⲟⲧⲓ	ⲟⲧⲓ
ⲟⲩⲁ	ⲟⲩⲁ
ⲟⲩⲇⲉ	ⲟⲩⲇⲉ
ⲟⲩⲉϩⲥⲁϩⲛⲉ	ⲟⲩⲉϩ|ⲥⲁϩⲛⲉ
ⲟⲩⲉⲓⲉⲛⲓⲛ	ⲟⲩⲉⲓⲉⲛⲓⲛ
ⲟⲩⲉⲓ	ⲟⲩⲉⲓ
ⲟⲩⲏⲗⲟⲛ	ⲟⲩⲏⲗⲟⲛ
ⲟⲩⲕⲉⲧⲓ	ⲟⲩⲕⲉⲧⲓ
ⲟⲩⲕⲟⲩⲛ	ⲟⲩⲕⲟⲩⲛ
ⲟⲩⲗⲏ	ⲟⲩⲗⲏ
ⲟⲩⲛ	ⲟⲩⲛ
ⲟⲩⲥⲓⲁⲣⲭⲏⲥ	ⲟⲩⲥⲓⲁⲣⲭⲏⲥ
ⲟⲩⲥⲓⲁ	ⲟⲩⲥⲓⲁ
ⲟⲩⲭⲓ	ⲟⲩⲭⲓ
ⲟⲩⲭ	ⲟⲩⲭ
ⲟⲩ	ⲟⲩ
ⲟⲫⲉⲗⲉⲓ	ⲟⲫⲉⲗⲉⲓ
ⲟⲭⲉⲙⲁ	ⲟⲭⲉⲙⲁ
ⲟⲭⲗⲏⲥⲓⲥ	ⲟⲭⲗⲏⲥⲓⲥ
ⲟⲭⲗⲟⲥ	ⲟⲭⲗⲟⲥ
ⲡⲁⲅⲁⲛⲟⲥ	ⲡⲁⲅⲁⲛⲟⲥ
ⲡⲁⲑⲓ	ⲡⲁⲑⲓ
ⲡⲁⲑⲟⲥ	ⲡⲁⲑⲟⲥ
ⲡⲁⲓⲇⲉⲩⲉ	ⲡⲁⲓⲇⲉⲩⲉ
ⲡⲁⲓⲇⲓⲁ	ⲡⲁⲓⲇⲓⲁ
ⲡⲁⲕⲁⲛⲟⲥ	ⲡⲁⲕⲁⲛⲟⲥ
ⲡⲁⲕⲧⲟⲛ	ⲡⲁⲕⲧⲟⲛ
ⲡⲁⲗⲁⲧⲓⲛⲟⲥ	ⲡⲁⲗⲁⲧⲓⲛⲟⲥ
ⲡⲁⲗⲓⲛ	ⲡⲁⲗⲓⲛ
ⲡⲁⲗⲗⲁⲕⲏ	ⲡⲁⲗⲗⲁⲕⲏ
ⲡⲁⲗⲗⲁⲧⲓⲟⲛ	ⲡⲁⲗⲗⲁⲧⲓⲟⲛ
ⲡⲁⲙⲙⲏⲧⲱⲣ	ⲡⲁⲙⲙⲏⲧⲱⲣ
ⲡⲁⲛϩⲁⲅⲛⲟⲛ	ⲡⲁⲛϩⲁⲅⲛⲟⲛ
ⲡⲁⲛϩⲟⲗⲱⲛ	ⲡⲁⲛϩⲟⲗⲱⲛ
ⲡⲁⲛϩⲟⲡⲗⲓⲁ	ⲡⲁⲛϩⲟⲡⲗⲓⲁ
ⲡⲁⲛⲁⲅⲓ̈ⲟⲥ	ⲡⲁⲛⲁⲅⲓ̈ⲟⲥ
ⲡⲁⲛⲁⲣⲉ	ⲡⲁⲛⲁⲣⲉ
ⲡⲁⲛⲅⲉⲛⲓⲁ	ⲡⲁⲛⲅⲉⲛⲓⲁ
ⲡⲁⲛⲅⲛⲱⲥⲓⲥ	ⲡⲁⲛⲅⲛⲱⲥⲓⲥ
ⲡⲁⲛⲇⲏⲗⲟⲥ	ⲡⲁⲛⲇⲏⲗⲟⲥ
ⲡⲁⲛⲇⲓⲁ	ⲡⲁⲛⲇⲓⲁ
ⲡⲁⲛⲇⲟⲩⲣⲁ	ⲡⲁⲛⲇⲟⲩⲣⲁ
ⲡⲁⲛⲇⲩⲛⲁⲙⲓⲥ	ⲡⲁⲛⲇⲩⲛⲁⲙⲓⲥ
ⲡⲁⲛⲉⲩⲫⲏⲙⲟⲥ	ⲡⲁⲛⲉⲩⲫⲏⲙⲟⲥ
ⲡⲁⲛⲏⲣⲉⲙⲟⲥ	ⲡⲁⲛⲏⲣⲉⲙⲟⲥ
ⲡⲁⲛⲑⲏⲣ	ⲡⲁⲛⲑⲏⲣ
ⲡⲁⲛⲙⲩⲥⲧⲏⲣⲓⲟⲛ	ⲡⲁⲛⲙⲩⲥⲧⲏⲣⲓⲟⲛ
ⲡⲁⲛⲟⲥⲓⲟⲥ	ⲡⲁⲛⲟⲥⲓⲟⲥ
ⲡⲁⲛⲟⲩⲣⲅⲓⲁ	ⲡⲁⲛⲟⲩⲣⲅⲓⲁ
ⲡⲁⲛⲟⲩⲣⲅⲟⲥ	ⲡⲁⲛⲟⲩⲣⲅⲟⲥ
ⲡⲁⲛⲟⲩⲥⲓⲟⲥ	ⲡⲁⲛⲟⲩⲥⲓⲟⲥ
ⲡⲁⲛⲡⲏⲅⲏ	ⲡⲁⲛⲡⲏⲅⲏ
ⲡⲁⲛⲥⲟⲫⲟⲥ	ⲡⲁⲛⲥⲟⲫⲟⲥ
ⲡⲁⲛⲧⲉⲗⲏⲥ	ⲡⲁⲛⲧⲉⲗⲏⲥ
ⲡⲁⲛⲧⲉⲗⲓⲟⲥ	ⲡⲁⲛⲧⲉⲗⲓⲟⲥ
ⲡⲁⲛⲧⲟⲇⲩⲛⲁⲙⲓⲥ	ⲡⲁⲛⲧⲟⲇⲩⲛⲁⲙⲓⲥ
ⲡⲁⲛⲧⲟⲇⲩⲛⲁⲙⲟⲥ	ⲡⲁⲛⲧⲟⲇⲩⲛⲁⲙⲟⲥ
ⲡⲁⲛⲧⲟⲕⲣⲁⲧⲱⲣ	ⲡⲁⲛⲧⲟⲕⲣⲁⲧⲱⲣ
ⲡⲁⲛⲧⲟⲙⲟⲣⲫⲟⲥ	ⲡⲁⲛⲧⲟⲙⲟⲣⲫⲟⲥ
ⲡⲁⲛⲧⲟⲡⲁⲧⲱⲣ	ⲡⲁⲛⲧⲟⲡⲁⲧⲱⲣ
ⲡⲁⲛⲧⲟⲭⲓⲟⲛ	ⲡⲁⲛⲧⲟⲭⲓⲟⲛ
ⲡⲁⲛⲧⲱⲥ	ⲡⲁⲛⲧⲱⲥ
ⲡⲁⲣϩⲏⲥⲓⲁⲍⲉ	ⲡⲁⲣϩⲏⲥⲓⲁⲍⲉ
ⲡⲁⲣϩⲓⲥⲧⲁ	ⲡⲁⲣϩⲓⲥⲧⲁ
ⲡⲁⲣϩⲟⲓⲙⲓⲁ	ⲡⲁⲣϩⲟⲓⲙⲓⲁ
ⲡⲁⲣϩⲩⲙⲓⲁⲥⲧⲏⲥ	ⲡⲁⲣϩⲩⲙⲓⲁⲥⲧⲏⲥ
ⲡⲁⲣⲁⲃⲁⲥⲓⲥ	ⲡⲁⲣⲁⲃⲁⲥⲓⲥ
ⲡⲁⲣⲁⲃⲁⲧⲏⲥ	ⲡⲁⲣⲁⲃⲁⲧⲏⲥ
ⲡⲁⲣⲁⲃⲁ	ⲡⲁⲣⲁⲃⲁ
ⲡⲁⲣⲁⲃⲉⲛⲓⲛ	ⲡⲁⲣⲁⲃⲉⲛⲓⲛ
ⲡⲁⲣⲁⲃⲟⲗⲏ	ⲡⲁⲣⲁⲃⲟⲗⲏ
ⲡⲁⲣⲁⲅⲅⲉⲓⲗⲉ	ⲡⲁⲣⲁⲅⲅⲉⲓⲗⲉ
ⲡⲁⲣⲁⲅⲅⲉⲗⲓⲁ	ⲡⲁⲣⲁⲅⲅⲉⲗⲓⲁ
ⲡⲁⲣⲁⲅⲉ	ⲡⲁⲣⲁⲅⲉ
ⲡⲁⲣⲁⲇⲉⲓⲥⲟⲥ	ⲡⲁⲣⲁⲇⲉⲓⲥⲟⲥ
ⲡⲁⲣⲁⲇⲉⲭⲉ	ⲡⲁⲣⲁⲇⲉⲭⲉ
ⲡⲁⲣⲁⲇⲓⲅⲙⲁ	ⲡⲁⲣⲁⲇⲓⲅⲙⲁ
ⲡⲁⲣⲁⲇⲓⲇⲟⲩ	ⲡⲁⲣⲁⲇⲓⲇⲟⲩ
ⲡⲁⲣⲁⲇⲓⲥⲟⲥ	ⲡⲁⲣⲁⲇⲓⲥⲟⲥ
ⲡⲁⲣⲁⲇⲟⲝⲟⲛ	ⲡⲁⲣⲁⲇⲟⲝⲟⲛ
ⲡⲁⲣⲁⲇⲟⲥⲓⲥ	ⲡⲁⲣⲁⲇⲟⲥⲓⲥ
ⲡⲁⲣⲁⲑⲏⲕⲏ	ⲡⲁⲣⲁⲑⲏⲕⲏ
ⲡⲁⲣⲁⲓⲧⲉⲓ	ⲡⲁⲣⲁⲓⲧⲉⲓ
ⲡⲁⲣⲁⲕⲁⲗⲉⲓ	ⲡⲁⲣⲁⲕⲁⲗⲉⲓ
ⲡⲁⲣⲁⲕⲗⲏⲥⲓⲥ	ⲡⲁⲣⲁⲕⲗⲏⲥⲓⲥ
ⲡⲁⲣⲁⲕⲗⲏⲧⲓⲕⲟⲛ	ⲡⲁⲣⲁⲕⲗⲏⲧⲓⲕⲟⲛ
ⲡⲁⲣⲁⲕⲗⲏⲧⲟⲛ	ⲡⲁⲣⲁⲕⲗⲏⲧⲟⲛ
ⲡⲁⲣⲁⲕⲗⲏⲧⲟⲥ	ⲡⲁⲣⲁⲕⲗⲏⲧⲟⲥ
ⲡⲁⲣⲁⲗⲏⲙⲡⲧⲱⲣ	ⲡⲁⲣⲁⲗⲏⲙⲡⲧⲱⲣ
ⲡⲁⲣⲁⲗⲓⲁ	ⲡⲁⲣⲁⲗⲓⲁ
ⲡⲁⲣⲁⲗⲟⲅⲟⲛ	ⲡⲁⲣⲁⲗⲟⲅⲟⲛ
ⲡⲁⲣⲁⲙⲉⲓⲛⲉ	ⲡⲁⲣⲁⲙⲉⲓⲛⲉ
ⲡⲁⲣⲁⲙⲟⲛⲏ	ⲡⲁⲣⲁⲙⲟⲛⲏ
ⲡⲁⲣⲁⲙⲩⲑⲓⲁ	ⲡⲁⲣⲁⲙⲩⲑⲓⲁ
ⲡⲁⲣⲁⲛⲟⲙⲉⲓ	ⲡⲁⲣⲁⲛⲟⲙⲉⲓ
ⲡⲁⲣⲁⲛⲟⲙⲓⲁ	ⲡⲁⲣⲁⲛⲟⲙⲓⲁ
ⲡⲁⲣⲁⲛⲟⲙⲟⲛ	ⲡⲁⲣⲁⲛⲟⲙⲟⲛ
ⲡⲁⲣⲁⲛⲟⲙⲟⲥ	ⲡⲁⲣⲁⲛⲟⲙⲟⲥ
ⲡⲁⲣⲁⲡⲉⲧⲁⲥⲙⲁ	ⲡⲁⲣⲁⲡⲉⲧⲁⲥⲙⲁ
ⲡⲁⲣⲁⲡⲧⲱⲙⲁ	ⲡⲁⲣⲁⲡⲧⲱⲙⲁ
ⲡⲁⲣⲁⲥⲕⲉⲩⲉⲍⲉ	ⲡⲁⲣⲁⲥⲕⲉⲩⲉⲍⲉ
ⲡⲁⲣⲁⲥⲕⲉⲩⲏ	ⲡⲁⲣⲁⲥⲕⲉⲩⲏ
ⲡⲁⲣⲁⲥⲧⲁⲧⲏⲥ	ⲡⲁⲣⲁⲥⲧⲁⲧⲏⲥ
ⲡⲁⲣⲁⲧⲏⲣⲓ	ⲡⲁⲣⲁⲧⲏⲣⲓ
ⲡⲁⲣⲁⲧⲓⲅⲙⲁⲧⲓⲍⲉ	ⲡⲁⲣⲁⲧⲓⲅⲙⲁⲧⲓⲍⲉ
ⲡⲁⲣⲁⲫⲣⲁⲥⲓⲥ	ⲡⲁⲣⲁⲫⲣⲁⲥⲓⲥ
ⲡⲁⲣⲁⲫⲩⲥⲓⲥ	ⲡⲁⲣⲁⲫⲩⲥⲓⲥ
ⲡⲁⲣⲁⲭⲓⲙⲁⲍⲉ	ⲡⲁⲣⲁⲭⲓⲙⲁⲍⲉ
ⲡⲁⲣⲁⲭⲱⲣⲉⲓ	ⲡⲁⲣⲁⲭⲱⲣⲉⲓ
ⲡⲁⲣⲁ	ⲡⲁⲣⲁ
ⲡⲁⲣⲁ<ⲫⲣⲱⲛ>	ⲡⲁⲣⲁ<ⲫⲣⲱⲛ>
ⲡⲁⲣⲇⲁⲗⲓⲥ	ⲡⲁⲣⲇⲁⲗⲓⲥ
ⲡⲁⲣⲉⲗⲑⲉ	ⲡⲁⲣⲉⲗⲑⲉ
ⲡⲁⲣⲉⲙⲃⲟⲗⲏ	ⲡⲁⲣⲉⲙⲃⲟⲗⲏ
ⲡⲁⲣⲑⲉⲛⲓⲁ	ⲡⲁⲣⲑⲉⲛⲓⲁ
ⲡⲁⲣⲑⲉⲛⲓⲕⲏ	ⲡⲁⲣⲑⲉⲛⲓⲕⲏ
ⲡⲁⲣⲑⲉⲛⲓⲕⲟⲛ	ⲡⲁⲣⲑⲉⲛⲓⲕⲟⲛ
ⲡⲁⲣⲑⲉⲛⲟⲥ	ⲡⲁⲣⲑⲉⲛⲟⲥ
ⲡⲁⲣⲑⲟⲥ	ⲡⲁⲣⲑⲟⲥ
ⲡⲁⲣⲓⲥⲑⲙⲓⲟⲛ	ⲡⲁⲣⲓⲥⲑⲙⲓⲟⲛ
ⲡⲁⲣⲟⲓⲕⲏⲥⲓⲥ	ⲡⲁⲣⲟⲓⲕⲏⲥⲓⲥ
ⲡⲁⲣⲟⲝⲩⲥⲙⲟⲥ	ⲡⲁⲣⲟⲝⲩⲥⲙⲟⲥ
ⲡⲁⲣⲟⲣⲁ	ⲡⲁⲣⲟⲣⲁ
ⲡⲁⲣⲟⲩⲥⲓⲁ	ⲡⲁⲣⲟⲩⲥⲓⲁ
ⲡⲁⲣⲣⲏⲥⲓⲁ	ⲡⲁⲣⲣⲏⲥⲓⲁ
ⲡⲁⲣⲱⲝⲩⲛⲉ	ⲡⲁⲣⲱⲝⲩⲛⲉ
ⲡⲁⲥⲧⲟⲥ	ⲡⲁⲥⲧⲟⲥ
ⲡⲁⲥⲭⲁ	ⲡⲁⲥⲭⲁ
ⲡⲁⲧⲁⲥⲥⲉ	ⲡⲁⲧⲁⲥⲥⲉ
ⲡⲁⲧⲉⲓ	ⲡⲁⲧⲉⲓ
ⲡⲁⲧⲣⲓⲁⲣⲭⲏⲥ	ⲡⲁⲧⲣⲓⲁⲣⲭⲏⲥ
ⲡⲁⲧⲣⲓⲁ	ⲡⲁⲧⲣⲓⲁ
ⲡⲁⲧⲣⲓⲥ	ⲡⲁⲧⲣⲓⲥ
ⲡⲉⲇⲏ	ⲡⲉⲇⲏ
ⲡⲉⲓⲑⲉ	ⲡⲉⲓⲑⲉ
ⲡⲉⲓⲣⲁⲍⲉ	ⲡⲉⲓⲣⲁⲍⲉ
ⲡⲉⲓⲣⲁⲥⲙⲟⲥ	ⲡⲉⲓⲣⲁⲥⲙⲟⲥ
ⲡⲉⲓⲣⲁⲧⲏⲣⲓⲟⲛ	ⲡⲉⲓⲣⲁⲧⲏⲣⲓⲟⲛ
ⲡⲉⲗⲁⲅⲟⲥ	ⲡⲉⲗⲁⲅⲟⲥ
ⲡⲉⲗⲙⲁ	ⲡⲉⲗⲙⲁ
ⲡⲉⲙⲡⲧⲉ	ⲡⲉⲙⲡⲧⲉ
ⲡⲉⲛⲁⲅⲓⲥ	ⲡⲉⲛⲁⲅⲓⲥ
ⲡⲉⲛⲑⲉⲓ	ⲡⲉⲛⲑⲉⲓ
ⲡⲉⲛⲑⲟⲥ	ⲡⲉⲛⲑⲟⲥ
ⲡⲉⲛⲧⲁⲥ	ⲡⲉⲛⲧⲁⲥ
ⲡⲉⲛⲧⲉⲕⲟⲛⲧⲁⲣⲭⲟⲥ	ⲡⲉⲛⲧⲉⲕⲟⲛⲧⲁⲣⲭⲟⲥ
ⲡⲉⲛⲧⲏⲕⲟⲥⲧⲏ	ⲡⲉⲛⲧⲏⲕⲟⲥⲧⲏ
ⲡⲉⲣⲓⲁⲅⲉ	ⲡⲉⲣⲓⲁⲅⲉ
ⲡⲉⲣⲓⲅⲣⲁⲫⲏ	ⲡⲉⲣⲓⲅⲣⲁⲫⲏ
ⲡⲉⲣⲓⲇⲱⲛ	ⲡⲉⲣⲓⲇⲱⲛ
ⲡⲉⲣⲓⲍⲱⲙⲁ	ⲡⲉⲣⲓⲍⲱⲙⲁ
ⲡⲉⲣⲓⲕⲁⲑⲁⲣⲙⲁ	ⲡⲉⲣⲓⲕⲁⲑⲁⲣⲙⲁ
ⲡⲉⲣⲓⲕⲉⲫⲁⲗⲁⲓⲁ	ⲡⲉⲣⲓⲕⲉⲫⲁⲗⲁⲓⲁ
ⲡⲉⲣⲓⲟⲇⲟⲥ	ⲡⲉⲣⲓⲟⲇⲟⲥ
ⲡⲉⲣⲓⲥⲟⲛ	ⲡⲉⲣⲓⲥⲟⲛ
ⲡⲉⲣⲓⲥⲡⲁⲥⲙⲟⲥ	ⲡⲉⲣⲓⲥⲡⲁⲥⲙⲟⲥ
ⲡⲉⲣⲓⲥⲥⲟⲛ	ⲡⲉⲣⲓⲥⲥⲟⲛ
ⲡⲉⲣⲓⲭⲱⲣⲟⲥ	ⲡⲉⲣⲓⲭⲱⲣⲟⲥ
ⲡⲉⲣⲡⲉⲣⲟⲥ	ⲡⲉⲣⲡⲉⲣⲟⲥ
ⲡⲉⲣⲥⲏⲥ	ⲡⲉⲣⲥⲏⲥ
ⲡⲉⲣⲥⲟⲥ	ⲡⲉⲣⲥⲟⲥ
ⲡⲉⲧⲛ	ⲡⲉⲧⲛ
ⲡⲉⲧⲣⲁ	ⲡⲉⲧⲣⲁ
ⲡⲏⲅⲏ	ⲡⲏⲅⲏ
ⲡⲏⲣⲁ	ⲡⲏⲣⲁ
ⲡⲏⲥⲥⲉ	ⲡⲏⲥⲥⲉ
ⲡⲓⲑⲉⲥⲑⲁⲓ	ⲡⲓⲑⲉⲥⲑⲁⲓ
ⲡⲓⲑⲟⲥ	ⲡⲓⲑⲟⲥ
ⲡⲓⲕⲣⲓⲁ	ⲡⲓⲕⲣⲓⲁ
ⲡⲓⲛⲁⲅⲓⲥ	ⲡⲓⲛⲁⲅⲓⲥ
ⲡⲓⲛⲁⲝ	ⲡⲓⲛⲁⲝ
ⲡⲓⲥⲧⲉⲩⲉ	ⲡⲓⲥⲧⲉⲩⲉ
ⲡⲓⲥⲧⲏ	ⲡⲓⲥⲧⲏ
ⲡⲓⲥⲧⲓⲕⲏ	ⲡⲓⲥⲧⲓⲕⲏ
ⲡⲓⲥⲧⲓⲥ	ⲡⲓⲥⲧⲓⲥ
ⲡⲓⲥⲧⲟⲛ	ⲡⲓⲥⲧⲟⲛ
ⲡⲓⲥⲧⲟⲥ	ⲡⲓⲥⲧⲟⲥ
ⲡⲗⲁⲛⲁⲥⲑⲁⲓ	ⲡⲗⲁⲛⲁⲥⲑⲁⲓ
ⲡⲗⲁⲛⲁⲥⲑⲉ	ⲡⲗⲁⲛⲁⲥⲑⲉ
ⲡⲗⲁⲛⲁ	ⲡⲗⲁⲛⲁ
ⲡⲗⲁⲛⲏ	ⲡⲗⲁⲛⲏ
ⲡⲗⲁⲛⲟⲥ	ⲡⲗⲁⲛⲟⲥ
ⲡⲗⲁⲝ	ⲡⲗⲁⲝ
ⲡⲗⲁⲥⲓⲥ	ⲡⲗⲁⲥⲓⲥ
ⲡⲗⲁⲥⲙⲁ	ⲡⲗⲁⲥⲙⲁ
ⲡⲗⲁⲥⲥⲉ	ⲡⲗⲁⲥⲥⲉ
ⲡⲗⲁⲥⲧⲏⲥ	ⲡⲗⲁⲥⲧⲏⲥ
ⲡⲗⲁⲧⲁⲛⲟⲥ	ⲡⲗⲁⲧⲁⲛⲟⲥ
ⲡⲗⲁⲧⲉⲓⲁ	ⲡⲗⲁⲧⲉⲓⲁ
ⲡⲗⲁⲧⲏⲣⲉ	ⲡⲗⲁⲧⲏⲣⲉ
ⲡⲗⲉⲁ	ⲡⲗⲉⲁ
ⲡⲗⲉⲣⲟⲫⲟⲣⲓⲁ	ⲡⲗⲉⲣⲟⲫⲟⲣⲓⲁ
ⲡⲗⲉⲥⲥⲉ	ⲡⲗⲉⲥⲥⲉ
ⲡⲗⲏⲅⲏ	ⲡⲗⲏⲅⲏ
ⲡⲗⲏⲕⲧⲣⲟⲛ	ⲡⲗⲏⲕⲧⲣⲟⲛ
ⲡⲗⲏⲛ	ⲡⲗⲏⲛ
ⲡⲗⲏⲣⲟⲩ	ⲡⲗⲏⲣⲟⲩ
ⲡⲗⲏⲣⲟⲫⲟⲣⲉⲓ	ⲡⲗⲏⲣⲟⲫⲟⲣⲉⲓ
ⲡⲗⲏⲣⲱⲙⲁ	ⲡⲗⲏⲣⲱⲙⲁ
ⲡⲗⲏⲱⲣⲙⲁ	ⲡⲗⲏⲱⲣⲙⲁ
ⲡⲗⲟⲩⲧⲱⲛⲓⲟⲥ	ⲡⲗⲟⲩⲧⲱⲛⲓⲟⲥ
ⲡⲗⲩⲅⲏ	ⲡⲗⲩⲅⲏ
ⲡⲛⲉⲩⲙⲁⲧⲓⲕⲏ	ⲡⲛⲉⲩⲙⲁⲧⲓⲕⲏ
ⲡⲛⲉⲩⲙⲁⲧⲓⲕⲟⲛ	ⲡⲛⲉⲩⲙⲁⲧⲓⲕⲟⲛ
ⲡⲛⲉⲩⲙⲁⲧⲓⲕⲟⲥ	ⲡⲛⲉⲩⲙⲁⲧⲓⲕⲟⲥ
ⲡⲛⲉⲩⲙⲁⲧⲓⲕⲱⲥ	ⲡⲛⲉⲩⲙⲁⲧⲓⲕⲱⲥ
ⲡⲛⲉⲩⲙⲁⲧⲟⲫⲟⲣⲟⲥ	ⲡⲛⲉⲩⲙⲁⲧⲟⲫⲟⲣⲟⲥ
ⲡⲛⲉⲩⲙⲁ	ⲡⲛⲉⲩⲙⲁ
ⲡⲛⲉⲩⲙⲱⲛ	ⲡⲛⲉⲩⲙⲱⲛ
ⲡⲛⲟⲏ	ⲡⲛⲟⲏ
ⲡⲟⲇⲏⲣⲏ	ⲡⲟⲇⲏⲣⲏ
ⲡⲟⲇⲟⲛⲓⲡⲧⲏⲣ	ⲡⲟⲇⲟⲛⲓⲡⲧⲏⲣ
ⲡⲟⲓⲙⲏⲛ	ⲡⲟⲓⲙⲏⲛ
ⲡⲟⲗⲉⲙⲉⲓ	ⲡⲟⲗⲉⲙⲉⲓ
ⲡⲟⲗⲉⲙⲓⲕⲟⲛ	ⲡⲟⲗⲉⲙⲓⲕⲟⲛ
ⲡⲟⲗⲉⲙⲟⲥ	ⲡⲟⲗⲉⲙⲟⲥ
ⲡⲟⲗⲓⲥ	ⲡⲟⲗⲓⲥ
ⲡⲟⲗⲓⲧⲉⲓⲁ	ⲡⲟⲗⲓⲧⲉⲓⲁ
ⲡⲟⲗⲓⲧⲉⲩⲉⲥⲑⲁⲓ	ⲡⲟⲗⲓⲧⲉⲩⲉⲥⲑⲁⲓ
ⲡⲟⲗⲓⲧⲉⲩⲉ	ⲡⲟⲗⲓⲧⲉⲩⲉ
ⲡⲟⲗⲓⲧⲉⲩⲙⲁ	ⲡⲟⲗⲓⲧⲉⲩⲙⲁ
ⲡⲟⲗⲓⲧⲉⲩⲧⲏⲥ	ⲡⲟⲗⲓⲧⲉⲩⲧⲏⲥ
ⲡⲟⲗⲓⲧⲏⲥ	ⲡⲟⲗⲓⲧⲏⲥ
ⲡⲟⲗⲗⲁⲕⲓⲥ	ⲡⲟⲗⲗⲁⲕⲓⲥ
ⲡⲟⲗⲩⲙⲁⲣⲭⲏⲥ	ⲡⲟⲗⲩⲙⲁⲣⲭⲏⲥ
ⲡⲟⲗⲩⲙⲓⲥⲧⲏⲥ	ⲡⲟⲗⲩⲙⲓⲥⲧⲏⲥ
ⲡⲟⲛⲏⲣⲁ	ⲡⲟⲛⲏⲣⲁ
ⲡⲟⲛⲏⲣⲉⲩⲉ	ⲡⲟⲛⲏⲣⲉⲩⲉ
ⲡⲟⲛⲏⲣⲓⲁ	ⲡⲟⲛⲏⲣⲓⲁ
ⲡⲟⲛⲏⲣⲟⲛ	ⲡⲟⲛⲏⲣⲟⲛ
ⲡⲟⲛⲏⲣⲟⲥ	ⲡⲟⲛⲏⲣⲟⲥ
ⲡⲟⲣⲛⲉⲓⲁ	ⲡⲟⲣⲛⲉⲓⲁ
ⲡⲟⲣⲛⲉⲩⲉ	ⲡⲟⲣⲛⲉⲩⲉ
ⲡⲟⲣⲛⲏ	ⲡⲟⲣⲛⲏ
ⲡⲟⲣⲛⲓⲕⲟⲛ	ⲡⲟⲣⲛⲓⲕⲟⲛ
ⲡⲟⲣⲛⲓⲟⲛ	ⲡⲟⲣⲛⲓⲟⲛ
ⲡⲟⲣⲛⲟⲕⲟⲡⲟⲥ	ⲡⲟⲣⲛⲟⲕⲟⲡⲟⲥ
ⲡⲟⲣⲛⲟⲥ	ⲡⲟⲣⲛⲟⲥ
ⲡⲟⲣⲫⲩⲣⲁ	ⲡⲟⲣⲫⲩⲣⲁ
ⲡⲟⲥⲓⲇⲱⲛ	ⲡⲟⲥⲓⲇⲱⲛ
ⲡⲟⲧⲁⲕⲓⲟⲛ	ⲡⲟⲧⲁⲕⲓⲟⲛ
ⲡⲟⲧⲏⲣⲓⲟⲛ	ⲡⲟⲧⲏⲣⲓⲟⲛ
ⲡⲣ̣ⲟⲧⲣⲟⲡⲏ	ⲡⲣ̣ⲟⲧⲣⲟⲡⲏ
ⲡⲣⲁⲅⲙⲁⲧⲉⲩⲉⲥⲑⲁⲓ	ⲡⲣⲁⲅⲙⲁⲧⲉⲩⲉⲥⲑⲁⲓ
ⲡⲣⲁⲅⲙⲁⲧⲉⲩⲧⲏⲥ	ⲡⲣⲁⲅⲙⲁⲧⲉⲩⲧⲏⲥ
ⲡⲣⲁⲅⲙⲁⲧⲓⲁ	ⲡⲣⲁⲅⲙⲁⲧⲓⲁ
ⲡⲣⲁⲅⲙⲁ	ⲡⲣⲁⲅⲙⲁ
ⲡⲣⲁⲓⲧⲁ	ⲡⲣⲁⲓⲧⲁ
ⲡⲣⲁⲓⲧⲱⲣⲓⲟⲛ	ⲡⲣⲁⲓⲧⲱⲣⲓⲟⲛ
ⲡⲣⲁⲝⲓⲥ	ⲡⲣⲁⲝⲓⲥ
ⲡⲣⲁⲥⲓⲥ	ⲡⲣⲁⲥⲓⲥ
ⲡⲣⲁⲥⲥⲁ	ⲡⲣⲁⲥⲥⲁ
ⲡⲣⲁⲥⲥⲉ	ⲡⲣⲁⲥⲥⲉ
ⲡⲣⲁⲧⲧⲉⲥⲑⲁⲓ	ⲡⲣⲁⲧⲧⲉⲥⲑⲁⲓ
ⲡⲣⲁⲧⲧⲉⲩⲑⲁⲓ	ⲡⲣⲁⲧⲧⲉⲩⲑⲁⲓ
ⲡⲣⲉⲡⲉⲓ	ⲡⲣⲉⲡⲉⲓ
ⲡⲣⲉⲡⲟⲥⲓⲧⲟⲥ	ⲡⲣⲉⲡⲟⲥⲓⲧⲟⲥ
ⲡⲣⲉⲥⲃⲉⲓⲁ	ⲡⲣⲉⲥⲃⲉⲓⲁ
ⲡⲣⲉⲥⲃⲉⲩⲉ	ⲡⲣⲉⲥⲃⲉⲩⲉ
ⲡⲣⲉⲥⲃⲉⲩⲧⲏⲥ	ⲡⲣⲉⲥⲃⲉⲩⲧⲏⲥ
ⲡⲣⲉⲥⲃⲩⲧⲉⲣⲟⲥ	ⲡⲣⲉⲥⲃⲩⲧⲉⲣⲟⲥ
ⲡⲣⲟϩⲁⲓⲣⲉⲥⲓⲥ	ⲡⲣⲟϩⲁⲓⲣⲉⲥⲓⲥ
ⲡⲣⲟϩⲓⲥⲧⲁ	ⲡⲣⲟϩⲓⲥⲧⲁ
ⲡⲣⲟϩⲟⲓⲙⲓⲟⲛ	ⲡⲣⲟϩⲟⲓⲙⲓⲟⲛ
ⲡⲣⲟⲁⲓⲥⲧⲓⲟⲛ	ⲡⲣⲟⲁⲓⲥⲧⲓⲟⲛ
ⲡⲣⲟⲃⲁⲗⲉ	ⲡⲣⲟⲃⲁⲗⲉ
ⲡⲣⲟⲃⲁⲧⲓⲕⲏ	ⲡⲣⲟⲃⲁⲧⲓⲕⲏ
ⲡⲣⲟⲃⲗⲏⲙⲁ	ⲡⲣⲟⲃⲗⲏⲙⲁ
ⲡⲣⲟⲅⲉⲛⲏⲧⲱⲣ	ⲡⲣⲟⲅⲉⲛⲏⲧⲱⲣ
ⲡⲣⲟⲅⲛⲱⲥⲓⲥ	ⲡⲣⲟⲅⲛⲱⲥⲓⲥ
ⲡⲣⲟⲇⲓⲇⲟⲩ	ⲡⲣⲟⲇⲓⲇⲟⲩ
ⲡⲣⲟⲇⲟⲇⲓ̈ⲁⲕⲟⲛⲟⲥ	ⲡⲣⲟⲇⲟⲇⲓ̈ⲁⲕⲟⲛⲟⲥ
ⲡⲣⲟⲇⲟⲧⲏⲥ	ⲡⲣⲟⲇⲟⲧⲏⲥ
ⲡⲣⲟⲇⲣⲟⲙⲟⲥ	ⲡⲣⲟⲇⲣⲟⲙⲟⲥ
ⲡⲣⲟⲉⲗⲑⲉ	ⲡⲣⲟⲉⲗⲑⲉ
ⲡⲣⲟⲉⲥⲧⲱⲥ	ⲡⲣⲟⲉⲥⲧⲱⲥ
ⲡⲣⲟⲑⲉⲥⲓⲛ	ⲡⲣⲟⲑⲉⲥⲓⲛ
ⲡⲣⲟⲑⲉⲥⲓⲥ	ⲡⲣⲟⲑⲉⲥⲓⲥ
ⲡⲣⲟⲑⲉⲥⲙⲓⲁ	ⲡⲣⲟⲑⲉⲥⲙⲓⲁ
ⲡⲣⲟⲑⲩⲙⲓⲁ	ⲡⲣⲟⲑⲩⲙⲓⲁ
ⲡⲣⲟⲑⲩⲙⲟⲥ	ⲡⲣⲟⲑⲩⲙⲟⲥ
ⲡⲣⲟⲕⲓⲙⲉⲛⲟⲛ	ⲡⲣⲟⲕⲓⲙⲉⲛⲟⲛ
ⲡⲣⲟⲕⲟⲡⲏ	ⲡⲣⲟⲕⲟⲡⲏ
ⲡⲣⲟⲕⲟⲡⲧⲉ	ⲡⲣⲟⲕⲟⲡⲧⲉ
ⲡⲣⲟⲕⲣⲓⲙⲁⲧⲓⲍⲉ	ⲡⲣⲟⲕⲣⲓⲙⲁⲧⲓⲍⲉ
ⲡⲣⲟⲛⲓⲕⲟⲥ	ⲡⲣⲟⲛⲓⲕⲟⲥ
ⲡⲣⲟⲛⲟⲏⲧⲏⲥ	ⲡⲣⲟⲛⲟⲏⲧⲏⲥ
ⲡⲣⲟⲛⲟⲏⲧⲟⲥ	ⲡⲣⲟⲛⲟⲏⲧⲟⲥ
ⲡⲣⲟⲛⲟⲓⲁ	ⲡⲣⲟⲛⲟⲓⲁ
ⲡⲣⲟⲡⲁⲧⲱⲣ	ⲡⲣⲟⲡⲁⲧⲱⲣ
ⲡⲣⲟⲡⲉⲧⲏⲥ	ⲡⲣⲟⲡⲉⲧⲏⲥ
ⲡⲣⲟⲥⲇⲟⲕⲁ	ⲡⲣⲟⲥⲇⲟⲕⲁ
ⲡⲣⲟⲥⲇⲟⲕⲉⲓ	ⲡⲣⲟⲥⲇⲟⲕⲉⲓ
ⲡⲣⲟⲥⲇⲟⲕⲓⲁ	ⲡⲣⲟⲥⲇⲟⲕⲓⲁ
ⲡⲣⲟⲥⲉⲗⲉⲩⲥⲓⲥ	ⲡⲣⲟⲥⲉⲗⲉⲩⲥⲓⲥ
ⲡⲣⲟⲥⲉⲗⲑⲉ	ⲡⲣⲟⲥⲉⲗⲑⲉ
ⲡⲣⲟⲥⲉⲩⲭⲉ	ⲡⲣⲟⲥⲉⲩⲭⲉ
ⲡⲣⲟⲥⲉⲩⲭⲏ	ⲡⲣⲟⲥⲉⲩⲭⲏ
ⲡⲣⲟⲥⲉⲭⲉ	ⲡⲣⲟⲥⲉⲭⲉ
ⲡⲣⲟⲥⲏⲗⲩⲧⲟⲥ	ⲡⲣⲟⲥⲏⲗⲩⲧⲟⲥ
ⲡⲣⲟⲥⲑⲉⲙⲁ	ⲡⲣⲟⲥⲑⲉⲙⲁ
ⲡⲣⲟⲥⲑⲏⲣⲟⲥ	ⲡⲣⲟⲥⲑⲏⲣⲟⲥ
ⲡⲣⲟⲥⲕⲁⲣⲧⲉⲣⲉⲓ	ⲡⲣⲟⲥⲕⲁⲣⲧⲉⲣⲉⲓ
ⲡⲣⲟⲥⲕⲩⲛⲉⲓ	ⲡⲣⲟⲥⲕⲩⲛⲉⲓ
ⲡⲣⲟⲥⲕⲩⲛⲏⲥⲓⲥ	ⲡⲣⲟⲥⲕⲩⲛⲏⲥⲓⲥ
ⲡⲣⲟⲥⲕ/	ⲡⲣⲟⲥⲕ/
ⲡⲣⲟⲥⲧⲁⲅⲙⲁ	ⲡⲣⲟⲥⲧⲁⲅⲙⲁ
ⲡⲣⲟⲥⲧⲁⲥⲓⲁ	ⲡⲣⲟⲥⲧⲁⲥⲓⲁ
ⲡⲣⲟⲥⲧⲁⲧⲏⲥ	ⲡⲣⲟⲥⲧⲁⲧⲏⲥ
ⲡⲣⲟⲥⲧⲓⲙⲟⲛ	ⲡⲣⲟⲥⲧⲓⲙⲟⲛ
ⲡⲣⲟⲥⲫⲉⲣⲉⲓ	ⲡⲣⲟⲥⲫⲉⲣⲉⲓ
ⲡⲣⲟⲥⲫⲟⲣⲁ	ⲡⲣⲟⲥⲫⲟⲣⲁ
ⲡⲣⲟⲥⲫⲱⲛⲉⲓ	ⲡⲣⲟⲥⲫⲱⲛⲉⲓ
ⲡⲣⲟⲥⲱⲡⲟⲛ	ⲡⲣⲟⲥⲱⲡⲟⲛ
ⲡⲣⲟⲥ	ⲡⲣⲟⲥ
ⲡⲣⲟⲧⲉⲕⲧⲱⲣ	ⲡⲣⲟⲧⲉⲕⲧⲱⲣ
ⲡⲣⲟⲧⲟⲅⲉⲛⲏⲧⲟⲥ	ⲡⲣⲟⲧⲟⲅⲉⲛⲏⲧⲟⲥ
ⲡⲣⲟⲧⲟⲅⲉⲛⲛⲏⲧⲱⲣ	ⲡⲣⲟⲧⲟⲅⲉⲛⲛⲏⲧⲱⲣ
ⲡⲣⲟⲧⲟⲡⲗⲁⲥⲙⲁ	ⲡⲣⲟⲧⲟⲡⲗⲁⲥⲙⲁ
ⲡⲣⲟⲧⲟⲡⲟⲗⲓⲧⲏⲥ	ⲡⲣⲟⲧⲟⲡⲟⲗⲓⲧⲏⲥ
ⲡⲣⲟⲧⲟⲫⲓⲗⲟⲥ	ⲡⲣⲟⲧⲟⲫⲓⲗⲟⲥ
ⲡⲣⲟⲧⲣⲉⲡⲉ	ⲡⲣⲟⲧⲣⲉⲡⲉ
ⲡⲣⲟⲫⲁⲥⲓⲥ	ⲡⲣⲟⲫⲁⲥⲓⲥ
ⲡⲣⲟⲫⲉⲧⲉⲩⲉ	ⲡⲣⲟⲫⲉⲧⲉⲩⲉ
ⲡⲣⲟⲫⲏⲧⲉⲓⲁ	ⲡⲣⲟⲫⲏⲧⲉⲓⲁ
ⲡⲣⲟⲫⲏⲧⲉⲩⲉ	ⲡⲣⲟⲫⲏⲧⲉⲩⲉ
ⲡⲣⲟⲫⲏⲧⲏⲥ	ⲡⲣⲟⲫⲏⲧⲏⲥ
ⲡⲣⲟⲫⲏⲧⲓⲕⲟⲛ	ⲡⲣⲟⲫⲏⲧⲓⲕⲟⲛ
ⲡⲣⲟⲱⲛⲧⲟⲥ	ⲡⲣⲟⲱⲛⲧⲟⲥ
ⲡⲣⲱⲧⲁⲣⲭⲱⲛ	ⲡⲣⲱⲧⲁⲣⲭⲱⲛ
ⲡⲣⲱⲧⲉⲛⲛⲟⲓⲁ	ⲡⲣⲱⲧⲉⲛⲛⲟⲓⲁ
ⲡⲣⲱⲧⲏ	ⲡⲣⲱⲧⲏ
ⲡⲣⲱⲧⲓⲁ	ⲡⲣⲱⲧⲓⲁ
ⲡⲣⲱⲧⲟⲛ	ⲡⲣⲱⲧⲟⲛ
ⲡⲣⲱⲧⲟⲧⲩⲡⲱⲥ	ⲡⲣⲱⲧⲟⲧⲩⲡⲱⲥ
ⲡⲣⲱⲧⲟⲫⲁⲛⲏⲥ	ⲡⲣⲱⲧⲟⲫⲁⲛⲏⲥ
ⲡⲧⲱⲙⲁ	ⲡⲧⲱⲙⲁ
ⲡⲩⲗⲏ	ⲡⲩⲗⲏ
ⲡⲩⲗⲱⲛ	ⲡⲩⲗⲱⲛ
ⲡⲩⲝⲓⲟⲛ	ⲡⲩⲝⲓⲟⲛ
ⲡⲩⲣⲁ	ⲡⲩⲣⲁ
ⲡⲩⲣⲅⲟⲥ	ⲡⲩⲣⲅⲟⲥ
ⲡⲩⲣⲟⲩ	ⲡⲩⲣⲟⲩ
ⲡⲱⲥ	ⲡⲱⲥ
ⲣϣϥⲉ	ⲣ|ϣϥⲉ
ⲣϣⲁⲩ	ⲣ|ϣⲁⲩ
ⲣϣⲁ	ⲣ|ϣⲁ
ⲣϣⲟⲣⲡ	ⲣ|ϣⲟⲣⲡ
ⲣϣⲡⲏⲣⲉ	ⲣ|ϣⲡⲏⲣⲉ
ⲣϩⲁϩ	ⲣ|ϩⲁϩ
ⲣϩⲁⲉ	ⲣ|ϩⲁⲉ
ⲣϩⲃⲃⲉ	ⲣ|ϩⲃⲃⲉ
ⲣϩⲉⲗⲡⲓⲍⲉ	ⲣ|ϩⲉⲗⲡⲓⲍⲉ
ⲣϩⲉⲙⲉⲣⲟⲥ	ⲣ|ϩⲉⲙⲉⲣⲟⲥ
ⲣϩⲉⲛⲧⲉⲭⲛⲏ	ⲣ|ϩⲉⲛ|ⲧⲉⲭⲛⲏ
ⲣϩⲏⲃⲉ	ⲣ|ϩⲏⲃⲉ
ⲣϩⲏⲧ	ⲣ|ϩⲏⲧ
ⲣϩⲙϩⲁⲗ	ⲣ|ϩⲙϩⲁⲗ
ⲣϩⲙⲉ	ⲣ|ϩⲙⲉ
ⲣϩⲙⲙⲉ	ⲣ|ϩⲙⲙⲉ
ⲣϩⲛⲁⲩ	ⲣ|ϩⲛⲁⲩ
ⲣϩⲛⲁ	ⲣ|ϩⲛⲁ
ⲣϩⲛⲏ	ⲣ|ϩⲛⲏ
ⲣϩⲟⲧⲉ	ⲣ|ϩⲟⲧⲉ
ⲣϩⲟⲩⲟ	ⲣ|ϩⲟⲩⲟ
ⲣϩⲩⲙⲛⲟⲥ	ⲣ|ϩⲩⲙⲛⲟⲥ
ⲣϩⲱⲃ	ⲣ|ϩⲱⲃ
ⲣϫⲟⲉⲓⲥ	ⲣ|ϫⲟⲉⲓⲥ
ⲣϫⲟⲩⲱⲧ	ⲣ|ϫⲟⲩⲱⲧ
ⲣϭⲟⲙ	ⲣ|ϭⲟⲙ
ⲣϭⲣⲱϩ	ⲣ|ϭⲣⲱϩ
ⲣⲁⲇⲓⲕⲓⲁ	ⲣ|ⲁⲇⲓⲕⲓⲁ
ⲣⲁⲑⲉⲧⲓⲛ	ⲣ|ⲁⲑⲉⲧⲓⲛ
ⲣⲁⲛⲁⲡⲁⲩⲉⲥⲑⲁⲓ	ⲣ|ⲁⲛⲁⲡⲁⲩⲉⲥⲑⲁⲓ
ⲣⲁⲛⲁⲭⲱⲣⲉⲓ	ⲣ|ⲁⲛⲁⲭⲱⲣⲉⲓ
ⲣⲁⲛⲁⲭⲱⲣⲓⲛ	ⲣ|ⲁⲛⲁⲭⲱⲣⲓⲛ
ⲣⲁⲛⲟⲩⲥⲓⲟⲥ	ⲣ|ⲁⲛⲟⲩⲥⲓⲟⲥ
ⲣⲁⲝⲓⲟⲥ	ⲣ|ⲁⲝⲓⲟⲥ
ⲣⲁⲡⲁⲅⲅⲉⲗⲓⲛ	ⲣ|ⲁⲡⲁⲅⲅⲉⲗⲓⲛ
ⲣⲁⲡⲁⲛⲧⲁⲛ	ⲣ|ⲁⲡⲁⲛⲧⲁⲛ
ⲣⲁⲡⲁⲧⲁⲛ	ⲣ|ⲁⲡⲁⲧⲁⲛ
ⲣⲁⲡⲓⲥⲧⲟⲥ	ⲣ|ⲁⲡⲓⲥⲧⲟⲥ
ⲣⲁⲡⲟⲕⲣⲓⲥⲓⲥ	ⲣ|ⲁⲡⲟⲕⲣⲓⲥⲓⲥ
ⲣⲁⲡⲟⲥⲧⲟⲗⲟⲥ	ⲣ|ⲁⲡⲟⲥⲧⲟⲗⲟⲥ
ⲣⲁⲡⲟⲧⲁⲍⲉⲥⲑⲉ	ⲣ|ⲁⲡⲟⲧⲁⲍⲉⲥⲑⲉ
ⲣⲁⲣⲅⲟⲛ	ⲣ|ⲁⲣⲅⲟⲛ
ⲣⲁⲣⲓⲥⲧⲟⲛ	ⲣ|ⲁⲣⲓⲥⲧⲟⲛ
ⲣⲁⲣⲭⲏ	ⲣ|ⲁⲣⲭⲏ
ⲣⲁⲥⲉⲃⲏⲥ	ⲣ|ⲁⲥⲉⲃⲏⲥ
ⲣⲁⲥⲡⲁⲍⲉⲥⲑⲉ	ⲣ|ⲁⲥⲡⲁⲍⲉⲥⲑⲉ
ⲣⲁⲧⲛⲁϩⲧⲉ	ⲣ|ⲁⲧ|ⲛⲁϩⲧⲉ
ⲣⲁⲧⲟⲟⲧ	ⲣ|ⲁⲧⲟⲟⲧ
ⲣⲁⲧⲥⲟⲟⲩⲛ	ⲣ|ⲁⲧ|ⲥⲟⲟⲩⲛ
ⲣⲃⲁⲥⲁⲛⲓⲍⲓⲛ	ⲣ|ⲃⲁⲥⲁⲛⲓⲍⲓⲛ
ⲣⲃⲗⲁⲡⲧⲓⲛ	ⲣ|ⲃⲗⲁⲡⲧⲓⲛ
ⲣⲃⲟⲏⲑⲓⲁ	ⲣ|ⲃⲟⲏⲑⲓⲁ
ⲣⲃⲟⲏⲑⲓⲛ	ⲣ|ⲃⲟⲏⲑⲓⲛ
ⲣⲃⲟⲟⲛⲉ	ⲣ|ⲃⲟⲟⲛⲉ
ⲣⲇⲓⲁⲕⲟⲛⲓⲛ	ⲣ|ⲇⲓⲁⲕⲟⲛⲓⲛ
ⲣⲉϥϣⲙϣⲉ	ⲣⲉϥ|ϣⲙϣⲉ
ⲣⲉϥϣⲟⲟⲣ	ⲣⲉϥ|ϣⲟⲟⲣ
ⲣⲉϥϣⲡϩⲓⲥⲉ	ⲣⲉϥ|ϣⲉⲡ|ϩⲓ̇ⲥⲉ
ⲣⲉϥϩⲩⲡⲟⲙⲓⲛⲉ	ⲣⲉϥ|ϩⲩⲡⲟⲙⲓⲛⲉ
ⲣⲉϥϩⲱϥⲧ	ⲣⲉϥ|ϩⲱϥⲧ
ⲣⲉϥϫⲓϣⲟϫⲛⲉ	ⲣⲉϥ|ϫⲓ|ϣⲟϫⲛⲉ
ⲣⲉϥϫⲓⲕⲟⲗⲩⲙⲃⲟⲛ	ⲣⲉϥ|ϫⲓ|ⲕⲟⲗⲩⲙⲃⲟⲛ
ⲣⲉϥϫⲓⲛϭⲟⲛⲥ	ⲣⲉϥ|ϫⲓ|ⲛ|ϭⲟⲛⲥ
ⲣⲉϥϫⲓⲟⲩⲉ	ⲣⲉϥ|ϫⲓⲟⲩⲉ
ⲣⲉϥϫⲓ	ⲣⲉϥ|ϫⲓ
ⲣⲉϥϭⲉⲡⲣⲱⲙⲉ	ⲣⲉϥ|ϭⲉⲡ|ⲣⲱⲙⲉ
ⲣⲉϥϯϩⲁⲡ	ⲣⲉϥ|ϯ|ϩⲁⲡ
ⲣⲉϥϯϩⲉ	ⲣⲉϥ|ϯ|ϩⲉ
ⲣⲉϥϯⲉⲱⲛ	ⲣⲉϥ|ϯ|ⲉⲱⲛ
ⲣⲉϥϯ	ⲣⲉϥ|ϯ
ⲣⲉϥⲁⲅⲱⲛⲓⲍⲉ	ⲣⲉϥ|ⲁⲅⲱⲛⲓⲍⲉ
ⲣⲉϥⲁⲣⲉⲥⲕⲉ	ⲣⲉϥ|ⲁⲣⲉⲥⲕⲉ
ⲣⲉϥⲇⲓⲁⲕⲟⲛⲉⲓ	ⲣⲉϥ|ⲇⲓⲁⲕⲟⲛⲉⲓ
ⲣⲉϥⲇⲓⲁⲕⲣⲓⲛⲉ	ⲣⲉϥ|ⲇⲓⲁⲕⲣⲓⲛⲉ
ⲣⲉϥⲇⲓⲒⲙⲙⲁⲣ	ⲣⲉϥ|ⲇⲓⲒⲙⲙⲁⲣ
ⲣⲉϥⲉⲡⲓⲑⲩⲙⲉⲓ	ⲣⲉϥ|ⲉⲡⲓⲑⲩⲙⲓ
ⲣⲉϥⲉⲣⲙⲉⲗⲉⲧⲁ	ⲣⲉϥ|ⲉⲣ|ⲙⲉⲗⲉⲧⲁ
ⲣⲉϥⲑⲉⲱⲣⲉⲓ	ⲣⲉϥ|ⲑⲉⲱⲣⲉⲓ
ⲣⲉϥⲑⲩⲣⲁⲡⲉⲩⲉ	ⲣⲉϥ|ⲑⲩⲣⲁⲡⲉⲩⲉ
ⲣⲉϥⲕⲁⲧⲁⲗⲁⲗⲉⲓ	ⲣⲉϥ|ⲕⲁⲧⲁⲗⲁⲗⲉⲓ
ⲣⲉϥⲕⲁⲧⲁⲫⲣⲟⲛⲉⲓ	ⲣⲉϥ|ⲕⲁⲧⲁⲫⲣⲟⲛⲉⲓ
ⲣⲉϥⲙⲟⲟⲩⲧ	ⲣⲉϥ|ⲙⲟⲟⲩⲧ
ⲣⲉϥⲛⲏⲫⲉ	ⲣⲉϥ|ⲛⲏⲫⲉ
ⲣⲉϥⲛⲕⲟⲧⲕ	ⲣⲉϥ|ⲛⲕⲟⲧⲕ
ⲣⲉϥⲛⲟⲓ	ⲣⲉϥ|ⲛⲟⲓ
ⲣⲉϥⲡⲗⲁⲛⲁ	ⲣⲉϥ|ⲡⲗⲁⲛⲁ
ⲣⲉϥⲣⲁⲓⲥⲑⲁⲛⲉ	ⲣⲉϥ|ⲣ|ⲁⲓⲥⲑⲁⲛⲉ
ⲣⲉϥⲣⲉⲡⲓⲑⲩⲙⲉⲓ	ⲣⲉϥ|ⲣ|ⲉⲡⲓⲑⲩⲙⲉⲓ
ⲣⲉϥⲣⲗⲩⲡⲉⲓ	ⲣⲉϥ|ⲣ|ⲗⲩⲡⲉⲓ
ⲣⲉϥⲣⲛⲟⲃⲉ	ⲣⲉϥ|ⲣ|ⲛⲟⲃⲉ
ⲣⲉϥⲣⲧⲉⲭⲛⲏ	ⲣⲉϥ|ⲣ|ⲧⲉⲭⲛⲏ
ⲣⲉϥⲥⲁϩⲟⲩ	ⲣⲉϥ|ⲥⲁϩⲟⲩ
ⲣⲉϥⲧⲱⲣⲡ	ⲣⲉϥ|ⲧⲱⲣⲡ
ⲣⲉϥⲫⲑⲟⲛⲉⲓ	ⲣⲉϥ|ⲫⲑⲟⲛⲉⲓ
ⲣⲉϥⲫⲟⲣⲉⲓ	ⲣⲉϥ|ⲫⲟⲣⲉⲓ
ⲣⲉϥⲯⲁⲗⲗⲉⲓ	ⲣⲉϥ|ⲯⲁⲗⲗⲉⲓ
ⲣⲉⲃⲏ	ⲣ|ⲉⲃⲏ
ⲣⲉⲓⲣⲏⲛⲏ	ⲣ|ⲉⲓⲣⲏⲛⲏ
ⲣⲉⲗⲁⲙⲓⲧⲏⲥ	ⲣ|ⲉⲗⲁⲙⲓⲧⲏⲥ
ⲣⲉⲙⲡⲟⲇⲁⲍⲓⲛ	ⲣ|ⲉⲙⲡⲟⲇⲁⲍⲓⲛ
ⲣⲉⲛⲕⲁⲕⲓⲛ	ⲣ|ⲉⲛⲕⲁⲕⲓⲛ
ⲣⲉⲛⲟⲩⲥⲓⲟⲥ	ⲣ|ⲉⲛⲟⲩⲥⲓⲟⲥ
ⲣⲉⲡⲓⲛⲟⲓⲛ	ⲣ|ⲉⲡⲓⲛⲟⲓⲛ
ⲣⲉⲡⲓⲥⲕⲟⲡⲟⲥ	ⲣ|ⲉⲡⲓⲥⲕⲟⲡⲟⲥ
ⲣⲉⲥⲑⲁⲛⲉⲥⲑⲉ	ⲣ|ⲉⲥⲑⲁⲛⲉⲥⲑⲉ
ⲣⲏⲥⲓⲥ	ⲣⲏⲥⲓⲥ
ⲣⲑⲁⲩⲙⲁ	ⲣ|ⲑⲁⲩⲙⲁ
ⲣⲑⲉⲱⲣⲓⲛ	ⲣ|ⲑⲉⲱⲣⲓⲛ
ⲣⲑⲩⲥⲓⲁ	ⲣ|ⲑⲩⲥⲓⲁ
ⲣⲕⲁⲕⲉ	ⲣ|ⲕⲁⲕⲉ
ⲣⲕⲁⲩⲙⲁ	ⲣ|ⲕⲁⲩⲙⲁ
ⲣⲕⲃⲁ	ⲣ|ⲕⲃⲁ
ⲣⲕⲉⲗⲉⲩⲓⲛ	ⲣ|ⲕⲉⲗⲉⲩⲓⲛ
ⲣⲕⲟⲓⲛⲟⲛ	ⲣ|ⲕⲟⲓⲛⲟⲛ
ⲣⲕⲟⲓⲛⲱⲛⲟⲥ	ⲣ|ⲕⲟⲓⲛⲱⲛⲟⲥ
ⲣⲕⲟⲩⲉⲓ	ⲣ|ⲕⲟⲩⲉⲓ
ⲣⲕⲣⲓⲛⲓⲛ	ⲣ|ⲕⲣⲓⲛⲓⲛ
ⲣⲗⲁⲁⲩ	ⲣ|ⲗⲁⲁⲩ
ⲣⲗⲓⲧⲟⲩⲣⲅⲓⲁ	ⲣ|ⲗⲓⲧⲟⲩⲣⲅⲓⲁ
ⲣⲗⲟⲓⲙⲟⲥ	ⲣ|ⲗⲟⲓⲙⲟⲥ
ⲣⲗⲩⲡⲏ	ⲣ|ⲗⲩⲡⲏ
ⲣⲙⲁⲅⲉⲓⲁ	ⲣ|ⲙⲁⲅⲉⲓⲁ
ⲣⲙⲁⲑⲏⲧⲏⲥ	ⲣ|ⲙⲁⲑⲏⲧⲏⲥ
ⲣⲙⲁⲕⲁⲣⲓⲟⲥ	ⲣ|ⲙⲁⲕⲁⲣⲓⲟⲥ
ⲣⲙⲁⲣⲧⲩⲣⲟⲥ	ⲣ|ⲙⲁⲣⲧⲩⲣⲟⲥ
ⲣⲙⲁⲧⲟⲓ	ⲣ|ⲙⲁⲧⲟⲓ
ⲣⲙⲉⲉⲩⲉ	ⲣ|ⲙⲉⲉⲩⲉ
ⲣⲙⲉⲧⲟⲭⲟⲥ	ⲣ|ⲙⲉⲧⲟⲭⲟⲥ
ⲣⲙⲏ	ⲣ|ⲙⲏ
ⲣⲙⲛϩⲏⲧ	ⲣⲙ|ⲛ|ϩⲏⲧ
ⲣⲙⲛⲕⲁϩ	ⲣⲙ|ⲛ|ⲕⲁϩ
ⲣⲙⲛⲛⲟⲙⲟⲥ	ⲣⲙⲛ|ⲛⲟⲙⲟⲥ
ⲣⲙⲛⲡⲟⲗⲓⲥ	ⲣⲙⲛ|ⲡⲟⲗⲓⲥ
ⲣⲙⲛⲥⲁⲣⲝ	ⲣⲙⲛ|ⲥⲁⲣⲝ
ⲣⲙⲛⲧⲣⲉ	ⲣ|ⲙⲛⲧⲣⲉ
ⲣⲙⲟⲛⲁⲭⲟⲥ	ⲣ|ⲙⲟⲛⲁⲭⲟⲥ
ⲣⲙⲡⲉⲡⲟⲓⲕⲓⲟⲛ	ⲣⲙ|ⲡⲉⲡⲟⲓⲕⲓⲟⲛ
ⲣⲙⲱⲛⲁⲭⲏ	ⲣ|ⲙⲱⲛⲁⲭⲏ
ⲣⲛⲟϥⲣⲉ	ⲣ|ⲛⲟϥⲣⲉ
ⲣⲛⲟϭ	ⲣ|ⲛⲟϭ
ⲣⲛⲟⲃⲉ	ⲣ|ⲛⲟⲃⲉ
ⲣⲛⲟⲃⲣⲉ	ⲣ|ⲛⲟⲃⲣⲉ
ⲣⲛⲟⲉⲓⲕ	ⲣ|ⲛⲟⲉⲓⲕ
ⲣⲟⲙⲟⲗⲟⲅⲓⲛ	ⲣ|ⲟⲙⲟⲗⲟⲅⲓⲛ
ⲣⲟⲣⲫⲁⲛⲟⲥ	ⲣ|ⲟⲣⲫⲁⲛⲟⲥ
ⲣⲟⲩⲟⲉⲓⲛ	ⲣ|ⲟⲩⲟⲉⲓⲛ
ⲣⲟⲩ	ⲣ|ⲟⲩ
ⲣⲡⲁⲓ	ⲣ|ⲡⲁⲓ
ⲣⲡⲁⲣⲏⲥⲓⲁ	ⲣ|ⲡⲁⲣⲏⲥⲓⲁ
ⲣⲡⲁⲥⲭⲁ	ⲣ|ⲡⲁⲥⲭⲁ
ⲣⲡⲉⲓⲑⲉⲓ	ⲣ|ⲡⲉⲓⲑⲉⲓ
ⲣⲡⲗⲁⲛⲏ	ⲣ|ⲡⲗⲁⲛⲏ
ⲣⲡⲟⲗⲉⲙⲟⲥ	ⲣ|ⲡⲟⲗⲉⲙⲟⲥ
ⲣⲡⲣⲟⲥⲫⲉⲣⲓⲛ	ⲣ|ⲡⲣⲟⲥⲫⲉⲣⲓⲛ
ⲣⲡⲣⲟⲫⲏⲧⲏⲥ	ⲣ|ⲡⲣⲟⲫⲏⲧⲏⲥ
ⲣⲣⲏⲧⲱⲣⲉⲩⲓⲛ	ⲣ|ⲣⲏⲧⲱⲣⲉⲩⲓⲛ
ⲣⲣⲙϩⲉ	ⲣ|ⲣⲙϩⲉ
ⲣⲣⲙⲙⲁⲟ	ⲣ|ⲣⲙⲙⲁⲟ
ⲣⲣⲟⲟⲩϣ	ⲣ|ⲣⲟⲟⲩϣ
ⲣⲣⲣⲟ	ⲣ|ⲣⲣⲟ
ⲣⲥϩⲓⲙⲉ	ⲣ|ⲥϩⲓⲙⲉ
ⲣⲥⲁϣϥ	ⲣ|ⲥⲁϣϥ
ⲣⲥⲁϩ	ⲣ|ⲥⲁϩ
ⲣⲥⲁⲃⲃⲁⲧⲟⲛ	ⲣ|ⲥⲁⲃⲃⲁⲧⲟⲛ
ⲣⲥⲁⲣⲝ	ⲣ|ⲥⲁⲣⲝ
ⲣⲥⲕⲉⲡⲁⲍⲓⲛ	ⲣ|ⲥⲕⲉⲡⲁⲍⲓⲛ
ⲣⲥⲕⲩⲗⲏ	ⲣ|ⲥⲕⲩⲗⲏ
ⲣⲥⲙⲟⲧ	ⲣ|ⲥⲙⲟⲧ
ⲣⲥⲛⲁⲩ	ⲣ|ⲥⲛⲁⲩ
ⲣⲥⲟϭ	ⲣ|ⲥⲟϭ
ⲣⲥⲟⲫⲟⲥ	ⲣ|ⲥⲟⲫⲟⲥ
ⲣⲥⲧⲩⲗⲟⲥ	ⲣ|ⲥⲧⲩⲗⲟⲥ
ⲣⲥⲧ	ⲣ|ⲥⲧ
ⲣⲥⲱⲙⲁ	ⲣ|ⲥⲱⲙⲁ
ⲣⲧⲁⲅⲁⲡⲏ	ⲣ|ⲧ|ⲁⲅⲁⲡⲏ
ⲣⲧⲉⲗⲉⲓⲟⲥ	ⲣ|ⲧⲉⲗⲉⲓⲟⲥ
ⲣⲧⲏⲡⲟⲥ	ⲣ|ⲧⲏⲡⲟⲥ
ⲣⲧⲩⲡⲟⲥ	ⲣ|ⲧⲩⲡⲟⲥ
ⲣⲧⲱⲛ	ⲣ|ⲧⲱⲛ
ⲣⲫⲟⲛⲟⲥ	ⲣ|ⲫⲟⲛⲟⲥ
ⲣⲭⲁⲩⲛⲟⲥ	ⲣ|ⲭⲁⲩⲛⲟⲥ
ⲣⲭⲏⲣⲁ	ⲣ|ⲭⲏⲣⲁ
ⲣⲭⲟⲗⲏ	ⲣ|ⲭⲟⲗⲏ
ⲣⲭⲣⲉⲓⲁ	ⲣ|ⲭⲣⲉⲓⲁ
ⲣⲭⲣⲏⲥⲧⲟⲥ	ⲣ|ⲭⲣⲏⲥⲧⲟⲥ
ⲣⲭⲣⲓⲁ	ⲣ|ⲭⲣⲓⲁ
ⲥϯⲭⲟⲥ	ⲥϯⲭⲟⲥ
ⲥⲁϩⲃⲟⲩⲣ	ⲥⲁ|ϩⲃⲟⲩⲣ
ⲥⲁⲃⲁⲕⲁⲧⲉ	ⲥⲁⲃⲁⲕⲁⲧⲉ
ⲥⲁⲕⲓⲁ	ⲥⲁⲕⲓⲁ
ⲥⲁⲗⲁⲙⲁⲛⲇⲣⲁ	ⲥⲁⲗⲁⲙⲁⲛⲇⲣⲁ
ⲥⲁⲗⲡⲓⲅⲅⲟⲥ	ⲥⲁⲗⲡⲓⲅⲅⲟⲥ
ⲥⲁⲗⲡⲓⲅⲝ	ⲥⲁⲗⲡⲓⲅⲝ
ⲥⲁⲗⲡⲓⲍⲉ	ⲥⲁⲗⲡⲓⲍⲉ
ⲥⲁⲙⲁⲣⲓⲧⲏⲥ	ⲥⲁⲙⲁⲣⲓⲧⲏⲥ
ⲥⲁⲛⲇⲁⲗⲓⲟⲛ	ⲥⲁⲛⲇⲁⲗⲓⲟⲛ
ⲥⲁⲡⲡⲉⲓⲣⲓⲛⲟⲛ	ⲥⲁⲡⲡⲉⲓⲣⲓⲛⲟⲛ
ⲥⲁⲡⲡⲓⲣⲟⲛ	ⲥⲁⲡⲡⲓⲣⲟⲛ
ⲥⲁⲡⲡⲓⲣⲟⲥ	ⲥⲁⲡⲡⲓⲣⲟⲥ
ⲥⲁⲣⲁⲅⲏⲛⲟⲥ	ⲥⲁⲣⲁⲅⲏⲛⲟⲥ
ⲥⲁⲣⲁⲫⲉⲓⲛ	ⲥⲁⲣⲁⲫⲉⲓⲛ
ⲥⲁⲣⲇⲓⲟⲛ	ⲥⲁⲣⲇⲓⲟⲛ
ⲥⲁⲣⲕⲁⲛⲏ	ⲥⲁⲣⲕⲁⲛⲏ
ⲥⲁⲣⲕⲓⲕⲏ	ⲥⲁⲣⲕⲓⲕⲏ
ⲥⲁⲣⲕⲓⲕⲟⲛ	ⲥⲁⲣⲕⲓⲕⲟⲛ
ⲥⲁⲣⲕⲓⲕⲟⲥ	ⲥⲁⲣⲕⲓⲕⲟⲥ
ⲥⲁⲣⲝ	ⲥⲁⲣⲝ
ⲥⲁⲧⲉⲉⲣⲉ	ⲥⲁⲧⲉⲉⲣⲉ
ⲥⲁⲫⲏⲛⲓⲍⲉ	ⲥⲁⲫⲏⲛⲓⲍⲉ
ⲥⲉⲃⲉⲥⲑⲁⲓ	ⲥⲉⲃⲉⲥⲑⲁⲓ
ⲥⲉⲃⲏⲣⲓⲟⲛ	ⲥⲉⲃⲏⲣⲓⲟⲛ
ⲥⲉⲗⲏⲛⲓⲁⲍⲉ	ⲥⲉⲗⲏⲛⲓⲁⲍⲉ
ⲥⲉⲙⲛⲏ	ⲥⲉⲙⲛⲏ
ⲥⲉⲙⲛⲟⲛ	ⲥⲉⲙⲛⲟⲛ
ⲥⲉⲙⲛⲟⲥ	ⲥⲉⲙⲛⲟⲥ
ⲥⲉⲙⲡⲟⲇⲓⲟⲛ	ⲥⲉⲙⲡⲟⲇⲓⲟⲛ
ⲥⲉⲛⲁⲗⲁⲥⲉ	ⲥⲉⲛⲁⲗⲁⲥⲉ
ⲥⲉⲣⲁⲡⲓⲥ	ⲥⲉⲣⲁⲡⲓⲥ
ⲥⲉⲣⲁ	ⲥⲉⲣⲁ
ⲥⲏⲙⲁⲛⲉ	ⲥⲏⲙⲁⲛⲉ
ⲥⲏⲙⲉⲓⲟⲛ	ⲥⲏⲙⲉⲓⲟⲛ
ⲥⲏⲙⲓⲟⲛ	ⲥⲏⲙⲓⲟⲛ
ⲥⲓⲅⲏ	ⲥⲓⲅⲏ
ⲥⲓⲅⲛⲟⲛ	ⲥⲓⲅⲛⲟⲛ
ⲥⲓⲅⲛⲟⲩⲫⲩⲗⲁⲝ	ⲥⲓⲅⲛⲟⲩⲫⲩⲗⲁⲝ
ⲥⲓⲙⲱⲛⲓⲁⲛⲟⲥ	ⲥⲓⲙⲱⲛⲓⲁⲛⲟⲥ
ⲥⲓⲛⲇⲱⲛⲓⲟⲛ	ⲥⲓⲛⲇⲱⲛⲓⲟⲛ
ⲥⲓⲛⲇⲱⲛ	ⲥⲓⲛⲇⲱⲛ
ⲥⲓⲡⲡⲓⲟⲛ	ⲥⲓⲡⲡⲓⲟⲛ
ⲥⲓⲥⲙⲟⲥ	ⲥⲓⲥⲙⲟⲥ
ⲥⲓⲭⲁⲛⲉⲥⲑⲁⲓ	ⲥⲓⲭⲁⲛⲉⲥⲑⲁⲓ
ⲥⲓⲭⲁⲛⲉ	ⲥⲓⲭⲁⲛⲉ
ⲥⲕⲁⲗⲁ	ⲥⲕⲁⲗⲁ
ⲥⲕⲁⲛⲇⲁⲗⲓⲍⲉ	ⲥⲕⲁⲛⲇⲁⲗⲓⲍⲉ
ⲥⲕⲁⲛⲇⲁⲗⲓⲥⲍⲉⲥⲑⲉ	ⲥⲕⲁⲛⲇⲁⲗⲓⲥⲍⲉⲥⲑⲉ
ⲥⲕⲁⲛⲇⲁⲗⲟⲛ	ⲥⲕⲁⲛⲇⲁⲗⲟⲛ
ⲥⲕⲁⲛⲇⲁⲗⲟⲥ	ⲥⲕⲁⲛⲇⲁⲗⲟⲥ
ⲥⲕⲁⲫⲏ	ⲥⲕⲁⲫⲏ
ⲥⲕⲁⲫⲟⲥ	ⲥⲕⲁⲫⲟⲥ
ⲥⲕⲉⲡⲁⲍⲉ	ⲥⲕⲉⲡⲁⲍⲉ
ⲥⲕⲉⲡⲁⲥⲧⲏⲥ	ⲥⲕⲉⲡⲁⲥⲧⲏⲥ
ⲥⲕⲉⲡⲉ	ⲥⲕⲉⲡⲉ
ⲥⲕⲉⲡⲓ	ⲥⲕⲉⲡⲓ
ⲥⲕⲉⲡⲧⲉⲓ	ⲥⲕⲉⲡⲧⲉⲓ
ⲥⲕⲉⲡⲧⲓⲛ	ⲥⲕⲉⲡⲧⲓⲛ
ⲥⲕⲉⲡⲱⲗⲁⲧⲱⲣ	ⲥⲕⲉⲡⲱⲗⲁⲧⲱⲣ
ⲥⲕⲉⲩⲉ	ⲥⲕⲉⲩⲉ
ⲥⲕⲉⲩⲏ	ⲥⲕⲉⲩⲏ
ⲥⲕⲉⲩⲟⲥ	ⲥⲕⲉⲩⲟⲥ
ⲥⲕⲉⲯⲓⲥ	ⲥⲕⲉⲯⲓⲥ
ⲥⲕⲏⲇⲁⲗⲏ	ⲥⲕⲏⲇⲁⲗⲏ
ⲥⲕⲏⲛⲏ	ⲥⲕⲏⲛⲏ
ⲥⲕⲏⲛⲟⲡⲏⲅⲓⲁ	ⲥⲕⲏⲛⲟⲡⲏⲅⲓⲁ
ⲥⲕⲓⲃⲩⲧⲱⲣ	ⲥⲕⲓⲃⲩⲧⲱⲣ
ⲥⲕⲓⲣⲧⲁ	ⲥⲕⲓⲣⲧⲁ
ⲥⲕⲗⲏⲣⲓⲁ	ⲥⲕⲗⲏⲣⲓⲁ
ⲥⲕⲟⲡⲟⲥ	ⲥⲕⲟⲡⲟⲥ
ⲥⲕⲩⲑⲏⲥ	ⲥⲕⲩⲑⲏⲥ
ⲥⲕⲩⲗⲗⲉⲓ	ⲥⲕⲩⲗⲗⲉⲓ
ⲥⲕⲩⲗⲙⲟⲥ	ⲥⲕⲩⲗⲙⲟⲥ
ⲥⲕⲩⲛⲱⲙⲁ	ⲥⲕⲩⲛⲱⲙⲁ
ⲥⲙⲁⲣⲁⲅⲇⲟⲥ	ⲥⲙⲁⲣⲁⲅⲇⲟⲥ
ⲥⲙⲉⲗⲓⲛ	ⲥⲙⲉⲗⲓⲛ
ⲥⲙⲓⲗⲁⲝ	ⲥⲙⲓⲗⲁⲝ
ⲥⲛⲧⲁⲍⲉ	ⲥⲛⲧⲁⲍⲉ
ⲥⲟⲇⲟⲙⲓⲧⲏⲥ	ⲥⲟⲇⲟⲙⲓⲧⲏⲥ
ⲥⲟⲧⲡ	ⲥⲟⲧⲡ
ⲥⲟⲩⲇⲁⲣⲓⲟⲛ	ⲥⲟⲩⲇⲁⲣⲓⲟⲛ
ⲥⲟⲫⲓⲁ	ⲥⲟⲫⲓⲁ
ⲥⲟⲫⲟⲥ	ⲥⲟⲫⲟⲥ
ⲥⲡⲁⲧⲁⲗⲁ	ⲥⲡⲁⲧⲁⲗⲁ
ⲥⲡⲁⲧⲁⲗⲟⲥ	ⲥⲡⲁⲧⲁⲗⲟⲥ
ⲥⲡⲉⲣⲙⲁ	ⲥⲡⲉⲣⲙⲁ
ⲥⲡⲏⲗⲁⲓⲟⲛ	ⲥⲡⲏⲗⲁⲓⲟⲛ
ⲥⲡⲓⲛⲑⲏⲣ	ⲥⲡⲓⲛⲑⲏⲣ
ⲥⲡⲓⲣⲁ	ⲥⲡⲓⲣⲁ
ⲥⲡⲗⲁⲅⲭⲛⲟⲛ	ⲥⲡⲗⲁⲅⲭⲛⲟⲛ
ⲥⲡⲗⲏⲛ	ⲥⲡⲗⲏⲛ
ⲥⲡⲟⲅⲅⲟⲥ	ⲥⲡⲟⲅⲅⲟⲥ
ⲥⲡⲟⲛⲇⲏ	ⲥⲡⲟⲛⲇⲏ
ⲥⲡⲟⲣⲁ	ⲥⲡⲟⲣⲁ
ⲥⲡⲟⲩⲇⲁⲍⲉ	ⲥⲡⲟⲩⲇⲁⲍⲉ
ⲥⲡⲟⲩⲇⲁⲓⲟⲥ	ⲥⲡⲟⲩⲇⲁⲓⲟⲥ
ⲥⲡⲟⲩⲇⲏ	ⲥⲡⲟⲩⲇⲏ
ⲥⲧⲁⲅⲱⲛ	ⲥⲧⲁⲅⲱⲛ
ⲥⲧⲁⲇⲓⲟⲛ	ⲥⲧⲁⲇⲓⲟⲛ
ⲥⲧⲁⲕⲧⲏ	ⲥⲧⲁⲕⲧⲏ
ⲥⲧⲁⲥⲓⲁⲍⲉ	ⲥⲧⲁⲥⲓⲁⲍⲉ
ⲥⲧⲁⲥⲓⲁⲥⲧⲏⲥ	ⲥⲧⲁⲥⲓⲁⲥⲧⲏⲥ
ⲥⲧⲁⲥⲓⲥ	ⲥⲧⲁⲥⲓⲥ
ⲥⲧⲁⲩⲗⲟⲛ	ⲥⲧⲁⲩⲗⲟⲛ
ⲥⲧⲁⲩⲣⲟⲥ	ⲥⲧⲁⲩⲣⲟⲥ
ⲥⲧⲁⲩⲣⲟⲩ	ⲥⲧⲁⲩⲣⲟⲩ
ⲥⲧⲁⲫⲩⲗⲏ	ⲥⲧⲁⲫⲩⲗⲏ
ⲥⲧⲉⲓⲣⲁ	ⲥⲧⲉⲓⲣⲁ
ⲥⲧⲉⲛⲱⲥⲓⲥ	ⲥⲧⲉⲛⲱⲥⲓⲥ
ⲥⲧⲉⲣⲉⲱⲙⲁ	ⲥⲧⲉⲣⲉⲱⲙⲁ
ⲥⲧⲉⲫⲁⲛⲟⲩⲫⲟⲣⲟⲥ	ⲥⲧⲉⲫⲁⲛⲟⲩⲫⲟⲣⲟⲥ
ⲥⲧⲉⲫⲁⲛⲟⲩ	ⲥⲧⲉⲫⲁⲛⲟⲩ
ⲥⲧⲏⲗⲏ	ⲥⲧⲏⲗⲏ
ⲥⲧⲏⲗⲟⲅⲣⲁⲫⲓⲁ	ⲥⲧⲏⲗⲟⲅⲣⲁⲫⲓⲁ
ⲥⲧⲓⲅⲙⲏ	ⲥⲧⲓⲅⲙⲏ
ⲥⲧⲓⲍⲉ	ⲥⲧⲓⲍⲉ
ⲥⲧⲓⲭⲉⲣⲟⲛ	ⲥⲧⲓⲭⲉⲣⲟⲛ
ⲥⲧⲓⲭⲟⲥ	ⲥⲧⲓⲭⲟⲥ
ⲥⲧⲟⲁ	ⲥⲧⲟⲁ
ⲥⲧⲟⲓⲭⲉⲓ	ⲥⲧⲟⲓⲭⲉⲓ
ⲥⲧⲟⲓⲭⲓⲟⲛ	ⲥⲧⲟⲓⲭⲓⲟⲛ
ⲥⲧⲟⲓ	ⲥⲧⲟⲓ
ⲥⲧⲟⲗⲏ	ⲥⲧⲟⲗⲏ
ⲥⲧⲟⲗⲓⲍⲉ	ⲥⲧⲟⲗⲓⲍⲉ
ⲥⲧⲟⲗⲟⲧⲟⲥ	ⲥⲧⲟⲗⲟⲧⲟⲥ
ⲥⲧⲟⲙⲁⲭⲟⲥ	ⲥⲧⲟⲙⲁⲭⲟⲥ
ⲥⲧⲣⲁⲧⲉⲓⲁ	ⲥⲧⲣⲁⲧⲉⲓⲁ
ⲥⲧⲣⲁⲧⲉⲩⲉ	ⲥⲧⲣⲁⲧⲉⲩⲉ
ⲥⲧⲣⲁⲧⲉⲩⲙⲁ	ⲥⲧⲣⲁⲧⲉⲩⲙⲁ
ⲥⲧⲣⲁⲧⲏⲅⲟⲥ	ⲥⲧⲣⲁⲧⲏⲅⲟⲥ
ⲥⲧⲣⲁⲧⲏⲗⲁⲧⲏⲥ	ⲥⲧⲣⲁⲧⲏⲗⲁⲧⲏⲥ
ⲥⲧⲣⲁⲧⲟⲛ	ⲥⲧⲣⲁⲧⲟⲛ
ⲥⲧⲣⲁⲧⲱⲡⲉⲧⲱⲛ	ⲥⲧⲣⲁⲧⲱⲡⲉⲧⲱⲛ
ⲥⲧⲣⲉⲃⲗⲟⲩ	ⲥⲧⲣⲉⲃⲗⲟⲩ
ⲥⲧⲣⲟⲅⲓⲗⲗⲟⲥ	ⲥⲧⲣⲟⲅⲓⲗⲗⲟⲥ
ⲥⲧⲣⲱⲙⲁ	ⲥⲧⲣⲱⲙⲁ
ⲥⲧⲩⲗⲟⲥ	ⲥⲧⲩⲗⲟⲥ
ⲥⲧⲩⲣⲁⲝ	ⲥⲧⲩⲣⲁⲝ
ⲥⲧⲩⲫⲏ	ⲥⲧⲩⲫⲏ
ⲥⲧⲩⲭⲉⲓ	ⲥⲧⲩⲭⲉⲓ
ⲥⲩⲅⲅⲉⲛⲉⲓⲁ	ⲥⲩⲅⲅⲉⲛⲉⲓⲁ
ⲥⲩⲅⲅⲉⲛⲏⲥ	ⲥⲩⲅⲅⲉⲛⲏⲥ
ⲥⲩⲅⲏ	ⲥⲩⲅⲏ
ⲥⲩⲅⲕⲣⲓⲙⲁ	ⲥⲩⲅⲕⲣⲓⲙⲁ
ⲥⲩⲅⲟⲥ	ⲥⲩⲅⲟⲥ
ⲥⲩⲗⲁ	ⲥⲩⲗⲁ
ⲥⲩⲗⲉⲩⲉ	ⲥⲩⲗⲉⲩⲉ
ⲥⲩⲙⲃⲟⲗⲏ	ⲥⲩⲙⲃⲟⲗⲏ
ⲥⲩⲙⲃⲟⲗⲟⲛ	ⲥⲩⲙⲃⲟⲗⲟⲛ
ⲥⲩⲙⲃⲟⲗⲟⲥ	ⲥⲩⲙⲃⲟⲗⲟⲥ
ⲥⲩⲙⲃⲟⲩⲗⲉⲩⲉ	ⲥⲩⲙⲃⲟⲩⲗⲉⲩⲉ
ⲥⲩⲙⲃⲟⲩⲗⲓⲁ	ⲥⲩⲙⲃⲟⲩⲗⲓⲁ
ⲥⲩⲙⲃⲟⲩⲗⲓⲟⲛ	ⲥⲩⲙⲃⲟⲩⲗⲓⲟⲛ
ⲥⲩⲙⲙⲁⲭⲟⲥ	ⲥⲩⲙⲙⲁⲭⲟⲥ
ⲥⲩⲙⲙⲉⲧⲟⲭⲟⲥ	ⲥⲩⲙⲙⲉⲧⲟⲭⲟⲥ
ⲥⲩⲙⲡⲟⲥⲓⲟⲛ	ⲥⲩⲙⲡⲟⲥⲓⲟⲛ
ⲥⲩⲙⲫⲁⲛⲉⲍⲉ	ⲥⲩⲙⲫⲁⲛⲉⲍⲉ
ⲥⲩⲙⲫⲉⲣⲉⲓ	ⲥⲩⲙⲫⲉⲣⲉⲓ
ⲥⲩⲙⲫⲟⲣⲁ	ⲥⲩⲙⲫⲟⲣⲁ
ⲥⲩⲙⲫⲱⲛⲉⲓ	ⲥⲩⲙⲫⲱⲛⲉⲓ
ⲥⲩⲙⲫⲱⲛⲓⲁ	ⲥⲩⲙⲫⲱⲛⲓⲁ
ⲥⲩⲙⲫⲱⲛⲟⲛ	ⲥⲩⲙⲫⲱⲛⲟⲛ
ⲥⲩⲛϩⲉⲇⲣⲓⲟⲛ	ⲥⲩⲛϩⲉⲇⲣⲓⲟⲛ
ⲥⲩⲛϩⲓⲥⲧⲁ	ⲥⲩⲛϩⲓⲥⲧⲁ
ⲥⲩⲛϩⲟⲇⲟⲥ	ⲥⲩⲛϩⲟⲇⲟⲥ
ⲥⲩⲛⲁⲅⲉ	ⲥⲩⲛⲁⲅⲉ
ⲥⲩⲛⲁⲅⲱⲅⲏ	ⲥⲩⲛⲁⲅⲱⲅⲏ
ⲥⲩⲛⲁⲓⲛⲉⲓ	ⲥⲩⲛⲁⲓⲛⲉⲓ
ⲥⲩⲛⲁⲛⲧⲏⲙⲁ	ⲥⲩⲛⲁⲛⲧⲏⲙⲁ
ⲥⲩⲛⲁⲝⲓⲥ	ⲥⲩⲛⲁⲝⲓⲥ
ⲥⲩⲛⲁⲣⲡⲁⲅⲏ	ⲥⲩⲛⲁⲣⲡⲁⲅⲏ
ⲥⲩⲛⲃⲟⲏⲑⲉⲓ	ⲥⲩⲛⲃⲟⲏⲑⲉⲓ
ⲥⲩⲛⲃⲟⲏⲑⲓⲁ	ⲥⲩⲛⲃⲟⲏⲑⲓⲁ
ⲥⲩⲛⲃⲟⲗⲏ	ⲥⲩⲛⲃⲟⲗⲏ
ⲥⲩⲛⲅⲛⲱⲙⲏ	ⲥⲩⲛⲅⲛⲱⲙⲏ
ⲥⲩⲛⲅⲣⲁⲫⲉⲩⲥ	ⲥⲩⲛⲅⲣⲁⲫⲉⲩⲥ
ⲥⲩⲛⲇⲟⲛⲓⲟⲛ	ⲥⲩⲛⲇⲟⲛⲓⲟⲛ
ⲥⲩⲛⲉⲓⲇⲏⲥⲓⲥ	ⲥⲩⲛⲉⲓⲇⲏⲥⲓⲥ
ⲥⲩⲛⲉⲩⲇⲟⲕⲉⲓ	ⲥⲩⲛⲉⲩⲇⲟⲕⲉⲓ
ⲥⲩⲛⲉⲭⲉ	ⲥⲩⲛⲉⲭⲉ
ⲥⲩⲛⲍⲏⲧⲉⲓ	ⲥⲩⲛⲍⲏⲧⲉⲓ
ⲥⲩⲛⲍⲩⲅⲟⲥ	ⲥⲩⲛⲍⲩⲅⲟⲥ
ⲥⲩⲛⲏⲇⲏⲥⲓⲥ	ⲥⲩⲛⲏⲇⲏⲥⲓⲥ
ⲥⲩⲛⲏⲑⲉⲓⲁ	ⲥⲩⲛⲏⲑⲉⲓⲁ
ⲥⲩⲛⲏⲗⲑⲁⲓ	ⲥⲩⲛⲏⲗⲑⲁⲓ
ⲥⲩⲛⲑⲉⲥⲓⲥ	ⲥⲩⲛⲑⲉⲥⲓⲥ
ⲥⲩⲛⲑⲏⲧⲟⲛ	ⲥⲩⲛⲑⲏⲧⲟⲛ
ⲥⲩⲛⲕⲁⲑⲉⲇⲣⲟⲥ	ⲥⲩⲛⲕⲁⲑⲉⲇⲣⲟⲥ
ⲥⲩⲛⲕⲗⲏⲣⲟⲛⲟⲙⲟⲥ	ⲥⲩⲛⲕⲗⲏⲣⲟⲛⲟⲙⲟⲥ
ⲥⲩⲛⲕⲗⲏⲧⲟⲥ	ⲥⲩⲛⲕⲗⲏⲧⲟⲥ
ⲥⲩⲛⲟⲩⲥⲓⲁ	ⲥⲩⲛⲟⲩⲥⲓⲁ
ⲥⲩⲛⲧⲁⲅⲏ	ⲥⲩⲛⲧⲁⲅⲏ
ⲥⲩⲛⲧⲁⲅⲙⲁ	ⲥⲩⲛⲧⲁⲅⲙⲁ
ⲥⲩⲛⲧⲁⲍⲉ	ⲥⲩⲛⲧⲁⲍⲉ
ⲥⲩⲛⲧⲉⲗⲉⲓⲁ	ⲥⲩⲛⲧⲉⲗⲉⲓⲁ
ⲥⲩⲛⲧⲓⲙⲁⲍⲉ	ⲥⲩⲛⲧⲓⲙⲁⲍⲉ
ⲥⲩⲛⲭⲱⲣⲉⲓ	ⲥⲩⲛⲭⲱⲣⲉⲓ
ⲥⲩⲛⲭⲱⲣⲏⲥⲓⲥ	ⲥⲩⲛⲭⲱⲣⲏⲥⲓⲥ
ⲥⲩⲣⲉ	ⲥⲩⲣⲉ
ⲥⲩⲥⲧⲁⲥⲓⲥ	ⲥⲩⲥⲧⲁⲥⲓⲥ
ⲥⲫⲉⲛⲇⲟⲛⲏ	ⲥⲫⲉⲛⲇⲟⲛⲏ
ⲥⲫⲉⲣⲁ	ⲥⲫⲉⲣⲁ
ⲥⲫⲗⲁⲅⲛⲟⲛ	ⲥⲫⲗⲁⲅⲛⲟⲛ
ⲥⲫⲟⲛⲅⲟⲥ	ⲥⲫⲟⲛⲅⲟⲥ
ⲥⲫⲟⲛⲇⲩⲗⲟⲥ	ⲥⲫⲟⲛⲇⲩⲗⲟⲥ
ⲥⲫⲣⲁⲅⲓⲍⲉ	ⲥⲫⲣⲁⲅⲓⲍⲉ
ⲥⲫⲣⲁⲅⲓⲥ	ⲥⲫⲣⲁⲅⲓⲥ
ⲥⲭⲉⲇⲟⲛ	ⲥⲭⲉⲇⲟⲛ
ⲥⲭⲏⲙⲁ	ⲥⲭⲏⲙⲁ
ⲥⲭⲓⲥⲙⲁ	ⲥⲭⲓⲥⲙⲁ
ⲥⲭⲟⲓⲛⲓⲟⲛ	ⲥⲭⲟⲓⲛⲓⲟⲛ
ⲥⲭⲟⲓⲛⲟⲥ	ⲥⲭⲟⲓⲛⲟⲥ
ⲥⲭⲟⲗⲁⲍⲉ	ⲥⲭⲟⲗⲁⲍⲉ
ⲥⲭⲟⲗⲁⲥⲧⲓⲕⲟⲥ	ⲥⲭⲟⲗⲁⲥⲧⲓⲕⲟⲥ
ⲥⲱⲇⲓⲟⲛ	ⲥⲱⲇⲓⲟⲛ
ⲥⲱⲙⲁⲧⲓⲍⲉ	ⲥⲱⲙⲁⲧⲓⲍⲉ
ⲥⲱⲙⲁⲧⲓⲕⲟⲛ	ⲥⲱⲙⲁⲧⲓⲕⲟⲛ
ⲥⲱⲙⲁⲧⲓⲕⲟⲥ	ⲥⲱⲙⲁⲧⲓⲕⲟⲥ
ⲥⲱⲙⲁ	ⲥⲱⲙⲁ
ⲥⲱⲧⲏⲣⲓⲁ	ⲥⲱⲧⲏⲣⲓⲁ
ⲥⲱⲧⲏⲣ	ⲥⲱⲧⲏⲣ
ⲧⲁϣⲉⲟⲉⲓϣ	ⲧⲁϣⲉ|ⲟⲉⲓϣ
ⲧⲁⲅⲙⲁ	ⲧⲁⲅⲙⲁ
ⲧⲁⲗⲁⲓⲡⲟⲣⲉⲓ	ⲧⲁⲗⲁⲓⲡⲟⲣⲉⲓ
ⲧⲁⲗⲁⲓⲡⲱⲣⲓⲁ	ⲧⲁⲗⲁⲓⲡⲱⲣⲓⲁ
ⲧⲁⲗⲁⲓⲡⲱⲣⲟⲥ	ⲧⲁⲗⲁⲓⲡⲱⲣⲟⲥ
ⲧⲁⲙⲉⲓⲟⲛ	ⲧⲁⲙⲉⲓⲟⲛ
ⲧⲁⲛⲓⲥⲧⲏⲥ	ⲧⲁⲛⲓⲥⲧⲏⲥ
ⲧⲁⲝⲓⲥ	ⲧⲁⲝⲓⲥ
ⲧⲁⲣⲁⲥⲥⲉ	ⲧⲁⲣⲁⲥⲥⲉ
ⲧⲁⲣⲁⲭⲏ	ⲧⲁⲣⲁⲭⲏ
ⲧⲁⲣⲁⲭⲟⲥ	ⲧⲁⲣⲁⲭⲟⲥ
ⲧⲁⲣⲓⲭⲓⲟⲛ	ⲧⲁⲣⲓⲭⲓⲟⲛ
ⲧⲁⲣⲙⲟⲥ	ⲧⲁⲣⲙⲟⲥ
ⲧⲁⲣⲧⲁⲣⲟⲛ	ⲧⲁⲣⲧⲁⲣⲟⲛ
ⲧⲁⲣⲧⲁⲣⲟⲥ	ⲧⲁⲣⲧⲁⲣⲟⲥ
ⲧⲁⲥⲥⲉ	ⲧⲁⲥⲥⲉ
ⲧⲁⲩⲉⲥϩⲃⲏⲓⲧⲉ	ⲧⲁⲩⲉ|ⲥϩⲃⲏⲓⲧⲉ
ⲧⲁⲩⲣⲟⲥ	ⲧⲁⲩⲣⲟⲥ
ⲧⲁⲫⲟⲥ	ⲧⲁⲫⲟⲥ
ⲧⲁⲭⲁ	ⲧⲁⲭⲁ
ⲧⲁⲭⲏ	ⲧⲁⲭⲏ
ⲧⲁⲭⲩ	ⲧⲁⲭⲩ
ⲧⲉϣⲡⲣⲉⲥⲃⲩⲧⲉⲣⲟⲥ	ⲧⲉϣ|ⲡⲣⲉⲥⲃⲩⲧⲉⲣⲟⲥ
ⲧⲉⲕⲁⲧⲏⲥ	ⲧⲉⲕⲁⲧⲏⲥ
ⲧⲉⲗⲉⲓⲁ	ⲧⲉⲗⲉⲓⲁ
ⲧⲉⲗⲉⲓⲟⲛ	ⲧⲉⲗⲉⲓⲟⲛ
ⲧⲉⲗⲉⲓⲟⲥ	ⲧⲉⲗⲉⲓⲟⲥ
ⲧⲉⲗⲉⲱⲥ	ⲧⲉⲗⲉⲱⲥ
ⲧⲉⲗⲓ	ⲧⲉⲗⲓ
ⲧⲉⲗⲟⲥ	ⲧⲉⲗⲟⲥ
ⲧⲉⲗⲱⲛⲏⲥ	ⲧⲉⲗⲱⲛⲏⲥ
ⲧⲉⲗⲱⲛⲓⲟⲛ	ⲧⲉⲗⲱⲛⲓⲟⲛ
ⲧⲉⲣⲉⲃⲓⲛⲑⲟⲥ	ⲧⲉⲣⲉⲃⲓⲛⲑⲟⲥ
ⲧⲉⲣⲯⲓⲥ	ⲧⲉⲣⲯⲓⲥ
ⲧⲉⲥⲉⲣⲁⲕⲟⲥⲧⲉ	ⲧⲉⲥⲉⲣⲁⲕⲟⲥⲧⲉ
ⲧⲉⲥⲥⲁⲣⲉⲥⲕⲁⲓⲇⲉⲕⲁⲧⲏ	ⲧⲉⲥⲥⲁⲣⲉⲥⲕⲁⲓⲇⲉⲕⲁⲧⲏ
ⲧⲉⲧⲁⲣⲧⲏⲥ	ⲧⲉⲧⲁⲣⲧⲏⲥ
ⲧⲉⲧⲁⲣⲧⲟⲛ	ⲧⲉⲧⲁⲣⲧⲟⲛ
ⲧⲉⲧⲣⲁⲅⲱⲛⲟⲛ	ⲧⲉⲧⲣⲁⲅⲱⲛⲟⲛ
ⲧⲉⲧⲣⲁⲡⲩⲗⲱⲛ	ⲧⲉⲧⲣⲁⲡⲩⲗⲱⲛ
ⲧⲉⲧⲣⲁⲣⲭⲏⲥ	ⲧⲉⲧⲣⲁⲣⲭⲏⲥ
ⲧⲉⲧⲣⲁⲥ	ⲧⲉⲧⲣⲁⲥ
ⲧⲉⲩⲧⲉⲣⲟⲛⲟⲙⲓⲟⲛ	ⲧⲉⲩⲧⲉⲣⲟⲛⲟⲙⲓⲟⲛ
ⲧⲉⲭⲛⲏ	ⲧⲉⲭⲛⲏ
ⲧⲉⲭⲛⲓⲧⲏⲥ	ⲧⲉⲭⲛⲓⲧⲏⲥ
ⲧⲉⲱⲥ	ⲧⲉⲱⲥ
ⲧⲏⲙⲟⲥ	ⲧⲏⲙⲟⲥ
ⲧⲏⲣⲉⲓ	ⲧⲏⲣⲉⲓ
ⲧⲏⲣⲓ	ⲧⲏⲣⲓ
ⲧⲓⲙⲁ	ⲧⲓⲙⲁ
ⲧⲓⲙⲏ	ⲧⲓⲙⲏ
ⲧⲓⲙⲓⲱⲧⲁⲧⲟⲥ	ⲧⲓⲙⲓⲱⲧⲁⲧⲟⲥ
ⲧⲓⲙⲓⲱⲧⲏⲥ	ⲧⲓⲙⲓⲱⲧⲏⲥ
ⲧⲓⲙⲱⲣⲉⲓ	ⲧⲓⲙⲱⲣⲉⲓ
ⲧⲓⲙⲱⲣⲓⲁ	ⲧⲓⲙⲱⲣⲓⲁ
ⲧⲓⲣⲱⲛ	ⲧⲓⲣⲱⲛ
ⲧⲓⲧⲗⲟⲥ	ⲧⲓⲧⲗⲟⲥ
ⲧⲟⲕⲙⲁⲇⲓⲕⲟⲥ	ⲧⲟⲕⲙⲁⲇⲓⲕⲟⲥ
ⲧⲟⲕⲙⲁⲧⲓⲕⲟⲛ	ⲧⲟⲕⲙⲁⲧⲓⲕⲟⲛ
ⲧⲟⲕⲝⲟⲧⲟⲥ	ⲧⲟⲕⲝⲟⲧⲟⲥ
ⲧⲟⲗⲉⲙⲟⲛ	ⲧⲟⲗⲉⲙⲟⲛ
ⲧⲟⲗⲙⲁ	ⲧⲟⲗⲙⲁ
ⲧⲟⲗⲙⲉⲥⲓⲁ	ⲧⲟⲗⲙⲉⲥⲓⲁ
ⲧⲟⲗⲙⲏⲣⲓⲁ	ⲧⲟⲗⲙⲏⲣⲓⲁ
ⲧⲟⲗⲙⲏⲣⲟⲥ	ⲧⲟⲗⲙⲏⲣⲟⲥ
ⲧⲟⲗⲟⲓⲡⲟⲛ	ⲧⲟⲗⲟⲓⲡⲟⲛ
ⲧⲟⲙⲁⲣⲓⲟⲛ	ⲧⲟⲙⲁⲣⲓⲟⲛ
ⲧⲟⲙⲉⲥⲧⲓⲕⲟⲥ	ⲧⲟⲙⲉⲥⲧⲓⲕⲟⲥ
ⲧⲟⲙⲟⲥ	ⲧⲟⲙⲟⲥ
ⲧⲟⲡⲁⲇⲓⲟⲛ	ⲧⲟⲡⲁⲇⲓⲟⲛ
ⲧⲟⲡⲟⲡⲓⲟⲥ	ⲧⲟⲡⲟⲡⲓⲟⲥ
ⲧⲟⲡⲟⲥ	ⲧⲟⲡⲟⲥ
ⲧⲟⲧⲉ	ⲧⲟⲧⲉ
ⲧⲟⲩⲛⲉⲓⲁⲧ	ⲧⲟⲩⲛ|ⲉⲓⲁⲧ
ⲧⲟ ⲧⲉⲱⲥ	ⲧⲟ ⲧⲉⲱⲥ
ⲧⲣⲁⲡⲉⲍⲁ	ⲧⲣⲁⲡⲉⲍⲁ
ⲧⲣⲓⲁⲥ	ⲧⲣⲓⲁⲥ
ⲧⲣⲓⲃⲏ	ⲧⲣⲓⲃⲏ
ⲧⲣⲓⲃⲟⲗⲗⲟⲥ	ⲧⲣⲓⲃⲟⲗⲗⲟⲥ
ⲧⲣⲓⲃⲟⲩⲛⲟⲥ	ⲧⲣⲓⲃⲟⲩⲛⲟⲥ
ⲧⲣⲓⲅⲉⲛⲉⲑⲗⲟⲥ	ⲧⲣⲓⲅⲉⲛⲉⲑⲗⲟⲥ
ⲧⲣⲓⲅⲉⲛⲏⲥ	ⲧⲣⲓⲅⲉⲛⲏⲥ
ⲧⲣⲓⲇⲩⲛⲁⲙⲓⲥ	ⲧⲣⲓⲇⲩⲛⲁⲙⲓⲥ
ⲧⲣⲓⲇⲩⲛⲁⲙⲟⲥ	ⲧⲣⲓⲇⲩⲛⲁⲙⲟⲥ
ⲧⲣⲓⲕⲟⲛ	ⲧⲣⲓⲕⲟⲛ
ⲧⲣⲓⲙⲏⲥⲓⲟⲛ	ⲧⲣⲓⲙⲏⲥⲓⲟⲛ
ⲧⲣⲓⲡⲟⲥ	ⲧⲣⲓⲡⲟⲥ
ⲧⲣⲓⲥϩⲁⲅⲓⲉ	ⲧⲣⲓⲥϩⲁⲅⲓⲉ
ⲧⲣⲓⲥⲁⲣⲥⲏⲥ	ⲧⲣⲓⲥⲁⲣⲥⲏⲥ
ⲧⲣⲓⲥⲙⲁⲕⲁⲣⲓⲟⲥ	ⲧⲣⲓⲥⲙⲁⲕⲁⲣⲓⲟⲥ
ⲧⲣⲓⲥⲙⲉⲅⲓⲥⲧⲉ	ⲧⲣⲓⲥⲙⲉⲅⲓⲥⲧⲉ
ⲧⲣⲓⲥⲙⲉⲅⲓⲥⲧⲟⲥ	ⲧⲣⲓⲥⲙⲉⲅⲓⲥⲧⲟⲥ
ⲧⲣⲓⲧⲏⲥ	ⲧⲣⲓⲧⲏⲥ
ⲧⲣⲓⲧⲟⲛ	ⲧⲣⲓⲧⲟⲛ
ⲧⲣⲟⲡⲉⲟⲛ	ⲧⲣⲟⲡⲉⲟⲛ
ⲧⲣⲟⲡⲟⲥ	ⲧⲣⲟⲡⲟⲥ
ⲧⲣⲟⲫⲏ	ⲧⲣⲟⲫⲏ
ⲧⲣⲟⲭⲟⲥ	ⲧⲣⲟⲭⲟⲥ
ⲧⲣⲩⲫⲁ	ⲧⲣⲩⲫⲁ
ⲧⲣⲩⲫⲏ	ⲧⲣⲩⲫⲏ
ⲧⲣⲩⲫⲩⲣⲓⲟⲛ	ⲧⲣⲩⲫⲩⲣⲓⲟⲛ
ⲧⲩⲡⲟⲥ	ⲧⲩⲡⲟⲥ
ⲧⲩⲡⲟⲩ	ⲧⲩⲡⲟⲩ
ⲧⲩⲣⲁⲛⲛⲟⲥ	ⲧⲩⲣⲁⲛⲛⲟⲥ
ⲧⲩⲫⲱⲛ	ⲧⲩⲫⲱⲛ
ⲧⲩⲭⲏ	ⲧⲩⲭⲏ
ⲧⲱⲇⲓⲕⲁⲓⲧⲏⲥ	ⲧⲱⲇⲓⲕⲁⲓⲧⲏⲥ
ⲧⲱⲕⲓⲙⲁⲥⲓⲁ	ⲧⲱⲕⲓⲙⲁⲥⲓⲁ
ⲩⲃⲣⲓⲥ	ⲩⲃⲣⲓⲥ
ⲩⲓⲟⲥ	ⲩⲓⲟⲥ
ⲩⲡⲟⲭⲟⲛⲇⲣⲓⲟⲥ	ⲩⲡⲟⲭⲟⲛⲇⲣⲓⲟⲥ
ⲫⲁⲕⲓⲁⲣⲓⲟⲛ	ⲫⲁⲕⲓⲁⲣⲓⲟⲛ
ⲫⲁⲛⲉⲣⲓⲟⲥ	ⲫⲁⲛⲉⲣⲓⲟⲥ
ⲫⲁⲛⲉⲣⲟⲛ	ⲫⲁⲛⲉⲣⲟⲛ
ⲫⲁⲛⲉⲣⲟⲩ	ⲫⲁⲛⲉⲣⲟⲩ
ⲫⲁⲛⲉⲣⲱⲥⲓⲥ	ⲫⲁⲛⲉⲣⲱⲥⲓⲥ
ⲫⲁⲛⲓⲁ	ⲫⲁⲛⲓⲁ
ⲫⲁⲛⲟⲥ	ⲫⲁⲛⲟⲥ
ⲫⲁⲛⲧⲁⲥⲓⲁ	ⲫⲁⲛⲧⲁⲥⲓⲁ
ⲫⲁⲛⲧⲁⲥⲙⲁ	ⲫⲁⲛⲧⲁⲥⲙⲁ
ⲫⲁⲣⲁⲅⲝ	ⲫⲁⲣⲁⲅⲝ
ⲫⲁⲣⲓⲥⲁⲓⲟⲥ	ⲫⲁⲣⲓⲥⲁⲓⲟⲥ
ⲫⲁⲣⲙⲁⲅⲟⲛ	ⲫⲁⲣⲙⲁⲅⲟⲛ
ⲫⲁⲣⲙⲁⲅⲟⲥ	ⲫⲁⲣⲙⲁⲅⲟⲥ
ⲫⲁⲣⲙⲁⲕⲓⲁ	ⲫⲁⲣⲙⲁⲕⲓⲁ
ⲫⲁⲥⲓⲥ	ⲫⲁⲥⲓⲥ
ⲫⲁⲩⲗⲟⲥ	ⲫⲁⲩⲗⲟⲥ
ⲫⲉⲅⲅⲟⲕⲁⲧⲟⲭⲟⲥ	ⲫⲉⲅⲅⲟⲕⲁⲧⲟⲭⲟⲥ
ⲫⲉⲙⲁⲛⲁⲣⲓⲟⲛ	ⲫⲉⲙⲁⲛⲁⲣⲓⲟⲛ
ⲫⲉⲛⲉⲥⲑⲁⲓ	ⲫⲉⲛⲉⲥⲑⲁⲓ
ⲫⲉⲣⲉⲍⲁⲓⲟⲥ	ⲫⲉⲣⲉⲍⲁⲓⲟⲥ
ⲫⲉⲥⲏⲥ	ⲫⲉⲥⲏⲥ
ⲫⲑⲟⲛⲉⲓ	ⲫⲑⲟⲛⲉⲓ
ⲫⲑⲟⲛⲏⲣⲓⲁ	ⲫⲑⲟⲛⲏⲣⲓⲁ
ⲫⲑⲟⲛⲓ	ⲫⲑⲟⲛⲓ
ⲫⲑⲟⲛⲟⲥ	ⲫⲑⲟⲛⲟⲥ
ⲫⲓⲁⲗⲏ	ⲫⲓⲁⲗⲏ
ⲫⲓⲗⲉⲥⲧⲁⲧⲟⲥ	ⲫⲓⲗⲉⲥⲧⲁⲧⲟⲥ
ⲫⲓⲗⲓⲕⲣⲓⲛⲏⲥ	ⲫⲓⲗⲓⲕⲣⲓⲛⲏⲥ
ⲫⲓⲗⲟⲇⲱⲛⲓ̈ⲁ	ⲫⲓⲗⲟⲇⲱⲛⲓ̈ⲁ
ⲫⲓⲗⲟⲕⲁⲗⲉⲓ	ⲫⲓⲗⲟⲕⲁⲗⲉⲓ
ⲫⲓⲗⲟⲕⲁⲗⲓⲁ	ⲫⲓⲗⲟⲕⲁⲗⲓⲁ
ⲫⲓⲗⲟⲛⲓⲕⲏ	ⲫⲓⲗⲟⲛⲓⲕⲏ
ⲫⲓⲗⲟⲥⲟⲫⲓⲁ	ⲫⲓⲗⲟⲥⲟⲫⲓⲁ
ⲫⲗⲉⲯ	ⲫⲗⲉⲯ
ⲫⲗⲩⲁⲣⲟⲥ	ⲫⲗⲩⲁⲣⲟⲥ
ⲫⲟⲃⲟⲥ	ⲫⲟⲃⲟⲥ
ⲫⲟⲓⲛⲓⲝ	ⲫⲟⲓⲛⲓⲝ
ⲫⲟⲛⲉⲩⲥ	ⲫⲟⲛⲉⲩⲥ
ⲫⲟⲛⲟⲥ	ⲫⲟⲛⲟⲥ
ⲫⲟⲣⲉⲓ	ⲫⲟⲣⲉⲓ
ⲫⲟⲣⲟⲥ	ⲫⲟⲣⲟⲥ
ⲫⲣⲁⲅⲉⲗⲗⲓⲟⲛ	ⲫⲣⲁⲅⲉⲗⲗⲓⲟⲛ
ⲫⲣⲁⲅⲉⲗⲗⲟⲩ	ⲫⲣⲁⲅⲉⲗⲗⲟⲩ
ⲫⲣⲁⲅⲙⲟⲥ	ⲫⲣⲁⲅⲙⲟⲥ
ⲫⲣⲁⲥⲓⲥ	ⲫⲣⲁⲥⲓⲥ
ⲫⲣⲟⲛⲏⲥⲓⲥ	ⲫⲣⲟⲛⲏⲥⲓⲥ
ⲫⲩⲗⲁⲅⲙⲁ	ⲫⲩⲗⲁⲅⲙⲁ
ⲫⲩⲗⲁⲕⲏ	ⲫⲩⲗⲁⲕⲏ
ⲫⲩⲗⲁⲕⲧⲏⲣⲓⲟⲛ	ⲫⲩⲗⲁⲕⲧⲏⲣⲓⲟⲛ
ⲫⲩⲗⲁⲝ	ⲫⲩⲗⲁⲝ
ⲫⲩⲗⲏ	ⲫⲩⲗⲏ
ⲫⲩⲗⲟⲡⲟⲛⲟⲥ	ⲫⲩⲗⲟⲡⲟⲛⲟⲥ
ⲫⲩⲥⲉⲓ	ⲫⲩⲥⲉⲓ
ⲫⲩⲥⲉⲱⲥ	ⲫⲩⲥⲉⲱⲥ
ⲫⲩⲥⲓⲕⲟⲛ	ⲫⲩⲥⲓⲕⲟⲛ
ⲫⲩⲥⲓⲥ	ⲫⲩⲥⲓⲥ
ⲫⲱⲛⲏ	ⲫⲱⲛⲏ
ⲫⲱⲣⲓⲥⲙⲁ	ⲫⲱⲣⲓⲥⲙⲁ
ⲫⲱⲥⲧⲏⲣ	ⲫⲱⲥⲧⲏⲣ
ⲫⲱⲥⲫⲟⲣ̣ⲟⲥ	ⲫⲱⲥⲫⲟⲣ̣ⲟⲥ
ⲭⲁⲓⲣⲉⲓⲛ	ⲭⲁⲓⲣⲉⲓⲛ
ⲭⲁⲓⲣⲉⲧⲉ	ⲭⲁⲓⲣⲉⲧⲉ
ⲭⲁⲓⲣⲉ	ⲭⲁⲓⲣⲉ
ⲭⲁⲗⲁⲍⲁ	ⲭⲁⲗⲁⲍⲁ
ⲭⲁⲗⲁ	ⲭⲁⲗⲁ
ⲭⲁⲗⲃⲁⲛⲏ	ⲭⲁⲗⲃⲁⲛⲏ
ⲭⲁⲗⲇⲁⲓⲟⲥ	ⲭⲁⲗⲇⲁⲓⲟⲥ
ⲭⲁⲗⲓⲛⲟⲥ	ⲭⲁⲗⲓⲛⲟⲥ
ⲭⲁⲗⲓⲛⲟⲩ	ⲭⲁⲗⲓⲛⲟⲩ
ⲭⲁⲗⲕⲓⲟⲛ	ⲭⲁⲗⲕⲓⲟⲛ
ⲭⲁⲙⲁⲓⲗⲉⲱⲛ	ⲭⲁⲙⲁⲓⲗⲉⲱⲛ
ⲭⲁⲙⲱⲥ	ⲭⲁⲙⲱⲥ
ⲭⲁⲛⲁⲛⲁⲓⲟⲥ	ⲭⲁⲛⲁⲛⲁⲓⲟⲥ
ⲭⲁⲛⲁⲛⲓⲧⲓⲥ	ⲭⲁⲛⲁⲛⲓⲧⲓⲥ
ⲭⲁⲟⲥ	ⲭⲁⲟⲥ
ⲭⲁⲣⲁⲕⲧⲏⲣ	ⲭⲁⲣⲁⲕⲧⲏⲣ
ⲭⲁⲣⲓⲍⲉⲥⲑⲉ	ⲭⲁⲣⲓⲍⲉⲥⲑⲉ
ⲭⲁⲣⲓⲍⲉ	ⲭⲁⲣⲓⲍⲉ
ⲭⲁⲣⲓⲥⲙⲁ	ⲭⲁⲣⲓⲥⲙⲁ
ⲭⲁⲣⲓⲥ	ⲭⲁⲣⲓⲥ
ⲭⲁⲣⲓⲧⲥⲱⲛ	ⲭⲁⲣⲓⲧⲥⲱⲛ
ⲭⲁⲣⲧⲏⲥ	ⲭⲁⲣⲧⲏⲥ
ⲭⲉⲓⲙⲁⲣⲣⲟⲥ	ⲭⲉⲓⲙⲁⲣⲣⲟⲥ
ⲭⲉⲓⲣⲟⲅⲣⲁⲫⲟⲛ	ⲭⲉⲓⲣⲟⲅⲣⲁⲫⲟⲛ
ⲭⲉⲓⲣⲟⲧⲟⲛⲉⲓ	ⲭⲉⲓⲣⲟⲧⲟⲛⲉⲓ
ⲭⲉⲓⲣⲟⲧⲟⲛⲓⲁ	ⲭⲉⲓⲣⲟⲧⲟⲛⲓⲁ
ⲭⲉⲣⲟⲩⲃⲓⲛ	ⲭⲉⲣⲟⲩⲃⲓⲛ
ⲭⲉⲧⲧⲁⲓⲟⲥ	ⲭⲉⲧⲧⲁⲓⲟⲥ
ⲭⲏⲣⲁ	ⲭⲏⲣⲁ
ⲭⲏⲣⲉⲩⲉ	ⲭⲏⲣⲉⲩⲉ
ⲭⲓⲗⲓⲁⲣⲭⲟⲥ	ⲭⲓⲗⲓⲁⲣⲭⲟⲥ
ⲭⲓⲙⲁⲣⲣⲁⲓⲥ	ⲭⲓⲙⲁⲣⲣⲁⲓⲥ
ⲭⲓⲙⲱⲛ	ⲭⲓⲙⲱⲛ
ⲭⲓⲱⲛ	ⲭⲓⲱⲛ
ⲭⲗⲁⲙⲩⲥ	ⲭⲗⲁⲙⲩⲥ
ⲭⲟⲓⲕⲟⲥ	ⲭⲟⲓⲕⲟⲥ
ⲭⲟⲓⲣⲟⲅⲩⲗⲓⲟⲛ	ⲭⲟⲓⲣⲟⲅⲩⲗⲓⲟⲛ
ⲭⲟⲗⲏ	ⲭⲟⲗⲏ
ⲭⲟⲛⲉⲩⲧⲟⲛ	ⲭⲟⲛⲉⲩⲧⲟⲛ
ⲭⲟⲣⲇⲏ	ⲭⲟⲣⲇⲏ
ⲭⲟⲣⲉⲕⲓ	ⲭⲟⲣⲉⲕⲓ
ⲭⲟⲣⲉⲩⲉ	ⲭⲟⲣⲉⲩⲉ
ⲭⲟⲣⲏⲅⲓⲁ	ⲭⲟⲣⲏⲅⲓⲁ
ⲭⲟⲣⲏⲙⲁ	ⲭⲟⲣⲏⲙⲁ
ⲭⲟⲣⲓⲟⲛ	ⲭⲟⲣⲓⲟⲛ
ⲭⲟⲣⲟⲥ	ⲭⲟⲣⲟⲥ
ⲭⲟⲣⲧⲟⲥ	ⲭⲟⲣⲧⲟⲥ
ⲭⲟⲣⲩⲙⲁ	ⲭⲟⲣⲩⲙⲁ
ⲭⲟⲩⲥ	ⲭⲟⲩⲥ
ⲭⲣⲁⲓⲟⲥ	ⲭⲣⲁⲓⲟⲥ
ⲭⲣⲁⲥⲑⲁⲓ	ⲭⲣⲁⲥⲑⲁⲓ
ⲭⲣⲉⲓⲁ	ⲭⲣⲉⲓⲁ
ⲭⲣⲉⲱⲥⲧⲉⲓ	ⲭⲣⲉⲱⲥⲧⲉⲓ
ⲭⲣⲉⲱⲥⲧⲓⲕⲟⲛ	ⲭⲣⲉⲱⲥⲧⲓⲕⲟⲛ
ⲭⲣⲏⲙⲁⲧⲓⲍⲉ	ⲭⲣⲏⲙⲁⲧⲓⲍⲉ
ⲭⲣⲏⲙⲁ	ⲭⲣⲏⲙⲁ
ⲭⲣⲏⲥⲙⲟⲥ	ⲭⲣⲏⲥⲙⲟⲥ
ⲭⲣⲏⲥⲧⲏⲣⲓⲟⲛ	ⲭⲣⲏⲥⲧⲏⲣⲓⲟⲛ
ⲭⲣⲏⲥⲧⲟⲥ	ⲭⲣⲏⲥⲧⲟⲥ
ⲭⲣⲓⲥⲓⲙⲱⲛ	ⲭⲣⲓⲥⲓⲙⲱⲛ
ⲭⲣⲓⲥⲙⲁ	ⲭⲣⲓⲥⲙⲁ
ⲭⲣⲓⲥⲧⲓⲁⲛⲟⲥ	ⲭⲣⲓⲥⲧⲓⲁⲛⲟⲥ
ⲭⲣⲓⲥⲧⲟⲥ	ⲭⲣⲓⲥⲧⲟⲥ
ⲭⲣⲟⲛⲟⲥ	ⲭⲣⲟⲛⲟⲥ
ⲭⲣⲩⲥⲟⲗⲓⲛⲑⲟⲥ	ⲭⲣⲩⲥⲟⲗⲓⲛⲑⲟⲥ
ⲭⲣⲩⲥⲟⲡⲗⲁⲥⲱⲥ	ⲭⲣⲩⲥⲟⲡⲗⲁⲥⲱⲥ
ⲭⲣⲱ	ⲭⲣⲱ
ⲭⲱⲣⲁ	ⲭⲱⲣⲁ
ⲭⲱⲣⲉⲩⲉ	ⲭⲱⲣⲉⲩⲉ
ⲭⲱⲣⲏⲅⲉⲓ	ⲭⲱⲣⲏⲅⲉⲓ
ⲭⲱⲣⲓⲛ	ⲭⲱⲣⲓⲛ
ⲭⲱⲣⲓⲟⲛ	ⲭⲱⲣⲓⲟⲛ
ⲭⲱⲣⲓⲥ	ⲭⲱⲣⲓⲥ
ⲭⲱⲣⲓ	ⲭⲱⲣⲓ
ⲯⲁⲗⲗⲉⲓ	ⲯⲁⲗⲗⲉⲓ
ⲯⲁⲗⲗⲏ	ⲯⲁⲗⲗⲏ
ⲯⲁⲗⲗⲓ	ⲯⲁⲗⲗⲓ
ⲯⲁⲗⲙⲟⲥ	ⲯⲁⲗⲙⲟⲥ
ⲯⲁⲗⲙⲱⲇⲓⲁ	ⲯⲁⲗⲙⲱⲇⲓⲁ
ⲯⲁⲗⲙⲱⲇⲟⲥ	ⲯⲁⲗⲙⲱⲇⲟⲥ
ⲯⲁⲗⲧⲏⲣⲓⲟⲛ	ⲯⲁⲗⲧⲏⲣⲓⲟⲛ
ⲯⲁⲗⲧⲏⲥ	ⲯⲁⲗⲧⲏⲥ
ⲯⲉⲩⲇⲟⲡⲣⲟⲫⲏⲧⲏⲥ	ⲯⲉⲩⲇⲟⲡⲣⲟⲫⲏⲧⲏⲥ
ⲯⲉⲩⲇⲟⲭⲣⲓⲥⲧⲟⲥ	ⲯⲉⲩⲇⲟⲭⲣⲓⲥⲧⲟⲥ
ⲯⲏⲫⲟⲥ	ⲯⲏⲫⲟⲥ
ⲯⲓⲕⲟⲥⲧⲁⲧⲏⲥ	ⲯⲓⲕⲟⲥⲧⲁⲧⲏⲥ
ⲯⲩⲫⲓⲥⲙⲁ	ⲯⲩⲫⲓⲥⲙⲁ
ⲯⲩⲭⲏ	ⲯⲩⲭⲏ
ⲯⲩⲭⲓⲕⲏ	ⲯⲩⲭⲓⲕⲏ
ⲯⲩⲭⲓⲕⲟⲛ	ⲯⲩⲭⲓⲕⲟⲛ
ⲯⲩⲭⲓⲕⲟⲥ	ⲯⲩⲭⲓⲕⲟⲥ
ⲯⲩⲭⲟⲟⲩⲉ	ⲯⲩⲭⲟⲟⲩⲉ
ⲱⲇⲏ	ⲱⲇⲏ
ⲱⲕⲉⲁⲛⲟⲥ	ⲱⲕⲉⲁⲛⲟⲥ
ⲱⲕⲛⲉⲓ	ⲱⲕⲛⲉⲓ
ⲱⲙⲟⲫⲟⲣⲟⲥ	ⲱⲙⲟⲫⲟⲣⲟⲥ
ⲱⲛⲏ	ⲱⲛⲏ
ⲱⲫⲉⲗⲉⲓ	ⲱⲫⲉⲗⲉⲓ
ⲱⲫⲉⲗⲓⲁ	ⲱⲫⲉⲗⲓⲁ
ⲱⲫⲓⲕⲓⲟⲛ	ⲱⲫⲓⲕⲓⲟⲛ
