ⲙⲛⲛⲁⲛⲥⲙⲙⲉ	ⲙⲛ|ⲛⲁ|ⲛ|ⲥⲙⲙⲉ
ϩⲓϭⲓⲛⲟⲩⲱⲙ	ϩⲓ|ϭⲓⲛ|ⲟⲩⲱⲙ
ⲛϩⲙⲟⲟⲥ	ⲛ|ϩⲙⲟⲟⲥ
ⲙⲛⲛⲉϥⲁⲛⲟⲙⲓⲁ	ⲙⲛ|ⲛⲉϥ|ⲁⲛⲟⲙⲓⲁ
ⲙⲛⲧϩⲃⲥⲱ	ⲙⲛ|ⲧ|ϩⲃⲥⲱ
ⲙⲡⲉⲭⲣⲓⲥⲧⲟⲥ	ⲙ|ⲡⲉ|ⲭⲣⲓⲥⲧⲟⲥ
ⲙⲡⲙⲁⲥⲉ	ⲙ|ⲡ|ⲙⲁⲥⲉ
ⲛϣⲁⲉⲓ	ⲛ|ϣⲁⲉⲓ
ⲙⲛⲟⲩⲟⲛ	ⲙⲛ|ⲟⲩⲟⲛ
ⲛⲧⲁⲡⲛⲟⲩⲧⲉ	ⲛⲧ|ⲁ|ⲡ|ⲛⲟⲩⲧⲉ
ⲟⲩϭⲱⲗⲡ	ⲟⲩ|ϭⲱⲗⲡ
ⲛⲃⲟⲏⲑⲟⲥ	ⲛ|ⲃⲟⲏⲑⲟⲥ
ⲉⲟⲩⲁϩϥ	ⲉ|ⲟⲩⲁϩ|ϥ
ϫⲉϥⲟⲛϩ	ϫⲉ|ϥ|ⲟⲛϩ
ϣⲁϥⲛⲡⲟϩⲥ	ϣⲁ|ϥ|ⲛ|ⲡⲟϩⲥ
ⲓⲱⲥⲏⲫ	ⲓⲱⲥⲏⲫ
ϣⲁⲛⲧⲓⲕⲱ	ϣⲁⲛⲧ|ⲓ|ⲕⲱ
ϫⲉⲉⲧⲉⲧⲛⲟ	ϫⲉ|ⲉ|ⲧⲉⲧⲛ|ⲟ
ϩⲛⲟⲩⲥⲣⲁϩⲧ	ϩⲛ|ⲟⲩ|ⲥⲣⲁϩⲧ
ϫⲉⲧⲓⲟⲩ	ϫⲉ|ⲧⲓⲟⲩ
ⲉⲡⲙⲛⲧⲥⲛⲟⲟⲩⲥ	ⲉ|ⲡ|ⲙⲛⲧⲥⲛⲟⲟⲩⲥ
ϩⲛⲟⲩⲟⲣⲅⲏ	ϩⲛ|ⲟⲩ|ⲟⲣⲅⲏ
ⲙⲛⲛⲉⲧⲏⲡ	ⲙⲛ|ⲛ|ⲉⲧ|ⲏⲡ
ⲛⲉⲩⲟⲩⲱϣ	ⲛⲉⲩ|ⲟⲩⲱϣ
ⲛⲧⲛⲧⲟⲟⲩ	ⲛ|ⲧⲛ|ⲧⲟⲟⲩ
ϫⲓⲛⲛϣⲟⲣⲡ	ϫⲓⲛ|ⲛ|ϣⲟⲣⲡ
ⲛⲟⲩϩⲛⲟ	ⲛ|ⲟⲩ|ϩⲛⲟ
ⲡⲉⲧⲛⲁϥⲓⲡ	ⲡ|ⲉⲧ|ⲛⲁ|ϥⲓ|ⲡ
ⲉⲛⲥⲟⲟⲩⲛ	ⲉ|ⲛ|ⲥⲟⲟⲩⲛ
ⲉⲩⲟⲩⲛⲣⲟ	ⲉ|ⲩ|ⲟⲩⲛⲣⲟ
ⲛⲗⲓⲧⲟⲩⲣⲅⲓⲁ	ⲛ|ⲗⲓⲧⲟⲩⲣⲅⲓⲁ
ⲛⲉⲧϩⲏⲡ	ⲛ|ⲉⲧ|ϩⲏⲡ
ⲉⲓⲙⲏⲧⲓ	ⲉⲓⲙⲏⲧⲓ
ϫⲉϯⲛⲁⲙⲟⲩⲧⲉ	ϫⲉ|ϯ|ⲛⲁ|ⲙⲟⲩⲧⲉ
ϩⲛⲛⲉⲩϩⲏⲧ	ϩⲛ|ⲛⲉⲩ|ϩⲏⲧ
ⲟⲩⲙⲛⲧϭⲱⲃ	ⲟⲩ|ⲙⲛⲧ|ϭⲱⲃ
ϩⲛⲡⲉϩⲟⲟⲩ	ϩⲛ|ⲡⲉ|ϩⲟⲟⲩ
ϫⲉⲛⲉⲧⲧⲁϩⲉ	ϫⲉ|ⲛ|ⲉⲧ|ⲧⲁϩⲉ
ⲛⲥⲁⲟⲩ	ⲛⲥⲁ|ⲟⲩ
ⲡⲉϫⲁⲩ	ⲡⲉϫⲁ|ⲩ
ⲙⲡⲉⲧⲛⲁⲛⲟⲩϥ	ⲙ|ⲡ|ⲉⲧ|ⲛⲁⲛⲟⲩ|ϥ
ⲉⲩϫⲓⲟⲩⲁ	ⲉ|ⲩ|ϫⲓⲟⲩⲁ
ϩⲛϩⲣⲉⲃⲉⲕⲕⲁ	ϩⲛ|ϩⲣⲉⲃⲉⲕⲕⲁ
ⲛⲟⲩⲁ	ⲛ|ⲟⲩⲁ
ⲉⲧⲉⲧⲛⲉϫⲱ	ⲉ|ⲧⲉⲧⲛ|ⲉ|ϫⲱ
ⲥⲱⲧⲙ	ⲥⲱⲧⲙ
ⲧⲉⲛⲡⲓⲥⲧⲓⲥ	ⲧⲉ|ⲛ|ⲡⲓⲥⲧⲓⲥ
ϫⲉⲁⲩⲣϩⲛⲁⲩ	ϫⲉ|ⲁ|ⲩ|ⲣ|ϩⲛⲁⲩ
ⲉⲫⲟⲣⲉⲓ	ⲉ|ⲫⲟⲣⲉⲓ
ⲉⲩϯⲧⲱⲛ	ⲉ|ⲩ|ϯ|ⲧⲱⲛ
ϩⲛⲟⲩϯⲧⲱⲛ	ϩⲛ|ⲟⲩ|ϯ|ⲧⲱⲛ
ⲙⲡⲣⲣⲟ	ⲙ|ⲡ|ⲣⲣⲟ
ⲧⲉⲧⲛϣⲧⲣⲧⲱⲣ	ⲧⲉⲧⲛ|ϣⲧⲣⲧⲱⲣ
ϫⲉⲥⲉⲟϣ	ϫⲉ|ⲥⲉ|ⲟϣ
ⲛϭⲓⲟⲩⲁ	ⲛϭⲓ|ⲟⲩⲁ
ⲧⲁⲕⲟ	ⲧⲁⲕⲟ
ⲛⲟⲩⲥⲟⲟⲛⲉ	ⲛ|ⲟⲩ|ⲥⲟⲟⲛⲉ
ⲛⲉⲥϩⲛϣⲁϫⲉ	ⲛ|ⲉ|ⲥ|ϩⲛ|ϣⲁϫⲉ
ⲙⲛⲧϫⲱⲱⲣⲉ	ⲙⲛⲧϫⲱⲱⲣⲉ
ⲉϥⲧⲁϫⲣⲟ	ⲉ|ϥ|ⲧⲁϫⲣⲟ
ⲛⲧⲁϥϫⲉ	ⲛⲧ|ⲁ|ϥ|ϫⲉ
ⲅⲣⲁⲫⲏ	ⲅⲣⲁⲫⲏ
ⲙⲛⲟⲩⲡⲛⲉⲩⲙⲁ	ⲙⲛ|ⲟⲩ|ⲡⲛⲉⲩⲙⲁ
ⲁϥϫⲓϩⲓⲙⲉ	ⲁ|ϥ|ϫⲓϩⲓⲙⲉ
ⲙⲙⲁ	ⲙ|ⲙⲁ
ⲉϥⲧⲙⲙⲟⲩⲣ	ⲉ|ϥ|ⲧⲙⲙⲟⲩⲣ
ϫⲉⲙⲡⲟⲩⲥⲣϥⲉ	ϫⲉ|ⲙⲡ|ⲟⲩ|ⲥⲣϥⲉ
ⲉⲙⲁⲧⲉ	ⲉⲙⲁⲧⲉ
ⲛϭⲓⲡⲉⲧⲛⲁⲡⲁⲣⲁⲇⲓⲇⲟⲩ	ⲛϭⲓ|ⲡ|ⲉⲧ|ⲛⲁ|ⲡⲁⲣⲁⲇⲓⲇⲟⲩ
ⲉϥⲉⲣⲟⲉⲓⲥ	ⲉ|ϥ|ⲉ|ⲣⲟⲉⲓⲥ
ϩⲛⲧⲉϥⲙⲛⲧϩⲗⲗⲟ	ϩⲛ|ⲧⲉϥ|ⲙⲛⲧϩⲗⲗⲟ
ⲛⲥⲉϫⲓⲧⲏⲩⲧⲛ	ⲛ|ⲥⲉ|ϫⲓ|ⲧⲏⲩⲧⲛ
ⲙⲡⲏⲩⲉ	ⲙ|ⲡⲏⲩⲉ
ⲛⲉϥⲧⲙⲁⲓⲟ	ⲛⲉ|ϥ|ⲧⲙⲁⲓⲟ
ⲛϭⲓⲟⲩⲣⲱⲙⲉ	ⲛϭⲓ|ⲟⲩ|ⲣⲱⲙⲉ
ⲉⲣⲉⲡϫⲟⲉⲓⲥ	ⲉⲣⲉ|ⲡ|ϫⲟⲉⲓⲥ
ⲙⲛⲛⲥⲱⲟⲩ	ⲙⲛⲛⲥⲱ|ⲟⲩ
ϩⲛⲟⲩⲕⲗⲟⲟⲗⲉ	ϩⲛ|ⲟⲩ|ⲕⲗⲟⲟⲗⲉ
ϯϩⲟⲙⲟⲗⲟⲅⲉⲓ	ϯ|ϩⲟⲙⲟⲗⲟⲅⲉⲓ
ϫⲉⲁⲩϯ	ϫⲉ|ⲁ|ⲩ|ϯ
ⲛⲕⲁⲧⲁⲛⲉⲅⲣⲁⲫⲏ	ⲛ|ⲕⲁⲧⲁ|ⲛⲉ|ⲅⲣⲁⲫⲏ
ϩⲓⲧⲙⲡⲉⲡⲛⲉⲩⲙⲁ	ϩⲓⲧⲙ|ⲡⲉ|ⲡⲛⲉⲩⲙⲁ
ⲉϣⲁϫⲉ	ⲉ|ϣⲁϫⲉ
ϩⲱⲱⲧ	ϩⲱⲱ|ⲧ
ⲛⲧⲁϥⲧⲱⲟⲩⲛ	ⲛⲧ|ⲁ|ϥ|ⲧⲱⲟⲩⲛ
ⲥⲉⲛⲁⲡⲗⲁⲛⲁ	ⲥⲉ|ⲛⲁ|ⲡⲗⲁⲛⲁ
ϭⲱ	ϭⲱ
ⲁϥϥⲓⲁⲧϥ	ⲁ|ϥ|ϥⲓ|ⲁⲧ|ϥ
ϣⲁⲛⲧⲉⲧⲛⲉⲓ	ϣⲁⲛⲧⲉ|ⲧⲛ|ⲉⲓ
ϫⲉⲧⲉⲧⲛⲟⲩⲱϣ	ϫⲉ|ⲧⲉⲧⲛ|ⲟⲩⲱϣ
ϩⲉⲛϭⲟⲗ	ϩⲉⲛ|ϭⲟⲗ
ⲙⲁⲣⲉⲡⲟⲩⲁ	ⲙⲁⲣⲉ|ⲡ|ⲟⲩⲁ
ⲙⲡⲉⲩϩⲏⲧ	ⲙ|ⲡⲉⲩ|ϩⲏⲧ
ϩⲙⲡⲙⲉϩϥⲧⲟⲟⲩ	ϩⲙ|ⲡ|ⲙⲉϩϥⲧⲟⲟⲩ
ⲙⲡⲓⲥⲧⲟⲥ	ⲙ|ⲡⲓⲥⲧⲟⲥ
ⲁϩⲁϩⲛⲧⲉⲗⲱⲛⲏⲥ	ⲁ|ϩⲁϩ|ⲛ|ⲧⲉⲗⲱⲛⲏⲥ
ⲛⲧⲁϥϫⲓ	ⲛⲧ|ⲁ|ϥ|ϫⲓ
ⲉⲣⲉⲡⲉⲥⲛⲟϥ	ⲉⲣⲉ|ⲡⲉ|ⲥⲛⲟϥ
ⲉⲣϣⲁⲛⲡⲥⲟⲛ	ⲉⲣϣⲁⲛ|ⲡ|ⲥⲟⲛ
ⲉⲧⲙⲧⲣⲉⲕⲟⲩⲱⲧⲛ	ⲉ|ⲧⲙ|ⲧⲣⲉ|ⲕ|ⲟⲩⲱⲧⲛ
ⲧⲡⲁⲣⲑⲉⲛⲟⲥ	ⲧ|ⲡⲁⲣⲑⲉⲛⲟⲥ
ⲉⲛⲉⲉⲓⲙⲉ	ⲉ|ⲛ|ⲉ|ⲉⲓⲙⲉ
ⲉⲣⲉⲡⲥⲁⲧⲁⲛⲁⲥ	ⲉⲣⲉ|ⲡ|ⲥⲁⲧⲁⲛⲁⲥ
ϫⲉⲉⲕⲏⲡ	ϫⲉ|ⲉ|ⲕ|ⲏⲡ
ϩⲓϫⲙⲡⲡⲓⲛⲁⲝ	ϩⲓϫⲙ|ⲡ|ⲡⲓⲛⲁⲝ
ⲛⲉⲓⲧⲙⲁⲓⲏⲩ	ⲛ|ⲉ|ⲓ|ⲧⲙⲁⲓⲏⲩ
ⲡⲉⲧⲡⲱⲣϫ	ⲡ|ⲉⲧ|ⲡⲱⲣϫ
ⲉϫⲟⲟϥ	ⲉ|ϫⲟⲟ|ϥ
ⲕⲣⲓⲛⲉ	ⲕⲣⲓⲛⲉ
ⲕⲁⲧⲁⲧⲉⲩϩⲓⲕⲱⲛ	ⲕⲁⲧⲁ|ⲧⲉ|ⲩ|ϩⲓⲕⲱⲛ
ⲛⲁⲟⲩⲟⲛϩϥ	ⲛⲁ|ⲟⲩ|ⲟⲛϩ|ϥ
ⲛⲧⲉⲭⲗⲁⲙⲩⲥ	ⲛ|ⲧⲉ|ⲭⲗⲁⲙⲩⲥ
ϣⲁⲣⲟⲉⲓ	ϣⲁⲣⲟ|ⲉⲓ
ⲙⲡⲉⲩⲟⲉⲓϣ	ⲙ|ⲡⲉ|ⲩⲟⲉⲓϣ
ⲉⲧⲃⲉⲛϣⲏⲣⲉ	ⲉⲧⲃⲉ|ⲛ|ϣⲏⲣⲉ
ⲛⲧⲁⲩⲥⲱⲧⲙ	ⲛⲧ|ⲁ|ⲩ|ⲥⲱⲧⲙ
ϩⲁⲧⲛⲧⲉⲑⲁⲗⲁⲥⲥⲁ	ϩⲁⲧⲛ|ⲧⲉ|ⲑⲁⲗⲁⲥⲥⲁ
ⲛⲛⲉⲓⲡⲉⲧⲟⲩⲁⲁⲃ	ⲛ|ⲛⲉⲓ|ⲡ|ⲉⲧ|ⲟⲩⲁⲁⲃ
ϩⲙ	ϩⲙ
ⲛⲧⲉⲧⲛϣⲗⲏⲗ	ⲛ|ⲧⲉⲧⲛ|ϣⲗⲏⲗ
ⲉⲉⲩⲁⲅⲅⲉⲗⲓⲍⲉ	ⲉ|ⲉⲩⲁⲅⲅⲉⲗⲓⲍⲉ
ϩⲓϫⲱⲟⲩ	ϩⲓϫⲱ|ⲟⲩ
ϩⲛⲛⲗⲁⲟⲥ	ϩⲛ|ⲛ|ⲗⲁⲟⲥ
ϩⲛⲟⲩⲱⲛϩ	ϩⲛ|ⲟⲩ|ⲱⲛϩ
ⲛⲧⲉⲕⲛⲟⲩⲛⲉ	ⲛ|ⲧⲉⲕ|ⲛⲟⲩⲛⲉ
ⲙⲡϣⲏⲣⲉ	ⲙ|ⲡ|ϣⲏⲣⲉ
ⲉϭⲉⲗⲁⲁⲩ	ⲉ|ϭⲉ|ⲗⲁⲁⲩ
ⲡⲕⲉⲧ	ⲡ|ⲕⲉⲧ
ϫⲉⲟⲩⲟⲛ	ϫⲉ|ⲟⲩⲟⲛ
ⲁⲡⲉⲓⲗⲉⲓ	ⲁⲡⲉⲓⲗⲉⲓ
[.]ⲙ	[.]ⲙ
ϩⲛⲟⲩϫⲓⲟⲩⲉ	ϩⲛ|ⲟⲩ|ϫⲓⲟⲩⲉ
ⲉⲁⲁϥ	ⲉ|ⲁⲁ|ϥ
ⲛⲉⲥⲛⲏⲩ	ⲛⲉ|ⲥⲛⲏⲩ
ⲛϩⲉⲛⲕⲟⲟⲩⲉ	ⲛ|ϩⲉⲛ|ⲕⲟⲟⲩⲉ
ⲁⲥⲣϩⲟⲧⲉ	ⲁ|ⲥ|ⲣϩⲟⲧⲉ
ⲉⲟⲩϫⲁⲓ	ⲉ|ⲟⲩϫⲁⲓ
ϩⲛⲛⲁⲍⲁⲣⲉⲑ	ϩⲛ|ⲛⲁⲍⲁⲣⲉⲑ
ⲛⲧⲥⲁⲣⲝ	ⲛ|ⲧ|ⲥⲁⲣⲝ
ⲙⲡⲉⲕⲗⲁⲟⲥ	ⲙ|ⲡⲉⲕ|ⲗⲁⲟⲥ
ⲛⲥⲁⲡⲉⲥⲙⲟⲧ	ⲛⲥⲁ|ⲡⲉ|ⲥⲙⲟⲧ
ⲉⲡⲕⲟⲟⲥⲧ	ⲉ|ⲡ|ⲕⲟⲟⲥⲧ
ⲉⲣⲉⲟⲩϣⲟϣⲟⲩ	ⲉⲣⲉ|ⲟⲩ|ϣⲟϣⲟⲩ
ⲛⲧⲁⲛⲉⲧⲕⲱⲧ	ⲛⲧ|ⲁ|ⲛ|ⲉⲧ|ⲕⲱⲧ
ⲛⲉϥϯ	ⲛⲉ|ϥ|ϯ
ⲛⲧⲉϥⲓ	ⲛ|ⲧⲉ|ϥⲓ
ⲉⲧⲁⲗⲉ	ⲉⲧ|ⲁⲗⲉ
ⲁϥⲕⲁⲁⲥ	ⲁ|ϥ|ⲕⲁⲁ|ⲥ
ⲉϫⲙⲡϩⲏⲧ	ⲉϫⲙ|ⲡ|ϩⲏⲧ
ϩⲛⲛⲉⲩⲙⲛⲧⲁⲡⲟⲥⲧⲟⲥ	ϩⲛ|ⲛⲉⲩ|ⲙⲛⲧⲁⲡⲟⲥⲧⲟⲥ
ⲛϩⲏⲧⲟⲩ	ⲛϩⲏⲧ|ⲟⲩ
ⲛⲛⲉⲧⲙⲟⲩⲟⲩⲧ	ⲛ|ⲛ|ⲉⲧ|ⲙⲟⲩⲟⲩⲧ
ⲧⲉⲩⲙⲛⲧⲁⲧⲛⲁϩⲧⲉ	ⲧⲉⲩ|ⲙⲛⲧⲁⲧⲛⲁϩⲧⲉ
ⲁⲩⲉⲓⲙⲉ	ⲁ|ⲩ|ⲉⲓⲙⲉ
ⲉⲣⲉⲟⲩⲁⲗⲁⲃⲁⲥⲧⲣⲟⲛ	ⲉⲣⲉ|ⲟⲩ|ⲁⲗⲁⲃⲁⲥⲧⲣⲟⲛ
ⲛⲣⲟⲙⲡⲉ	ⲛ|ⲣⲟⲙⲡⲉ
ⲉⲧⲣⲉϥⲕⲁⲁϥ	ⲉ|ⲧⲣⲉ|ϥ|ⲕⲁⲁ|ϥ
ⲉϯⲣϩⲱⲃ	ⲉ|ϯ|ⲣϩⲱⲃ
ⲉⲧⲉⲧⲛⲛⲁⲛⲁⲩ	ⲉ|ⲧⲉⲧⲛ|ⲛⲁ|ⲛⲁⲩ
ⲥⲉⲛⲁⲧϭⲁⲓⲟϥ	ⲥⲉ|ⲛⲁ|ⲧϭⲁⲓⲟ|ϥ
ⲁⲥⲗⲟ	ⲁ|ⲥ|ⲗⲟ
ⲛⲛⲟϭ	ⲛ|ⲛⲟϭ
ϫⲉⲧⲱⲟⲩⲛⲅ	ϫⲉ|ⲧⲱⲟⲩⲛ|ⲅ
ⲛϭⲓⲧⲉϥϭⲓϫ	ⲛϭⲓ|ⲧⲉϥ|ϭⲓϫ
ⲛⲧⲉⲧⲛⲧⲙϩⲉⲡⲗⲁⲁⲩ	ⲛ|ⲧⲉⲧⲛ|ⲧⲙ|ϩⲉⲡ|ⲗⲁⲁⲩ
ϥⲛⲏⲩ	ϥ|ⲛⲏⲩ
ⲧⲉⲩϭⲟⲙ	ⲧⲉⲩ|ϭⲟⲙ
ⲛⲁⲣⲭⲱⲛ	ⲛ|ⲁⲣⲭⲱⲛ
ⲙⲛⲡⲕⲱⲧⲉ	ⲙⲛ|ⲡ|ⲕⲱⲧⲉ
ϩⲛⲟⲩϫⲡⲓⲟ	ϩⲛ|ⲟⲩ|ϫⲡⲓⲟ
ϩⲓϣⲁⲗ	ϩⲓ|ϣⲁⲗ
ⲙⲡⲉϥϭⲣⲟϭ	ⲙ|ⲡⲉϥ|ϭⲣⲟϭ
ⲙⲛⲡⲥⲟⲃⲧⲉ	ⲙⲛ|ⲡ|ⲥⲟⲃⲧⲉ
ϫⲛϩⲛⲟⲩⲁⲅⲁⲡⲏ	ϫⲛ|ϩⲛ|ⲟⲩ|ⲁⲅⲁⲡⲏ
ⲁⲩⲕⲁⲧⲏⲅⲟⲣⲓ	ⲁ|ⲩ|ⲕⲁⲧⲏⲅⲟⲣⲓ
ⲛⲟⲩⲟⲩⲛⲟⲩ	ⲛ|ⲟⲩ|ⲟⲩⲛⲟⲩ
ⲉⲥⲕⲏⲃ	ⲉ|ⲥ|ⲕⲏⲃ
ⲛϩⲏⲧτ	ⲛ|ϩⲏⲧ|ϥ
ⲡⲧⲏⲣϥ	ⲡ|ⲧⲏⲣ|ϥ
ⲛⲁⲥⲛⲏⲩ	ⲛⲁ|ⲥⲛⲏⲩ
ⲕϣⲟⲩϣⲟⲩ	ⲕ|ϣⲟⲩϣⲟⲩ
ⲉⲧⲟⲩⲁϣⲥ	ⲉⲧ|ⲟⲩⲁϣ|ⲥ
ⲧⲉϥϣⲧⲏⲛ	ⲧⲉϥ|ϣⲧⲏⲛ
ⲛⲧⲛϯⲧⲏⲩⲧⲛ	ⲛ|ⲧⲛ|ϯ|ⲧⲏⲩⲧⲛ
ⲛⲧⲉⲧⲛϩⲉⲛⲥⲁⲃⲉ	ⲛⲧⲉⲧⲛ|ϩⲉⲛ|ⲥⲁⲃⲉ
ⲉⲩⲉϣⲱⲡⲉ	ⲉⲩⲉ|ϣⲱⲡⲉ
ⲛϭⲓⲟⲩⲟⲛ	ⲛϭⲓ|ⲟⲩⲟⲛ
ϫⲉⲉⲛⲙⲟⲟϣⲉ	ϫⲉ|ⲉ|ⲛ|ⲙⲟⲟϣⲉ
ⲉⲧⲉⲣⲉⲛⲁⲧϩⲏⲧ	ⲉⲧⲉⲣⲉ|ⲛ|ⲁⲧϩⲏⲧ
ⲉϩⲉⲛϯⲙⲉ	ⲉ|ϩⲉⲛ|ϯⲙⲉ
ⲛⲁϣⲁϫⲉ	ⲛⲁ|ϣⲁϫⲉ
ⲉⲩⲡⲁⲣⲁⲕⲁⲗⲉⲓ	ⲉ|ⲩ|ⲡⲁⲣⲁⲕⲁⲗⲉⲓ
ⲗⲁⲁⲩ	ⲗⲁⲁⲩ
ⲙⲡⲓⲏⲗ	ⲙ|ⲡ|ⲓⲥⲣⲁⲏⲗ
ⲉϫⲛⲟⲩⲁ	ⲉϫⲛ|ⲟⲩⲁ
ⲛⲁⲱⲛϩ	ⲛⲁ|ⲱⲛϩ
ⲛϩⲏ[..]ⲉ	ⲛ|ϩⲏ[..]ⲉ
ϫⲉⲁⲛⲁⲩ	ϫⲉ|ⲁ|ⲛⲁⲩ
ϩⲟⲟⲩⲧ	ϩⲟⲟⲩⲧ
ϩⲛⲧⲓⲉⲡⲓⲥⲧⲟⲗⲏ	ϩⲛ|ⲧⲓ|ⲉⲡⲓⲥⲧⲟⲗⲏ
ⲉⲛⲉⲥⲟⲟⲩⲧⲛ	ⲉⲛⲉ|ⲥⲟⲟⲩⲧⲛ
ⲛ̄ⲧⲁϩⲉⲛⲙⲏⲏϣⲉ	ⲛ̄ⲧ|ⲁ|ϩⲉⲛ|ⲙⲏⲏϣⲉ
ⲉϯⲛⲁⲟⲩⲱⲙ	ⲉ|ϯ|ⲛⲁ|ⲟⲩⲱⲙ
ⲉⲓⲥⲙⲛⲧⲥⲛⲟⲟⲩⲥ	ⲉⲓⲥ|ⲙⲛⲧⲥⲛⲟⲟⲩⲥ
ⲛⲉⲣⲉⲏⲡⲡⲉ	ⲛⲉⲣⲉ|ⲏⲡ|ⲡⲉ
ⲡⲣⲟⲟⲩϣ	ⲡ|ⲣⲟⲟⲩϣ
ϣⲱⲡⲉ`	ϣⲱⲡⲉ`
ⲉⲕⲧⲁⲙⲟ	ⲉ|ⲕ|ⲧⲁⲙⲟ
ϣⲁⲣⲉ	ϣⲁⲣⲉ
ⲉⲓⲥⲡϩⲗⲗⲟ	ⲉⲓⲥ|ⲡ|ϩⲗⲗⲟ
ϣⲁϥⲕⲱ	ϣⲁ|ϥ|ⲕⲱ
ⲛⲧⲛϣⲓⲡⲉ	ⲛ|ⲧⲛ|ϣⲓⲡⲉ
ⲉⲛⲧⲁϥⲕⲟⲧϥ	ⲉⲛⲧ|ⲁ|ϥ|ⲕⲟⲧ|ϥ
ⲙⲡⲧⲓⲟⲩ	ⲙ|ⲡ|ⲧⲓⲟⲩ
ⲙⲁⲣⲉϥϭⲱϣⲧ	ⲙⲁⲣⲉ|ϥ|ϭⲱϣⲧ
ϩⲁⲧⲉⲑⲁⲗⲁⲥⲥⲁ	ϩⲁ|ⲧⲉ|ⲑⲁⲗⲁⲥⲥⲁ
ⲉⲛⲧⲁⲡⲛⲟⲩⲧⲉ	ⲉⲛⲧ|ⲁ|ⲡ|ⲛⲟⲩⲧⲉ
ⲉⲩⲧϭⲁⲓⲏⲩ	ⲉ|ⲩ|ⲧϭⲁⲓⲏⲩ
ⲁⲩϭⲱⲗⲡ	ⲁ|ⲩ|ϭⲱⲗⲡ
ϩⲛϩⲉⲛϣⲁϫⲉ	ϩⲛ|ϩⲉⲛ|ϣⲁϫⲉ
ⲛϭⲓⲡⲁⲣⲭⲏⲗⲏⲥⲧⲏⲥ	ⲛϭⲓ|ⲡ|ⲁⲣⲭⲏⲗⲏⲥⲧⲏⲥ
ⲛⲥⲉⲡⲥⲛⲁⲩ	ⲛ|ⲥⲉⲡ|ⲥⲛⲁⲩ
ϣⲁⲥⲉⲓ	ϣⲁ|ⲥ|ⲉⲓ
ⲛⲧⲉⲡⲕⲟⲥⲙⲟⲥ	ⲛⲧⲉ|ⲡ|ⲕⲟⲥⲙⲟⲥ
ⲡⲉϫⲁϥ	ⲡⲉϫⲁ|ϥ
ⲧⲉⲧⲛϫⲟⲟⲣ	ⲧⲉⲧⲛ|ϫⲟⲟⲣ
ⲛⲛⲁⲡⲟⲥⲧⲟⲗⲟⲥ	ⲛ|ⲛ|ⲁⲡⲟⲥⲧⲟⲗⲟⲥ
ϩⲟⲓⲛⲉ	ϩⲟⲓⲛⲉ
ⲛϫⲟⲟⲥ	ⲛ|ϫⲟⲟ|ⲥ
ⲣⲉϥⲣⲛⲟⲃⲉ	ⲣⲉϥⲣⲛⲟⲃⲉ
ⲉϥϫⲱⲙⲙⲟⲥ	ⲉ|ϥ|ϫⲱ|ⲙⲙⲟ|ⲥ
ⲉⲓ	ⲉ|ⲓ
ⲙⲡⲉⲓⲥⲭⲏⲙⲁ	ⲙ|ⲡⲉⲓ|ⲥⲭⲏⲙⲁ
ⲁϥⲧⲥⲟϥ	ⲁ|ϥ|ⲧⲥⲟ|ϥ
ⲉⲣⲱⲧⲛ	ⲉⲣⲱ|ⲧⲛ
ⲛϭⲓⲡϩⲓⲉⲣⲉⲩⲥ	ⲛϭⲓ|ⲡ|ϩⲓⲉⲣⲉⲩⲥ
ⲉϩⲟⲩⲉⲡⲧⲃⲃⲟ	ⲉϩⲟⲩⲉ|ⲡ|ⲧⲃⲃⲟ
ⲙⲛⲛϭⲟⲗ	ⲙⲛ|ⲛ|ϭⲟⲗ
ϩⲛⲟⲩⲡⲁⲣⲣⲏⲥⲓⲁ	ϩⲛ|ⲟⲩ|ⲡⲁⲣⲣⲏⲥⲓⲁ
ⲁϥϣⲉⲡ	ⲁ|ϥ|ϣⲉⲡ
ⲡⲉⲧϩⲓⲧⲟⲩⲱⲕ	ⲡ|ⲉⲧ|ϩⲓⲧⲟⲩⲱ|ⲕ
ⲉⲡⲉⲥⲧⲁⲩⲣⲟⲥ	ⲉ|ⲡⲉ|ⲥⲧⲁⲩⲣⲟⲥ
ⲛϩⲉⲛⲡⲛⲉⲩⲙⲁⲧⲓⲕⲟⲛ	ⲛ|ϩⲉⲛ|ⲡⲛⲉⲩⲙⲁⲧⲓⲕⲟⲛ
ϩⲓⲧⲙⲡⲣⲁⲛ	ϩⲓⲧⲙ|ⲡ|ⲣⲁⲛ
ⲛⲉⲥϭⲟⲛⲧ	ⲛⲉ|ⲥ|ϭⲟⲛⲧ
ⲛⲧⲛⲓⲱϩⲁⲛⲛⲏⲥ	ⲛⲧⲛ|ⲓⲱϩⲁⲛⲛⲏⲥ
ⲛⲉⲧⲟⲩⲛⲁ	ⲛ|ⲉⲧ|ⲟⲩ|ⲛⲁ
ⲉϥϣⲁⲛⲣⲥⲧ	ⲉϥϣⲁⲛ|ⲣⲥⲧ
ⲛⲉⲩⲇⲓⲁⲕⲟⲛⲓ	ⲛⲉ|ⲩ|ⲇⲓⲁⲕⲟⲛⲓ
ⲛⲧⲉⲓϭⲟⲧ	ⲛ|ⲧⲉⲓ|ϭⲟⲧ
ϣⲁⲉⲛⲉϩ	ϣⲁ|ⲉⲛⲉϩ
ⲉⲑⲟⲟⲩ	ⲉⲧ|ϩⲟⲟⲩ
ϩⲛⲛⲧⲟϣ	ϩⲛ|ⲛⲧⲟϣ
ⲥⲏϩ	ⲥⲏϩ
ⲧⲉⲫⲑⲟⲛⲉⲓ	ⲧⲉ|ⲫⲑⲟⲛⲉⲓ
ϩⲙⲡⲁⲣⲭⲱⲛ	ϩⲙ|ⲡ|ⲁⲣⲭⲱⲛ
ⲧⲙⲛⲧⲣⲣⲟ	ⲧ|ⲙⲛⲧⲣⲣⲟ
ϩⲛⲛⲟⲩϣⲁϫⲉ	ϩⲛ|ⲛⲟⲩ|ϣⲁϫⲉ
ⲕⲏⲫⲁ	ⲕⲏⲫⲁ
ⲧϣⲉⲉⲣⲉ	ⲧ|ϣⲉⲉⲣⲉ
ϩⲁϩⲉⲛⲙⲏⲏϣⲉ	ϩⲁ|ϩⲉⲛ|ⲙⲏⲏϣⲉ
ⲉⲡⲉⲛⲧⲁⲧⲁⲓ	ⲉ|ⲡ|ⲉⲛⲧ|ⲁ|ⲧⲁⲓ
ⲟⲩⲙⲛⲧⲥⲟϭ	ⲟⲩ|ⲙⲛⲧⲥⲟϭ
ⲏⲥⲁⲩ	ⲏⲥⲁⲩ
ⲉⲩⲥϩⲁⲓ	ⲉ|ⲩ|ⲥϩⲁⲓ
ⲙⲛⲡⲧⲁⲉⲓⲟ	ⲙⲛ|ⲡ|ⲧⲁⲉⲓⲟ
ⲙⲛⲓⲉⲍⲉⲕⲓⲏⲗ	ⲙⲛ|ⲓⲉⲍⲉⲕⲓⲏⲗ
ϯⲛⲁⲕⲉⲧⲕⲉⲟⲩⲁ	ϯ|ⲛⲁ|ⲕⲉⲧ|ⲕⲉ|ⲟⲩⲁ
ⲧⲙⲛⲧϣⲁϥⲧⲉ	ⲧ|ⲙⲛⲧϣⲁϥⲧⲉ
ⲉⲙⲙⲁ	ⲉ|ⲙ|ⲙⲁ
ⲧⲉϥⲙⲁⲁⲩ	ⲧⲉϥ|ⲙⲁⲁⲩ
ⲉⲟⲩⲛⲧϥⲓⲏⲥⲟⲩⲥ	ⲉ|ⲟⲩⲛⲧ|ϥ|ⲓⲏⲥⲟⲩⲥ
ⲛⲧⲁϥϫⲱϩ	ⲛⲧ|ⲁ|ϥ|ϫⲱϩ
ⲡⲉⲧⲛⲛⲁⲁⲁϥ	ⲡⲉ|ⲧⲛ|ⲛⲁ|ⲁⲁ|ϥ
ϩⲁⲣⲟⲛ	ϩⲁⲣⲟ|ⲛ
ⲙⲡⲓⲣⲁⲥⲙⲟⲥ	ⲙ|ⲡⲓⲣⲁⲥⲙⲟⲥ
ϣⲁϥⲥⲗⲡⲛϩⲁⲗⲩⲥⲓⲥ	ϣⲁ|ϥ|ⲥⲗⲡ|ⲛ|ϩⲁⲗⲩⲥⲓⲥ
ⲛⲉⲓⲟⲩϣⲏ	ⲛⲉⲓ|ⲟⲩϣⲏ
ⲉⲧⲃⲏⲏⲧⲛ	ⲉⲧⲃⲏⲏ|ⲧⲛ
ϩⲛⲧⲉⲕⲣⲓ	ϩⲛ|ⲧⲉⲕ|ⲣⲓ
ϩⲛⲛⲉϥⲕⲉⲉⲥ	ϩⲛ|ⲛⲉϥ|ⲕⲉⲉⲥ
ϩⲁⲧⲉⲩϩⲏ	ϩⲁ|ⲧⲉ|ⲩ|ϩⲏ
ⲛⲧⲉⲧⲛⲛⲟϫϥ	ⲛ|ⲧⲉⲧⲛ|ⲛⲟϫ|ϥ
ϫⲉⲙⲁ	ϫⲉ|ⲙⲁ
ⲙⲙⲛⲧϣⲙⲙⲟ	ⲙ|ⲙⲛⲧϣⲙⲙⲟ
ⲙⲡⲙⲟⲟⲩ	ⲙ|ⲡ|ⲙⲟⲟⲩ
ⲛⲉϥⲁϩⲉⲣⲁⲧϥ	ⲛⲉ|ϥ|ⲁϩⲉⲣⲁⲧ|ϥ
ⲙⲛⲡⲙⲁ	ⲙⲛ|ⲡ|ⲙⲁ
ⲙⲛⲡⲉϥⲭⲣⲓⲥⲧⲟⲥ	ⲙⲛ|ⲡⲉ|ϥ|ⲭⲣⲓⲥⲧⲟⲥ
ⲛⲧⲉⲧⲛϫⲓⲧϥ	ⲛ|ⲧⲉⲧⲛ|ϫⲓⲧ|ϥ
ⲛϥⲛⲁϣϭⲙϭⲟⲙ	ⲛ|ϥ|ⲛⲁ|ϣϭⲙϭⲟⲙ
ⲉϫⲙⲡⲉⲭⲟⲣⲧⲟⲥ	ⲉϫⲙ|ⲡⲉ|ⲭⲟⲣⲧⲟⲥ
ⲕⲟⲩⲓ	ⲕⲟⲩⲓ
ⲧⲁⲁⲑⲉⲧⲉⲓ	ⲧⲁ|ⲁⲑⲉⲧⲉⲓ
ⲉⲛⲧⲁϥϫⲟⲟⲥ	ⲉⲛⲧ|ⲁ|ϥ|ϫⲟⲟ|ⲥ
ⲛϥϯⲕⲁⲣⲡⲟⲥ	ⲛ|ϥ|ϯ|ⲕⲁⲣⲡⲟⲥ
ⲥⲁⲁⲧϥ	ⲥⲁⲁⲧ|ϥ
ⲣⲛⲟⲃⲉ	ⲣⲛⲟⲃⲉ
ⲉⲙⲛϣϭⲟⲙ	ⲉ|ⲙⲛ|ϣϭⲟⲙ
ϫⲉⲉⲓⲥ	ϫⲉ|ⲉⲓⲥ
ⲉⲡⲉⲓⲃⲓⲟⲥ	ⲉ|ⲡⲉⲓ|ⲃⲓⲟⲥ
ⲥⲁⲧⲁⲛⲁⲥ	ⲥⲁⲧⲁⲛⲁⲥ
ϩⲛⲟⲩⲡⲓⲧϩⲉ	ϩⲛ|ⲟⲩ|ⲡⲓⲧϩⲉ
ϫⲉⲡⲉⲭⲣⲓⲥⲧⲟⲥ	ϫⲉ|ⲡⲉ|ⲭⲣⲓⲥⲧⲟⲥ
ⲛⲧⲟⲟⲧⲥ	ⲛⲧⲟⲟⲧ|ⲥ
ⲛⲧⲡⲁⲣⲃⲁⲥⲓⲥ	ⲛ|ⲧ|ⲡⲁⲣⲃⲁⲥⲓⲥ
ⲁⲥⲡⲁϩⲧⲥ	ⲁ|ⲥ|ⲡⲁϩⲧ|ⲥ
ⲉⲡⲉⲕⲣⲟ	ⲉ|ⲡⲉ|ⲕⲣⲟ
ⲛⲓⲁⲕⲱⲃⲟⲥ	ⲛ|ⲓⲁⲕⲱⲃⲟⲥ
ϫⲉⲥⲉⲛⲁϣⲓⲡⲉ	ϫⲉ|ⲥⲉ|ⲛⲁ|ϣⲓⲡⲉ
ϩⲛⲛⲉⲛϩⲃⲏⲩⲉ	ϩⲛ|ⲛⲉⲛ|ϩⲃⲏⲩⲉ
ⲥⲛⲏⲩ	ⲥⲛⲏⲩ
ⲁⲧϩⲟⲧⲉ	ⲁ|ⲧ|ϩⲟⲧⲉ
ⲉⲁⲧⲉⲧⲛⲥⲱⲟⲩϩ	ⲉ|ⲁ|ⲧⲉⲧⲛ|ⲥⲱⲟⲩϩ
ⲛⲧⲁϥⲧⲁⲁⲩ	ⲛⲧ|ⲁ|ϥ|ⲧⲁⲁ|ⲩ
ⲛⲥⲛⲁⲟⲩⲱϩ	ⲛ|ⲥ|ⲛⲁ|ⲟⲩⲱϩ
ⲕⲁⲧⲁⲡⲉⲛⲉⲓⲛⲉ	ⲕⲁⲧⲁ|ⲡⲉⲛ|ⲉⲓⲛⲉ
ϫⲡⲓⲟ	ϫⲡⲓⲟ
ⲉⲣⲟⲛ	ⲉⲣⲟ|ⲛ
ⲉⲕϣⲁⲛⲧⲙⲥⲱⲧⲉ	ⲉⲕϣⲁⲛ|ⲧⲙ|ⲥⲱⲧⲉ
ⲉⲁⲩⲉⲓ	ⲉ|ⲁ|ⲩ|ⲉⲓ
ⲉⲧⲉⲧⲛϫⲟ	ⲉ|ⲧⲉⲧⲛ|ϫⲟ
ϩⲁⲙⲟⲓ	ϩⲁⲙⲟⲓ
ϫⲉϥϩⲟⲗϭ	ϫⲉ|ϥ|ϩⲟⲗϭ
ⲉⲣⲉⲡⲉⲛϩⲏⲧ	ⲉⲣⲉ|ⲡⲉⲛ|ϩⲏⲧ
ⲁϥⲧⲁⲁϥ	ⲁ|ϥ|ⲧⲁⲁ|ϥ
ⲉⲛϫⲱ	ⲉ|ⲛ|ϫⲱ
ⲡⲉϩⲟⲟⲩ	ⲡⲉ|ϩⲟⲟⲩ
ⲛⲟⲩⲟⲉⲓⲉ	ⲛ|ⲟⲩⲟⲉⲓⲉ
ⲧⲉⲧⲛⲫⲟⲣⲉⲓ	ⲧⲉⲧⲛ|ⲫⲟⲣⲉⲓ
ⲛⲧⲁϩⲉⲛⲕⲟⲟⲩⲉ	ⲛⲧ|ⲁ|ϩⲉⲛ|ⲕⲟⲟⲩⲉ
ⲉⲧⲙⲣϩⲟⲩⲟ	ⲉ|ⲧⲙ|ⲣϩⲟⲩⲟ
ⲛϩⲉⲛϩⲟⲙⲧ	ⲛ|ϩⲉⲛ|ϩⲟⲙⲧ
ⲡⲃⲁⲣⲟⲥ	ⲡ|ⲃⲁⲣⲟⲥ
ⲉϥϩⲟⲟⲩ	ⲉ|ϥ|ϩⲟⲟⲩ
ϣⲁⲛⲧⲉⲧⲛⲥⲉⲩϩ	ϣⲁⲛⲧⲉ|ⲧⲛ|ⲥⲉⲩϩ
ⲛⲧⲁⲡⲉⲓⲙⲁ	ⲛⲧ|ⲁ|ⲡⲉⲓ|ⲙⲁ
ⲡⲉϫⲉ	ⲡⲉϫⲉ
ⲙⲙⲁⲑⲏⲧⲏⲥ	ⲙ|ⲙⲁⲑⲏⲧⲏⲥ
ⲛⲓⲁⲕⲱⲃ	ⲛ|ⲓⲁⲕⲱⲃ
ⲙⲡⲁⲓⲱⲛ	ⲙ|ⲡ|ⲁⲓⲱⲛ
ⲛⲧⲕⲟⲩⲉⲛⲧⲏϭ	ⲛⲧⲕ|ⲟⲩ|ⲉⲛⲧⲏϭ
ⲡⲉⲕϩⲏⲧ	ⲡⲉⲕ|ϩⲏⲧ
ⲡⲉⲧⲉⲣⲉⲡϫⲟⲉⲓⲥ	ⲡ|ⲉⲧⲉⲣⲉ|ⲡ|ϫⲟⲉⲓⲥ
ϣⲁⲛⲉⲕⲣⲱⲙⲉ	ϣⲁ|ⲛⲉⲕ|ⲣⲱⲙⲉ
ⲁⲥⲙⲉϩ	ⲁ|ⲥ|ⲙⲉϩ
ⲛⲧⲁⲩⲁϩⲟⲩ	ⲛⲧ|ⲁ|ⲩ|ⲁϩⲟⲩ
ⲁⲧⲉⲧⲛⲥⲱⲧⲡ	ⲁ|ⲧⲉⲧⲛ|ⲥⲱⲧⲡ
ⲥⲉⲛⲁϩⲉ	ⲥⲉ|ⲛⲁ|ϩⲉ
ⲉⲧⲃⲉⲧⲙⲛⲧⲉⲣⲟ	ⲉⲧⲃⲉ|ⲧ|ⲙⲛⲧⲉⲣⲟ
ⲛϥⲉⲓ	ⲛ|ϥ|ⲉⲓ
ⲉⲙⲉϣϣⲉ	ⲉ|ⲙⲉϣϣⲉ
ϩⲙⲡⲉϩⲙⲉ	ϩⲙ|ⲡⲉ|ϩⲙⲉ
ϫⲉⲉⲩⲉⲃⲱⲕ	ϫⲉ|ⲉ|ⲩ|ⲉ|ⲃⲱⲕ
ⲙⲉϥϯϩⲏⲩ	ⲙⲉ|ϥ|ϯ|ϩⲏⲩ
ⲛⲛⲁϩⲣⲛⲡⲓⲃⲁⲃⲉⲣⲱⲙⲉ	ⲛⲛⲁϩⲣⲛ|ⲡⲓ|ⲃⲁⲃⲉⲣⲱⲙⲉ
ⲉϫⲛⲧⲡⲉⲧⲣⲁ	ⲉϫⲛ|ⲧ|ⲡⲉⲧⲣⲁ
ⲛⲉϥⲕⲱⲧⲉ	ⲛⲉ|ϥ|ⲕⲱⲧⲉ
ⲛⲉⲧⲟⲩⲁⲓⲧⲉⲓ	ⲛ|ⲉⲧ|ⲟⲩ|ⲁⲓⲧⲉⲓ
ϩⲉⲛⲥⲁⲃⲉ	ϩⲉⲛ|ⲥⲁⲃⲉ
ⲉⲧⲟⲓ	ⲉⲧ|ⲟⲓ
ⲛⲙⲙⲁⲩ	ⲛⲙⲙⲁ|ⲩ
ⲁϥϫⲓϣⲕⲁⲕ	ⲁ|ϥ|ϫⲓ|ϣⲕⲁⲕ
ⲉϩⲉⲛⲕⲉⲧⲟⲡⲟⲥ	ⲉ|ϩⲉⲛ|ⲕⲉ|ⲧⲟⲡⲟⲥ
ϩⲛⲃⲏⲑⲁⲛⲓⲁ	ϩⲛ|ⲃⲏⲑⲁⲛⲓⲁ
ϩⲛⲟⲩⲙⲛⲧⲣⲉϥϭⲛⲁⲣⲓⲕⲉ	ϩⲛ|ⲟⲩ|ⲙⲛⲧⲣⲉϥϭⲛ|ⲁⲣⲓⲕⲉ
ⲙⲡⲣⲟⲇⲟⲇⲏⲥ	ⲙⲡⲣ|ⲟ|ⲇⲟⲇⲏⲥ
ϩⲓϫⲛⲧϩⲁⲗⲁⲥⲥⲁ	ϩⲓϫⲛ|ⲧ|ϩⲁⲗⲁⲥⲥⲁ
ⲉⲧϭⲟⲙ	ⲉ|ⲧ|ϭⲟⲙ
ⲛⲑⲓⲙⲉ	ⲛ|ⲑ|ⲓⲙⲉ
ⲧⲁⲙⲁⲁⲩ	ⲧⲁ|ⲙⲁⲁⲩ
ⲙⲡⲟⲩⲁⲑⲉⲧⲓ	ⲙ|ⲡ|ⲟⲩ|ⲁⲑⲉⲧⲓ
ⲉⲧⲉⲓ	ⲉⲧ|ⲉⲓ
ϫⲉϫⲟⲟⲩⲛ	ϫⲉ|ϫⲟⲟⲩ|ⲛ
ⲛⲧⲉⲓ	ⲛ|ⲧⲉⲓ
ϩⲉⲛϣⲏⲣⲉ	ϩⲉⲛ|ϣⲏⲣⲉ
ϫⲉⲉⲥⲉⲗⲟ	ϫⲉ|ⲉ|ⲥ|ⲉⲗⲟ
ϫⲉⲛⲁⲙⲉ	ϫⲉ|ⲛⲁⲙⲉ
ⲙⲁⲩⲁⲁϥ	ⲙⲁⲩⲁⲁ|ϥ
ⲛⲛⲟⲃⲉ	ⲛ|ⲛⲟⲃⲉ
ⲛⲉⲛⲧⲁⲩϣⲱⲡⲉ	ⲛ|ⲉⲛⲧ|ⲁ|ⲩ|ϣⲱⲡⲉ
ⲉϣϫⲉⲁⲧⲉⲧⲛⲣⲣⲣⲟ	ⲉϣϫⲉ|ⲁ|ⲧⲉⲧⲛ|ⲣⲣⲣⲟ
ⲉⲛϥⲥⲟⲟⲩⲛ	ⲉ|ⲛ|ϥ|ⲥⲟⲟⲩⲛ
ⲉⲩⲥⲟⲟⲩⲛ	ⲉ|ⲩ|ⲥⲟⲟⲩⲛ
ⲙⲡϥⲟⲩⲱϣ	ⲙⲡ|ϥ|ⲟⲩⲱϣ
ⲛⲥⲁⲩⲥⲁ	ⲛⲥⲁ|ⲩ|ⲥⲁ
ⲙⲡⲁⲣⲭⲓⲥⲩⲛⲁⲅⲱⲅⲟⲥ	ⲙ|ⲡ|ⲁⲣⲭⲓⲥⲩⲛⲁⲅⲱⲅⲟⲥ
ⲛⲟⲩⲑⲗⲓⲯⲓⲥ	ⲛ|ⲟⲩ|ⲑⲗⲓⲯⲓⲥ
ϩⲛⲟⲩⲙⲛⲧⲣⲙⲛⲧϩⲏⲧ	ϩⲛ|ⲟⲩ|ⲙⲛⲧⲣⲙⲛⲧϩⲏⲧ
ⲉⲧⲉⲧⲛϭⲱϣⲧ	ⲉ|ⲧⲉⲧⲛ|ϭⲱϣⲧ
ⲛⲛⲟϫⲟⲩ	ⲛ|ⲛⲟϫⲟⲩ
ⲧⲁⲁⲓⲧⲉⲓ	ⲧⲁ|ⲁⲓⲧⲉⲓ
ϫⲉⲕⲁⲗⲱⲥ	ϫⲉ|ⲕⲁⲗⲱⲥ
ⲙⲡⲗϭⲉ	ⲙ|ⲡⲗϭⲉ
ⲛⲧⲉⲓϩⲙϩⲁⲗ	ⲛ|ⲧⲉⲓ|ϩⲙϩⲁⲗ
ⲇⲟⲩⲗⲟⲥ	ⲇⲟⲩⲗⲟⲥ
ⲛⲟⲩⲭⲗⲁⲙⲩⲥ	ⲛ|ⲟⲩ|ⲭⲗⲁⲙⲩⲥ
ⲙⲡⲉⲥⲥⲛⲟϥ	ⲙ|ⲡⲉⲥ|ⲥⲛⲟϥ
ⲉⲟⲩⲱⲙ	ⲉ|ⲟⲩⲱⲙ
ⲁϥϫⲉⲩⲕⲉⲟⲩⲁ	ⲁ|ϥ|ϫⲉⲩ|ⲕⲉ|ⲟⲩⲁ
ⲛⲥⲡⲱϩ	ⲛ|ⲥ|ⲡⲱϩ
ϫⲉⲉϣϫⲉⲧⲉⲧⲛⲁⲛⲧ	ϫⲉ|ⲉϣϫⲉ|ⲧⲉⲧⲛ|ⲛⲁ|ⲛⲧ
ⲙⲛⲛⲣⲱⲙⲉ	ⲙⲛ|ⲛ|ⲣⲱⲙⲉ
ⲥⲉⲛⲁϩⲁⲣⲉϩ	ⲥⲉ|ⲛⲁ|ϩⲁⲣⲉϩ
ϫⲉⲥⲉϫⲱ	ϫⲉ|ⲥⲉ|ϫⲱ
ⲛⲉⲩⲛⲟⲩϫ	ⲛⲉ|ⲩ|ⲛⲟⲩϫ
ⲉϩⲉⲛⲛⲟϭ	ⲉ|ϩⲉⲛ|ⲛⲟϭ
ⲧⲙⲏⲧⲉ	ⲧ|ⲙⲏⲧⲉ
ⲛⲉⲩⲥⲟⲟⲩⲛ	ⲛⲉ|ⲩ|ⲥⲟⲟⲩⲛ
ⲛⲁϣⲱⲡⲉ	ⲛⲁ|ϣⲱⲡⲉ
ϫⲉⲁⲥⲥⲗⲁⲁⲧⲉ	ϫⲉ|ⲁ|ⲥ|ⲥⲗⲁⲁⲧⲉ
ⲁϥⲕⲱⲧⲉ	ⲁ|ϥ|ⲕⲱⲧⲉ
ⲧⲉϥⲕⲉⲯⲩⲭⲏ	ⲧⲉϥ|ⲕⲉ|ⲯⲩⲭⲏ
ⲡⲉⲧⲙⲟⲟϣⲉ	ⲡ|ⲉⲧ|ⲙⲟⲟϣⲉ
ⲙⲙⲁⲓⲧⲟ	ⲙ|ⲙⲁⲓⲧⲟ
ⲛⲧⲉⲧⲛϫⲟⲟⲥ	ⲛ|ⲧⲉⲧⲛ|ϫⲟⲟ|ⲥ
ⲛⲧⲁⲥⲁⲁ	ⲛⲧ|ⲁ|ⲥ|ⲁⲁ
norm_group	norm
ⲟⲩⲱϩ	ⲟⲩⲱϩ
ϩⲱⲟⲩ	ϩⲱ|ⲟⲩ
ϫⲉϥⲟⲩⲱⲙ	ϫⲉ|ϥ|ⲟⲩⲱⲙ
ⲟⲩⲇⲓⲱⲅⲙⲟⲥ	ⲟⲩ|ⲇⲓⲱⲅⲙⲟⲥ
ϫⲉⲉⲣⲉⲡⲁⲙⲁ	ϫⲉ|ⲉⲣⲉ|ⲡⲁ|ⲙⲁ
ⲛⲧⲁϥⲛⲟⲩϫⲉ	ⲛⲧ|ⲁ|ϥ|ⲛⲟⲩϫⲉ
ϩⲛⲟⲩⲣⲁϣⲉ	ϩⲛ|ⲟⲩ|ⲣⲁϣⲉ
ⲛⲧⲉⲣⲟⲩⲙⲟⲟⲛⲉ	ⲛⲧⲉⲣ|ⲟⲩ|ⲙⲟⲟⲛⲉ
ⲡⲁ[…]ϥⲟϭⲉ	ⲡⲁ[…]ϥⲟϭⲉ
ϯⲛⲁϫⲟⲟⲥ	ϯ|ⲛⲁ|ϫⲟⲟ|ⲥ
ⲉⲧⲉⲧⲛⲧⲣⲉⲩⲛⲟⲩϫⲉ	ⲉ|ⲧⲉⲧⲛ|ⲧⲣⲉ|ⲩ|ⲛⲟⲩϫⲉ
ⲉⲟⲩ	ⲉ|ⲟⲩ
ⲉⲁϥϩⲩⲡⲟⲙⲓⲛⲉ	ⲉ|ⲁ|ϥ|ϩⲩⲡⲟⲙⲓⲛⲉ
ⲉⲧⲡⲏⲧ	ⲉⲧ|ⲡⲏⲧ
ϫⲉⲉϥⲉϫⲓ	ϫⲉ|ⲉ|ϥ|ⲉ|ϫⲓ
ⲡⲉⲧⲛⲁⲇⲟⲕⲓⲙⲁⲍⲉ	ⲡ|ⲉⲧ|ⲛⲁ|ⲇⲟⲕⲓⲙⲁⲍⲉ
ⲛϫⲡⲯⲓⲧⲉ	ⲛ|ϫⲡ|ⲯⲓⲧⲉ
ⲛⲉⲧϩⲛⲧⲓⲟⲩⲇⲁⲓⲁ	ⲛ|ⲉⲧ|ϩⲛ|ⲧ|ⲓⲟⲩⲇⲁⲓⲁ
ϫⲉⲁⲩⲃⲱⲕ	ϫⲉ|ⲁ|ⲩ|ⲃⲱⲕ
ⲁϥⲟⲩⲁϩϥ	ⲁ|ϥ|ⲟⲩⲁϩ|ϥ
ⲛⲉϫⲧⲟⲉⲓⲥ	ⲛⲉϫ|ⲧⲟⲉⲓⲥ
ⲧⲡⲟⲗⲓⲥ	ⲧ|ⲡⲟⲗⲓⲥ
ϫⲟⲟ	ϫⲟⲟ
ⲁϩⲁϩ	ⲁ|ϩⲁϩ
ϫⲉⲁⲕⲛⲟⲩϭⲥ	ϫⲉ|ⲁ|ⲕ|ⲛⲟⲩϭⲥ
ⲛⲉⲥⲙⲡⲙⲁ	ⲛⲉ|ⲥ|ⲙ|ⲡ|ⲙⲁ
ⲉⲩⲕⲓⲙ	ⲉ|ⲩ|ⲕⲓⲙ
ⲙⲡϥⲕⲁⲁⲥ	ⲙⲡ|ϥ|ⲕⲁⲁ|ⲥ
ⲥⲁⲁⲧ	ⲥⲁⲁⲧ
ϫⲉⲡⲁⲟⲩⲟⲛ	ϫⲉ|ⲡⲁ|ⲟⲩⲟⲛ
ϩⲟⲟⲩ	ϩⲟⲟⲩ
ⲁⲩϥⲓ	ⲁ|ⲩ|ϥⲓ
ⲛⲓⲙ	ⲛⲓⲙ
ⲁϥϣⲡϩⲙⲟⲧ	ⲁ|ϥ|ϣⲡ|ϩⲙⲟⲧ
ϩⲉⲛⲕⲉϩⲛⲁⲁⲩ	ϩⲉⲛ|ⲕⲉ|ϩⲛⲁⲁⲩ
ⲉⲧⲣⲉⲛⲧⲁⲙⲟⲟⲩ	ⲉ|ⲧⲣⲉ|ⲛ|ⲧⲁⲙⲟ|ⲟⲩ
ⲛⲥⲁⲟⲩⲥⲟⲫⲓⲁ	ⲛⲥⲁ|ⲟⲩ|ⲥⲟⲫⲓⲁ
ⲙⲛⲛⲉⲧⲛⲙⲙⲁϥ	ⲙⲛ|ⲛ|ⲉⲧ|ⲛⲙⲙⲁ|ϥ
ϫⲉⲟⲩⲥⲟⲛ	ϫⲉ|ⲟⲩ|ⲥⲟⲛ
ⲙⲙⲟⲩ	ⲙ|ⲙⲟⲩ
ⲛⲛϣⲁϫⲉ	ⲛ|ⲛ|ϣⲁϫⲉ
ϣⲟⲡϥ	ϣⲟⲡ|ϥ
ⲡⲛⲁⲍⲁⲣⲏⲛⲟⲥ	ⲡ|ⲛⲁⲍⲁⲣⲏⲛⲟⲥ
ϫⲉⲟⲩⲣⲉϥϫⲓϭⲟⲗ	ϫⲉ|ⲟⲩ|ⲣⲉϥϫⲓ|ϭⲟⲗ
ⲛⲁⲩ	ⲛⲁ|ⲩ
ϫⲉⲁⲡϣⲱⲙ	ϫⲉ|ⲁ|ⲡ|ϣⲱⲙ
ⲡⲁⲛⲟⲩⲧⲉ	ⲡⲁ|ⲛⲟⲩⲧⲉ
ϩⲛⲟⲩⲙⲛⲧⲣⲉϥϩⲓⲗⲁ	ϩⲛ|ⲟⲩ|ⲙⲛⲧⲣⲉϥϩⲓⲗⲁ
ⲉϥⲫⲟⲣⲉⲓ	ⲉ|ϥ|ⲫⲟⲣⲉⲓ
ⲉⲙⲡⲁⲧⲉⲟⲩⲁⲗⲉⲕⲧⲱⲣ	ⲉ|ⲙⲡⲁⲧⲉ|ⲟⲩ|ⲁⲗⲉⲕⲧⲱⲣ
ⲛⲛⲉϥϣⲟϫⲛⲉ	ⲛ|ⲛⲉϥ|ϣⲟϫⲛⲉ
ⲙⲡⲁⲡⲟⲥⲧⲟⲗⲟⲥ	ⲙ|ⲡ|ⲁⲡⲟⲥⲧⲟⲗⲟⲥ
ⲏⲇⲏ	ⲏⲇⲏ
ⲁϥϭⲱ	ⲁ|ϥ|ϭⲱ
ⲙⲡⲥⲱⲛⲧ	ⲙ|ⲡ|ⲥⲱⲛⲧ
ⲡⲛⲟⲩⲧⲉⲛⲛϭⲟⲙ	ⲡ|ⲛⲟⲩⲧⲉ|ⲛ|ⲛ|ϭⲟⲙ
ⲙⲡⲣⲁⲛ	ⲙ|ⲡ|ⲣⲁⲛ
ⲙⲡⲟⲩϩⲟⲟⲩϣ	ⲙⲡ|ⲟⲩ|ϩⲟⲟⲩϣ
ⲛϥϥⲓⲡϣⲁϫⲉ	ⲛ|ϥ|ϥⲓ|ⲡ|ϣⲁϫⲉ
ⲉⲣⲟⲕ	ⲉⲣⲟ|ⲕ
ⲉⲛⲧⲁⲕϫⲓⲟⲩⲁ	ⲉⲛⲧ|ⲁ|ⲕ|ϫⲓ|ⲟⲩⲁ
ⲙⲁⲩⲁⲁⲕ	ⲙⲁⲩⲁⲁ|ⲕ
ⲛⲉⲧⲉⲙⲡⲟⲩⲁⲗⲉ	ⲛ|ⲉⲧⲉ|ⲙⲡ|ⲟⲩ|ⲁⲗⲉ
ⲉⲧⲉⲛⲁⲓ	ⲉⲧⲉ|ⲛⲁⲓ
ϯⲡⲁⲣⲁⲕⲁⲗⲉⲓ	ϯ|ⲡⲁⲣⲁⲕⲁⲗⲉⲓ
ϣⲁⲡⲓⲗⲁⲧⲟⲥ	ϣⲁ|ⲡⲓⲗⲁⲧⲟⲥ
ϩⲛⲡⲣⲟⲥⲟⲩⲟⲉⲓϣ	ϩⲛ|ⲡⲣⲟⲥⲟⲩⲟⲉⲓϣ
ϩⲙⲙⲁ	ϩⲙ|ⲙⲁ
ⲙⲡⲉⲟⲟⲩⲓⲏⲥⲟⲩⲥ	ⲙ|ⲡ|ⲉⲟⲟⲩ|ⲓⲏⲥⲟⲩⲥ
ⲉⲡⲉⲥⲏⲧⲡⲉⲥⲏⲧ	ⲉⲡⲉⲥⲏⲧ|ⲡⲉ|ⲥⲏⲧ
ⲛϭⲓⲛⲉⲫⲁⲣⲓⲥⲥⲁⲓⲟⲥ	ⲛϭⲓ|ⲛⲉ|ⲫⲁⲣⲓⲥⲥⲁⲓⲟⲥ
ⲉϣⲏⲣⲉ	ⲉ|ϣⲏⲣⲉ
ⲉⲧⲃⲏⲏⲧⲥ	ⲉⲧⲃⲏⲏⲧ|ⲥ
ⲙⲡⲣⲟⲫⲏⲧⲏⲥ	ⲙ|ⲡⲣⲟⲫⲏⲧⲏⲥ
ⲛⲙⲙⲩⲥⲧⲏⲣⲓⲟⲛ	ⲛ|ⲙ|ⲙⲩⲥⲧⲏⲣⲓⲟⲛ
ⲛⲑⲉⲁⲧⲣⲟⲛ	ⲛ|ⲑⲉⲁⲧⲣⲟⲛ
ⲧⲥⲟⲫⲓⲁ	ⲧ|ⲥⲟⲫⲓⲁ
ⲉⲧⲣⲉⲩϯⲡⲉⲩⲟⲓ	ⲉ|ⲧⲣⲉ|ⲩ|ϯⲡⲉⲩⲟⲓ
ϫ[ⲉ]	ϫ[ⲉ]
ϫⲛⲉⲙⲟⲟⲩⲧⲥ	ϫⲛ|ⲉ|ⲙⲟⲟⲩⲧ|ⲥ
ⲉⲓⲟ	ⲉ|ⲓ|ⲟ
ⲛⲉⲃⲟⲗ	ⲛⲉⲃⲟⲗ
ϩⲛⲧⲥⲩⲛⲁⲅⲱⲅⲏ	ϩⲛ|ⲧ|ⲥⲩⲛⲁⲅⲱⲅⲏ
ⲉⲛⲕⲟⲟⲩⲉ	ⲉ|ⲛ|ⲕⲟⲟⲩⲉ
ⲉⲣⲉⲛⲉⲛϣⲏⲣⲉ	ⲉⲣⲉ|ⲛⲉⲛ|ϣⲏⲣⲉ
ⲟⲩⲙⲧⲟⲛ	ⲟⲩ|ⲙⲧⲟⲛ
ⲑⲓⲙⲉ	ⲑ|ⲓⲙⲉ
ϫⲉⲁⲩⲙⲟⲣϥ	ϫⲉ|ⲁ|ⲩ|ⲙⲟⲣ|ϥ
ϩⲛϩⲉⲛϩⲣⲟⲟⲩ	ϩⲛ|ϩⲉⲛ|ϩⲣⲟⲟⲩ
ⲁⲓⲡⲁⲣⲁⲓⲧⲉⲓ	ⲁ|ⲓ|ⲡⲁⲣⲁⲓⲧⲉⲓ
ϩⲙⲡⲙⲁ	ϩⲙ|ⲡ|ⲙⲁ
ⲡⲕⲉⲥⲉⲉⲡⲉ	ⲡ|ⲕⲉ|ⲥⲉⲉⲡⲉ
ϫⲓⲧⲉϥⲥϩⲓⲙⲉ	ϫⲓ|ⲧⲉϥ|ⲥϩⲓⲙⲉ
ⲙⲡⲁⲗⲁⲟⲥ	ⲙ|ⲡⲁ|ⲗⲁⲟⲥ
ϩⲟⲩo	ϩⲟⲩo
ⲛⲧⲁⲓⲱⲥⲓⲁⲥ	ⲛⲧ|ⲁ|ⲓⲱⲥⲓⲁⲥ
ⲛⲉϥⲣⲱⲙⲉ	ⲛⲉϥ|ⲣⲱⲙⲉ
ⲡⲉⲧⲛⲁⲕⲗⲏⲣⲟⲛⲟⲙⲉⲓ	ⲡ|ⲉⲧ|ⲛⲁ|ⲕⲗⲏⲣⲟⲛⲟⲙⲉⲓ
ⲙⲛϩⲉⲛⲕⲉϩⲃⲏⲩⲉ	ⲙⲛ|ϩⲉⲛ|ⲕⲉ|ϩⲃⲏⲩⲉ
ϩⲓⲧⲛⲡⲛⲟⲩⲧⲉ	ϩⲓⲧⲛ|ⲡ|ⲛⲟⲩⲧⲉ
ϩⲁⲑⲏ	ϩⲁⲑⲏ
ⲙⲏⲣ	ⲙⲏⲣ
ⲛⲧⲉⲩⲙⲛⲧϩⲏⲕⲉ	ⲛ|ⲧⲉⲩ|ⲙⲛⲧϩⲏⲕⲉ
ⲛⲧⲁϥⲥⲱⲛⲧ	ⲛ|ⲧⲁ|ϥ|ⲥⲱⲛⲧ
ⲣϩⲛⲁⲩ	ⲣ|ϩⲛⲁⲩ
ⲛⲉⲕⲗⲟⲟⲗⲉ	ⲛⲉ|ⲕⲗⲟⲟⲗⲉ
ⲙⲛⲛⲕⲟⲟⲩⲉ	ⲙⲛ|ⲛ|ⲕⲟⲟⲩⲉ
ⲛⲟⲩⲟⲓⲉϣ	ⲛ|ⲟⲩⲟⲓⲉϣ
ⲛⲁⲧⲱⲧⲛϩⲏⲧ	ⲛⲁ|ⲧⲱⲧ|ⲛ|ϩⲏⲧ
ⲛⲧⲁⲣϣⲓⲛⲉ	ⲛⲧ|ⲁⲣ|ϣⲓⲛⲉ
ϩⲟⲗⲱⲥ	ϩⲟⲗⲱⲥ
ⲙⲛϩⲉⲛⲛⲏⲥⲧⲉⲓⲁ	ⲙⲛ|ϩⲉⲛ|ⲛⲏⲥⲧⲉⲓⲁ
ⲛⲉϥϩⲓⲡⲉⲕⲣⲟ	ⲛⲉ|ϥ|ϩⲓ|ⲡⲉ|ⲕⲣⲟ
ϫⲉϩⲉⲛⲁⲕⲁⲑⲁⲣⲧⲟⲥ	ϫⲉ|ϩⲉⲛ|ⲁⲕⲁⲑⲁⲣⲧⲟⲥ
ⲛⲥⲁⲡⲉⲛⲥⲙⲟⲧ	ⲛⲥⲁ|ⲡⲉⲛ|ⲥⲙⲟⲧ
ⲟⲩϩⲟⲟⲩⲧ	ⲟⲩ|ϩⲟⲟⲩⲧ
ϣⲁⲛ	ϣⲁⲛ
ⲏ	ⲏ
ⲛϭⲓⲡⲉⲧⲟ	ⲛϭⲓ|ⲡ|ⲉⲧ|ⲟ
ⲉⲣⲉⲡⲁⲗⲉⲕⲧⲱⲣ	ⲉⲣⲉ|ⲡ|ⲁⲗⲉⲕⲧⲱⲣ
ⲉⲧⲣⲉⲛϣⲏⲣⲉ	ⲉ|ⲧⲣⲉ|ⲛ|ⲛϣⲏⲣⲉ
ⲙⲡⲉⲕⲣⲁⲛⲓⲟⲛ	ⲙ|ⲡⲉ|ⲕⲣⲁⲛⲓⲟⲛ
ⲁⲩⲧⲁϣⲉⲟⲉⲓϣ	ⲁ|ⲩ|ⲧⲁϣⲉⲟⲉⲓϣ
ⲉϩⲱⲃ	ⲉ|ϩⲱⲃ
ⲙⲛⲓⲥⲁⲁⲕ	ⲙⲛ|ⲓⲥⲁⲁⲕ
ϫⲉϫⲓⲛⲧⲉⲛⲟⲩ	ϫⲉ|ϫⲓⲛ|ⲧⲉⲛⲟⲩ
ⲁⲥⲛⲟⲩϫⲉ	ⲁ|ⲥ|ⲛⲟⲩϫⲉ
ϫⲉⲡⲁⲡⲁⲗⲓⲛ	ϫⲉ|ⲡⲁⲗⲓⲛ
ⲉϩⲣⲁⲓ	ⲉϩⲣⲁⲓ
ⲉⲣϣⲁⲛⲧⲙⲡⲉⲕⲥⲟⲛ	ⲉⲣϣⲁⲛ|ⲧⲙ|ⲡⲉⲕ|ⲥⲟⲛ
ϫⲉⲉⲛⲉⲛⲁⲩ	ϫⲉ|ⲉⲛⲉ|ⲛⲁⲩ
ⲁϥⲧⲟⲩϫⲟϥ	ⲁ|ϥ|ⲧⲟⲩϫⲟ|ϥ
ϩⲏⲧⲟⲩ	ϩⲏⲧ|ⲟⲩ
ⲉⲩⲉϥⲓ	ⲉⲩⲉ|ϥⲓ
ⲧⲱⲛ	ⲧⲱⲛ
ⲉⲡⲁϩⲟⲩ	ⲉ|ⲡⲁϩⲟⲩ
ⲙⲡⲉⲓϣⲁϫⲉ	ⲙ|ⲡⲉⲓ|ϣⲁϫⲉ
ⲛⲧⲟⲥ	ⲛⲧⲟⲥ
ⲡⲙⲟⲟⲩ	ⲡ|ⲙⲟⲟⲩ
ⲙⲡⲟⲩϫⲉⲗⲁⲁⲩ	ⲙⲡ|ⲟⲩ|ϫⲉ|ⲗⲁⲁⲩ
ⲁϥⲙⲟⲩⲧⲉ	ⲁ|ϥ|ⲙⲟⲩⲧⲉ
ⲟⲩⲟⲓ	ⲟⲩⲟⲓ
ϩⲓⲧⲛⲧⲁⲫⲟⲣⲙⲏ	ϩⲓⲧⲛ|ⲧ|ⲁⲫⲟⲣⲙⲏ
ⲙⲛⲧⲁⲧⲛⲟⲩⲧⲉ	ⲙⲛⲧⲁⲧⲛⲟⲩⲧⲉ
ⲛⲛⲉⲩϩⲃⲏⲩⲉ	ⲛ|ⲛⲉⲩ|ϩⲃⲏⲩⲉ
ⲉⲩⲧⲛⲧⲱⲛ	ⲉ|ⲩ|ⲧⲛⲧⲱⲛ
ⲁⲩϥⲓⲡⲉϥⲥⲱⲙⲁ	ⲁ|ⲩ|ϥⲓ|ⲡⲉϥ|ⲥⲱⲙⲁ
ⲛⲟⲩ	ⲛⲟⲩ
ⲛⲧⲉⲧⲛⲥⲟⲩⲧⲛ	ⲛ|ⲧⲉⲧⲛ|ⲥⲟⲩⲧⲛ
ⲛⲧϣⲉⲉⲣⲉ	ⲛ|ⲧ|ϣⲉⲉⲣⲉ
ⲛⲛⲉⲧϩⲓⲃⲟⲗ	ⲛ|ⲛ|ⲉⲧ|ϩⲓⲃⲟⲗ
ⲉⲛⲧⲁⲡⲁⲟⲩⲱϣ	ⲉⲛⲧ|ⲁ|ⲡⲁ|ⲟⲩⲱϣ
ⲛⲛⲉⲛⲉⲓⲟⲧⲉ	ⲛ|ⲛⲉⲛ|ⲉⲓⲟⲧⲉ
ⲛⲉⲛⲧⲟⲗⲏ	ⲛ|ⲉⲛⲧⲟⲗⲏ
ⲉⲟⲩⲁ	ⲉ|ⲟⲩⲁ
ⲧⲏⲣⲥ	ⲧⲏⲣ|ⲥ
ⲉϩⲉⲛⲡⲟⲛⲏⲣⲟⲛ	ⲉ|ϩⲉⲛ|ⲡⲟⲛⲏⲣⲟⲛ
ⲉⲧⲣⲉⲥⲃⲱⲕ	ⲉ|ⲧⲣⲉ|ⲥ|ⲃⲱⲕ
ϫⲉⲛⲁϩⲙϩⲁⲗ	ϫⲉ|ⲛⲁ|ϩⲙϩⲁⲗ
ⲉⲧϫⲟ	ⲉⲧ|ϫⲟ
ⲙⲡⲟⲩϯⲕⲁⲣⲡⲟⲥ	ⲙⲡ|ⲟⲩ|ϯ|ⲕⲁⲣⲡⲟⲥ
ⲛⲃⲣⲣⲉ	ⲛ|ⲃⲣⲣⲉ
ⲡⲓⲉⲣⲟ	ⲡ|ⲓⲉⲣⲟ
ⲙⲛⲛⲥⲱϣⲉ	ⲙⲛ|ⲛ|ⲥⲱϣⲉ
ⲛⲧⲉⲓⲡⲁⲣⲁⲃⲟⲗⲏ	ⲛ|ⲧⲉⲓ|ⲡⲁⲣⲁⲃⲟⲗⲏ
ⲛⲛⲉⲧⲙⲟⲟϣⲉ	ⲛ|ⲛ|ⲉⲧ|ⲙⲟⲟϣⲉ
ⲡⲉⲁⲩϫⲓⲧⲉ	ⲡⲉ|ⲁ|ⲩ|ϫⲓⲧⲉ
ϩⲛⲛⲉⲕⲕⲗⲏⲥⲓⲁ	ϩⲛ|ⲛ|ⲉⲕⲕⲗⲏⲥⲓⲁ
ⲛϣⲱⲡ	ⲛ|ϣⲱⲡ
ⲉⲧⲣⲉϥϥⲱⲧⲉ	ⲉ|ⲧⲣⲉ|ϥ|ϥⲱⲧⲉ
ⲉϫⲓ	ⲉ|ϫⲓ
ⲛⲉⲗⲟⲟⲗⲉ	ⲛ|ⲉⲗⲟⲟⲗⲉ
[.....]ⲡⲣ[..][....]ⲥ	[.....]ⲡⲣ[..][....]ⲥ
ⲟⲩⲉⲗⲁⲭⲓⲥⲧⲟⲛ	ⲟⲩ|ⲉⲗⲁⲭⲓⲥⲧⲟⲛ
ⲛⲛⲉϥⲭⲣⲏⲙⲁ	ⲛ|ⲛⲉϥ|ⲭⲣⲏⲙⲁ
ⲉⲡⲉⲕⲏⲉⲓ	ⲉ|ⲡⲉⲕ|ⲏⲉⲓ
ⲛⲭⲱⲣⲁ	ⲛ|ⲭⲱⲣⲁ
ⲙⲡⲣϭⲱ	ⲙⲡⲣ|ϭⲱ
ⲉⲕϣⲁⲛⲥⲱⲧⲙ	ⲉⲕϣⲁⲛ|ⲥⲱⲧⲙ
ⲛⲛⲛⲩⲕⲧⲉⲣⲓⲥ	ⲛ|ⲛ|ⲛⲩⲕⲧⲉⲣⲓⲥ
ϩⲧⲟⲟⲩⲉ	ϩⲧⲟⲟⲩⲉ
ⲛⲧⲁⲩⲛⲧⲟⲩ	ⲛⲧ|ⲁ|ⲩ|ⲛⲧ|ⲟⲩ
ϩⲁϩⲧⲏⲛ	ϩⲁϩⲧⲏ|ⲛ
ⲛⲧⲉⲣⲉϥⲉⲓ	ⲛⲧⲉⲣⲉ|ϥ|ⲉⲓ
ⲙⲡⲉⲧⲛⲙⲧⲟ	ⲙ|ⲡⲉⲧⲛ|ⲙⲧⲟ
ⲟⲩⲙⲛⲧⲣⲣⲟ	ⲟⲩ|ⲙⲛⲧⲣⲣⲟ
ⲛⲛⲛⲁⲁⲕⲉ	ⲛ|ⲛ|ⲛⲁⲁⲕⲉ
ⲛⲟⲩⲥⲧⲟⲗⲏ	ⲛ|ⲟⲩ|ⲥⲧⲟⲗⲏ
ⲉⲕⲣⲟⲛⲟⲥ	ⲉ|ⲕⲣⲟⲛⲟⲥ
ⲉⲧⲉⲧⲛⲉⲥⲃⲟ	ⲉ|ⲧⲉⲧⲛ|ⲉ|ⲥⲃⲟ
ⲥⲉ	ⲥⲉ
ⲉⲣϣⲁⲛⲟⲩⲁⲛⲁⲅⲕⲏ	ⲉⲣϣⲁⲛ|ⲟⲩ|ⲁⲛⲁⲅⲕⲏ
ⲡⲙⲁⲕⲁⲣⲓⲟⲥ	ⲡ|ⲙⲁⲕⲁⲣⲓⲟⲥ
ⲛⲧⲉϥϣⲧⲏⲛ	ⲛ|ⲧⲉϥ|ϣⲧⲏⲛ
ⲙⲡⲉⲙϩⲁⲟⲩ	ⲙ|ⲡⲉ|ⲙϩⲁⲟⲩ
ϩⲉⲛⲛⲩⲕⲧⲉⲣⲓⲥ	ϩⲉⲛ|ⲛⲩⲕⲧⲉⲣⲓⲥ
ⲛⲉϥϫⲱⲙⲙⲟⲥ	ⲛⲉ|ϥ|ϫⲱ|ⲙⲙⲟ|ⲥ
ⲥⲉⲛⲁⲡⲁⲣⲁⲇⲓⲇⲟⲩ	ⲥⲉ|ⲛⲁ|ⲡⲁⲣⲁⲇⲓⲇⲟⲩ
ⲙⲡⲁⲩⲗⲟⲥ	ⲙ|ⲡⲁⲩⲗⲟⲥ
ⲛⲁⲣⲭⲓⲉⲣⲉⲩⲥ	ⲛ|ⲁⲣⲭⲓⲉⲣⲉⲩⲥ
ⲙⲛⲛⲉⲧⲛⲏⲣⲡ	ⲙⲛ|ⲛⲉⲧⲛ|ⲏⲣⲡ
ⲁϥⲥϩⲁⲓ	ⲁ|ϥ|ⲥϩⲁⲓ
ⲙⲛⲡϣⲁϫⲉ	ⲙⲛ|ⲡ|ϣⲁϫⲉ
ⲛϫⲣⲟⲡ	ⲛ|ϫⲣⲟⲡ
ⲛⲛⲉⲓϩⲓⲥⲉ	ⲛ|ⲛⲉⲓ|ϩⲓⲥⲉ
ⲉϫ[.....]ϣⲏⲣⲉ	ⲉϫ[.....]|ϣⲏⲣⲉ
ⲡⲁⲥⲱⲙⲁ	ⲡⲁ|ⲥⲱⲙⲁ
ϫⲉⲡⲁⲅⲁⲑⲟⲥ	ϫⲉ|ⲡ|ⲁⲅⲁⲑⲟⲥ
ⲛⲁⲣⲭⲓⲥⲩⲛⲁⲅⲱⲅⲟⲥ	ⲛ|ⲁⲣⲭⲓⲥⲩⲛⲁⲅⲱⲅⲟⲥ
ⲉⲙⲡⲉⲗⲁⲁⲩ	ⲉ|ⲙⲡⲉ|ⲗⲁⲁⲩ
ⲛⲛⲉⲧⲙⲟⲟⲩⲧ	ⲛ|ⲛ|ⲉⲧ|ⲙⲟⲟⲩⲧ
ⲉⲡⲉⲧⲛⲧⲱϩⲙ	ⲉ|ⲡⲉⲧⲛ|ⲧⲱϩⲙ
ⲙⲛⲡⲉϥⲙⲛⲧⲥⲛⲟⲟⲩⲥ	ⲙⲛ|ⲡⲉϥ|ⲙⲛⲧⲥⲛⲟⲟⲩⲥ
ⲛⲧⲉⲡϩⲉⲣⲙⲏⲥ	ⲛⲧⲉ|ⲡ|ϩⲉⲣⲙⲏⲥ
ⲁⲩⲟⲙⲟⲩ	ⲁ|ⲩ|ⲟⲙ|ⲟⲩ
ⲁⲩⲣⲁϣⲉ	ⲁ|ⲩ|ⲣⲁϣⲉ
ⲛⲗⲁⲟⲥ	ⲛ|ⲗⲁⲟⲥ
ϩⲓϩⲛⲁⲩ	ϩⲓ|ϩⲛⲁⲩ
ⲛⲛⲉⲥⲛⲏⲩ	ⲛ|ⲛⲉ|ⲥⲛⲏⲩ
ⲛⲟⲩⲛⲁ	ⲛ|ⲟⲩ|ⲛⲁ
ⲛⲉϥⲉⲡⲓⲧⲓⲙⲁ	ⲛⲉ|ϥ|ⲉⲡⲓⲧⲓⲙⲁ
ϫⲉⲧⲉⲓⲭⲏⲣⲁ	ϫⲉ|ⲧⲉⲓ|ⲭⲏⲣⲁ
ⲉϥϫⲓⲟⲩⲁ	ⲉ|ϥ|ϫⲓⲟⲩⲁ
ϫⲉⲕϫⲱ	ϫⲉ|ⲕ|ϫⲱ
ⲛⲉⲣⲉⲡⲡⲁⲥⲭⲁ	ⲛⲉⲣⲉ|ⲡ|ⲡⲁⲥⲭⲁ
ⲛⲛⲁϩⲣⲙⲡⲛⲟⲩⲧⲉ	ⲛⲛⲁϩⲣⲙ|ⲡ|ⲛⲟⲩⲧⲉ
ⲉϥⲛⲟⲩϫⲉ	ⲉ|ϥ|ⲛⲟⲩϫⲉ
ϩⲏⲧⲥ	ϩⲏⲧ|ⲥ
ⲉⲉⲓϫⲉⲣⲟ	ⲉ|ⲉⲓ|ϫⲉⲣⲟ
ⲛⲥⲉⲛⲁϩⲱⲡ	ⲛ|ⲥⲉ|ⲛⲁ|ϩⲱⲡ
ⲡⲉⲩⲧⲱϩ	ⲡⲉⲩ|ⲧⲱϩ
ⲉϥⲓⲡⲉϥϩⲟⲉⲓⲧⲉ	ⲉ|ϥⲓ|ⲡⲉϥ|ϩⲟⲉⲓⲧⲉ
ⲙⲡⲉⲩⲁⲅⲅⲉⲗⲓⲟⲛ	ⲙ|ⲡ|ⲉⲩⲁⲅⲅⲉⲗⲓⲟⲛ
ⲉⲣⲁⲧϥ	ⲉⲣⲁⲧ|ϥ
ⲙⲛⲡⲉⲥϣⲏⲣⲉ	ⲙⲛ|ⲡⲉⲥ|ϣⲏⲣⲉ
ϩⲙⲡⲓⲕⲁⲓⲣⲟⲥ	ϩⲙ|ⲡⲓ|ⲕⲁⲓⲣⲟⲥ
ⲙⲛⲛⲉⲧⲟⲩⲁⲁⲃ	ⲙⲛ|ⲛ|ⲉⲧ|ⲟⲩⲁⲁⲃ
ⲛⲛⲥⲁϩⲟⲩ	ⲛ|ⲛ|ⲥⲁϩⲟⲩ
ⲟⲩⲏⲣ	ⲟⲩⲏⲣ
ⲉⲛⲉⲥⲛϩⲏⲧϥ	ⲉ|ⲛⲉ|ⲥ|ⲛϩⲏⲧ|ϥ
ϩⲛⲧⲓⲇⲟⲩⲙⲁⲓⲁ	ϩⲛ|ⲧ|ⲓⲇⲟⲩⲙⲁⲓⲁ
ⲧⲁⲥⲟⲣⲙⲉⲧ	ⲧⲁ|ⲥⲟⲣⲙ|ⲉⲧ
ⲟⲩⲧⲉ	ⲟⲩⲧⲉ
ⲛϩⲉⲛⲥⲟⲃⲧ	ⲛ|ϩⲉⲛ|ⲥⲟⲃⲧ
ⲉⲧⲉⲭⲱⲣⲁ	ⲉ|ⲧⲉ|ⲭⲱⲣⲁ
ⲙⲛⲡϫⲱϩⲙ	ⲙⲛ|ⲡ|ϫⲱϩⲙ
ⲉⲩⲁⲡⲉ	ⲉ|ⲩ|ⲁⲡⲉ
ⲙⲡϣⲁϩ	ⲙ|ⲡ|ϣⲁϩ
ⲛⲧⲉⲗⲁⲁⲩ	ⲛⲧⲉ|ⲗⲁⲁⲩ
ⲛⲧⲉⲣⲉϥⲙⲟⲟϣⲉ	ⲛⲧⲉⲣⲉ|ϥ|ⲙⲟⲟϣⲉ
ⲁϥⲡⲟϣⲟⲩ	ⲁ|ϥ|ⲡⲟϣ|ⲟⲩ
ⲁⲩⲥⲓ	ⲁ|ⲩ|ⲥⲓ
ⲟⲩⲡⲓⲥⲧⲟⲥ	ⲟⲩ|ⲡⲓⲥⲧⲟⲥ
ⲙⲙⲛⲡⲣⲟⲫⲏⲧⲏⲥ	ⲙⲙⲛ|ⲡⲣⲟⲫⲏⲧⲏⲥ
ⲉϥϫⲓ	ⲉ|ϥ|ϫⲓ
ⲙⲛⲧⲉϥⲙⲁⲁⲩ	ⲙⲛ|ⲧⲉ|ϥ|ⲙⲁⲁⲩ
ⲛⲁⲥⲱⲧⲙ	ⲛⲁ|ⲥⲱⲧⲙ
ⲛⲧⲉⲧⲛⲧⲁϣⲉⲟⲉⲓϣ	ⲛ|ⲧⲉⲧⲛ|ⲧⲁϣⲉⲟⲉⲓϣ
ⲙⲡⲉⲧⲛⲥⲱⲙⲁ	ⲙ|ⲡⲉⲧⲛ|ⲥⲱⲙⲁ
ⲙⲡⲁⲅⲁⲑⲟⲛ	ⲙ|ⲡ|ⲁⲅⲁⲑⲟⲛ
ⲉⲧϩⲙϩⲙ	ⲉⲧ|ϩⲙϩⲙ
ⲉⲛⲉⲥⲉⲣⲏⲩ	ⲉ|ⲛⲉⲥ|ⲉⲣⲏⲩ
ⲛⲕⲉⲥⲟⲟⲛⲉ	ⲛ|ⲕⲉ|ⲥⲟⲟⲛⲉ
ⲛⲟⲩⲕⲟⲩⲉⲓ	ⲛ|ⲟⲩ|ⲕⲟⲩⲉⲓ
ⲙⲟⲩⲧⲉ	ⲙⲟⲩⲧⲉ
ⲛⲉⲟⲩⲛⲧϥ	ⲛⲉ|ⲟⲩⲛⲧ|ϥ
ⲉⲣⲟⲩⲇⲓⲡⲛⲟⲛ	ⲉ|ⲣ|ⲟⲩ|ⲇⲓⲡⲛⲟⲛ
ⲩϣⲏ	ⲩϣⲏ
ⲛⲟⲩⲗⲉⲗⲟⲩ	ⲛ|ⲟⲩ|ⲗⲉⲗⲟⲩ
ⲧⲟⲩⲛⲧⲏⲩⲧⲛ	ⲧⲟⲩⲛ|ⲧⲏⲩⲧⲛ
ⲣⲟⲩϩⲉ	ⲣⲟⲩϩⲉ
ⲉⲛⲟⲗⲟⲕⲁⲩⲧⲱⲙⲁ	ⲉ|ⲛ|ⲟⲗⲟⲕⲁⲩⲧⲱⲙⲁ
ⲁⲩϯⲁⲁⲥ	ⲁ|ⲩ|ϯⲁⲁⲥ
ⲛϭⲓⲟⲩⲥϩⲓⲙⲉ	ⲛϭⲓ|ⲟⲩ|ⲥϩⲓⲙⲉ
ⲛⲥⲉⲛⲁϫⲓϩⲁⲓ	ⲛ|ⲥⲉ|ⲛⲁ|ϫⲓϩⲁⲓ
ⲉⲁϥϫⲱⲕ	ⲉ|ⲁ|ϥ|ϫⲱⲕ
ⲉⲧⲃⲉⲟⲩⲙⲟⲥⲧⲉ	ⲉⲧⲃⲉ|ⲟⲩ|ⲙⲟⲥⲧⲉ
ⲛⲛⲁⲩ	ⲛ|ⲛⲁⲩ
ⲟⲩϫⲁⲓⲉⲡⲉ	ⲟⲩ|ϫⲁⲓⲉ|ⲡⲉ
ⲉⲃⲟⲗⲃⲗ	ⲉ|ⲃⲟⲗⲃⲗ
ⲉϯⲛⲁⲕ	ⲉ|ϯ|ⲛⲁ|ⲕ
ⲉⲧⲉⲡⲓⲕⲁⲗⲉⲓ	ⲉⲧ|ⲉⲡⲓⲕⲁⲗⲉⲓ
ⲟⲩⲥⲟⲛ	ⲟⲩ|ⲥⲟⲛ
ⲉⲛⲧⲁⲡϩⲟϥ	ⲉⲛⲧ|ⲁ|ⲡ|ϩⲟϥ
ⲉⲩⲛⲁϣⲱⲡⲉ	ⲉ|ⲩ|ⲛⲁ|ϣⲱⲡⲉ
ϩⲛⲛⲉⲛϭⲓϫ	ϩⲛ|ⲛⲉⲛ|ϭⲓϫ
ⲡⲉϯϫⲱ	ⲡⲉ|ϯ|ϫⲱ
ⲙⲡⲉϥⲛⲁ	ⲙ|ⲡⲉϥ|ⲛⲁ
ⲉⲧⲃⲉ	ⲉⲧⲃⲉ
ⲉⲧⲙⲉ	ⲉⲧ|ⲙⲉ
ⲛϭⲓⲡⲉⲥⲧⲁⲩⲣⲟⲥ	ⲛϭⲓ|ⲡⲉ|ⲥⲧⲁⲩⲣⲟⲥ
ϩⲙⲡⲕⲁϩ	ϩⲙ|ⲡ|ⲕⲁϩ
ⲙⲡⲣⲡⲓⲥⲧⲉⲩⲉ	ⲙⲡⲣ|ⲡⲓⲥⲧⲉⲩⲉ
ⲧⲱⲟⲩⲛⲉ	ⲧⲱⲟⲩⲛ|ⲉ
ⲥⲟⲩⲛ	ⲥⲟⲩⲛ
ⲙⲙⲉⲉⲩⲉ	ⲙ|ⲙⲉⲉⲩⲉ
ⲙ	ⲙ
ⲁϥϫⲉⲩⲟⲩϩⲙϩⲁⲗ	ⲁ|ϥ|ϫⲉⲩ|ⲟⲩ|ϩⲙϩⲁⲗ
ⲥⲉⲛⲁϫⲡⲓϣⲱⲡⲉ	ⲥⲉ|ⲛⲁ|ϫⲡⲓ|ϣⲱⲡⲉ
ⲉⲩⲣⲙⲙⲁⲟ	ⲉ|ⲩ|ⲣⲙⲙⲁⲟ
ⲛⲧⲉⲣⲉⲥⲛⲁⲩ	ⲛⲧⲉⲣⲉ|ⲥ|ⲛⲁⲩ
ⲉⲩⲫⲣⲁⲛⲉ	ⲉⲩⲫⲣⲁⲛⲉ
ϩⲛⲁⲣⲓⲙⲁⲑⲁⲓⲟⲥ	ϩⲛ|ⲁⲣⲓⲙⲁⲑⲁⲓⲟⲥ
ⲙⲏⲧⲓ	ⲙⲏⲧⲓ
ⲁⲡⲟⲧⲁⲥⲥⲉ	ⲁⲡⲟⲧⲁⲥⲥⲉ
ⲛⲉⲧⲣϩⲟⲩⲟ	ⲛ|ⲉⲧ|ⲣϩⲟⲩⲟ
ⲉⲕϯⲥⲃⲱ	ⲉ|ⲕ|ϯⲥⲃⲱ
ⲁⲩⲛⲧϥ	ⲁ|ⲩ|ⲛⲧ|ϥ
ϩⲛⲛⲉⲩⲁⲅⲅⲓⲟⲛ	ϩⲛ|ⲛⲉⲩ|ⲁⲅⲅⲓⲟⲛ
ⲡⲛⲉⲩⲙⲁⲧⲓⲕⲟⲥ	ⲡⲛⲉⲩⲙⲁⲧⲓⲕⲟⲥ
ⲙⲡⲉⲓⲣⲱⲙⲉ	ⲙ|ⲡⲉⲓ|ⲣⲱⲙⲉ
ⲛⲥⲱⲕ	ⲛⲥⲱ|ⲕ
ⲛⲉⲧⲟⲩⲱⲙ	ⲛ|ⲉⲧ|ⲟⲩⲱⲙ
ⲛϫⲡϣⲟⲙⲧⲉ	ⲛ|ϫⲡ|ϣⲟⲙⲧⲉ
ϩⲛⲛⲉϩⲟⲟⲩ	ϩⲛ|ⲛⲉ|ϩⲟⲟⲩ
ⲛⲥⲉⲧⲙϯϣⲧⲏⲛ	ⲛ|ⲥⲉ|ⲧⲙ|ϯ|ϣⲧⲏⲛ
ⲁⲩⲛⲁⲩ	ⲁ|ⲩ|ⲛⲁⲩ
ⲉϣⲁⲩⲥⲱⲧⲙ	ⲉ|ϣⲁ|ⲩ|ⲥⲱⲧⲙ
ⲥⲉⲱϭⲧ	ⲥⲉ|ⲱϭⲧ
ⲁⲥⲧⲱⲟⲩⲛⲥ	ⲁ|ⲥ|ⲧⲱⲟⲩⲛ|ⲥ
ⲛⲥⲓⲙⲱⲛ	ⲛ|ⲥⲓⲙⲱⲛ
ⲧⲕⲉⲥϩⲓⲙⲉ	ⲧ|ⲕⲉ|ⲥϩⲓⲙⲉ
ⲛⲥⲁⲡⲉⲓⲱⲧ	ⲛⲥⲁ|ⲡ|ⲉⲓⲱⲧ
ⲛⲟⲩⲛⲟϭ	ⲛ|ⲟⲩ|ⲛⲟϭ
ⲉⲧⲣⲉⲛϫⲉ	ⲉ|ⲧⲣⲉ|ⲛ|ϫⲉ
ϫⲉⲉϥⲕⲱⲧ	ϫⲉ|ⲉ|ϥ|ⲕⲱⲧ
ⲁⲓⲧⲱϭⲉ	ⲁ|ⲓ|ⲧⲱϭⲉ
ⲛⲥⲉϫⲓϣⲕⲁⲕ	ⲛ|ⲥⲉ|ϫⲓ|ϣⲕⲁⲕ
ϩⲙⲡⲉⲓϣⲟⲙⲛⲧ	ϩⲙ|ⲡⲉⲓ|ϣⲟⲙⲛⲧ
ⲉϥϯⲃⲁⲡⲧⲓⲥⲙⲁ	ⲉ|ϥ|ϯ|ⲃⲁⲡⲧⲓⲥⲙⲁ
ⲉϣϫⲉⲟⲩⲛⲟⲩⲁ	ⲉϣϫⲉ|ⲟⲩⲛ|ⲟⲩⲁ
ϩⲙⲡⲉⲩⲧⲱⲙ	ϩⲙ|ⲡⲉⲩ|ⲧⲱⲙ
ⲛⲁⲧⲥⲱⲧⲙ	ⲛ|ⲁⲧⲥⲱⲧⲙ
ⲉⲛⲣⲱⲙⲉ	ⲉ|ⲛ|ⲣⲱⲙⲉ
ϣⲁϩⲟⲩⲛ	ϣⲁϩⲟⲩⲛ
ⲡⲉϥⲥⲧⲁⲩⲣⲟⲥ	ⲡⲉϥ|ⲥⲧⲁⲩⲣⲟⲥ
ⲙⲛⲧⲛⲟⲩⲧⲉ	ⲙⲛⲧⲛⲟⲩⲧⲉ
ϩⲁϩⲧⲛ̅ⲑⲁⲗⲁⲥⲥⲁ	ϩⲁϩⲧⲛ|ⲧ|ϩⲁⲗⲁⲥⲥⲁ
ϣⲁⲁⲡⲁ	ϣⲁ|ⲁⲡⲁ
ⲛⲣⲉϥϣⲙϣⲉⲉⲓⲇⲱⲗⲟⲛ	ⲛ|ⲣⲉϥϣⲙϣⲉ|ⲉⲓⲇⲱⲗⲟⲛ
ⲧⲟⲛⲟⲩ	ⲧⲟⲛⲟⲩ
ϩⲓⲧⲛⲧⲙⲛⲧⲥⲟϭ	ϩⲓⲧⲛ|ⲧ|ⲙⲛⲧⲥⲟϭ
ϣⲱⲡⲉ	ϣⲱⲡⲉ
ϫⲉⲁⲙⲏⲉⲓⲛ	ϫⲉ|ⲁⲙⲏⲉⲓⲛ
ⲛⲧⲁⲁⲁϥ	ⲛⲧⲁ|ⲁⲁ|ϥ
ⲛⲉⲧϫⲱⲙⲙⲟⲥ	ⲛ|ⲉⲧ|ϫⲱ|ⲙⲙⲟ|ⲥ
ⲛⲟⲩⲣϩⲙⲙⲉ	ⲛ|ⲟⲩ|ⲣϩⲙⲙⲉ
ⲉⲧⲣⲉϥⲡⲱⲱⲛⲉ	ⲉ|ⲧⲣⲉ|ϥ|ⲡⲱⲱⲛⲉ
ϩⲓϫⲛⲟⲩⲕⲁϣ	ϩⲓϫⲛ|ⲟⲩ|ⲕⲁϣ
ⲉⲧⲟⲩⲁⲁⲃ	ⲉⲧ|ⲟⲩⲁⲁⲃ
ϩⲓϫⲛⲙⲙⲁ	ϩⲓϫⲛ|ⲙ|ⲙⲁ
ϯⲛⲧⲟⲟⲧⲟⲩ	ϯ|ⲛⲧⲟⲟⲧ|ⲟⲩ
ϩⲛϩⲁⲗⲩⲥⲓⲥ	ϩⲛ|ϩⲁⲗⲩⲥⲓⲥ
ϫⲉⲁϩⲣⲟⲕ	ϫⲉ|ⲁϩⲣⲟ|ⲕ
ⲉⲓⲛⲁϣϩⲱⲡ	ⲉ|ⲓ|ⲛⲁ|ϣ|ϩⲱⲡ
ⲛⲧⲟⲩⲉⲓ	ⲛ|ⲧ|ⲟⲩⲉⲓ
ⲉϣⲁⲩⲥⲩⲣⲁ	ⲉ|ϣⲁ|ⲩ|ⲥⲩⲣⲁ
ⲉⲓⲣⲉ	ⲉⲓⲣⲉ
ⲉⲁⲡⲛⲟⲩⲧⲉ	ⲉ|ⲁ|ⲡ|ⲛⲟⲩⲧⲉ
ⲣⲱ	ⲣⲱ
ϫⲟⲟⲩⲥⲉ	ϫⲟⲟⲩ|ⲥⲉ
ⲙⲉⲣⲓⲧ	ⲙⲉⲣⲓⲧ
ϫⲉⲥⲉⲕⲱⲧⲉ	ϫⲉ|ⲥⲉ|ⲕⲱⲧⲉ
ⲙⲡⲓϣϭⲙϭⲟⲙ	ⲙⲡ|ⲓ|ϣ|ϭⲙϭⲟⲙ
ⲉⲛⲉⲙⲡⲉⲡⲟⲩϩⲏⲧ	ⲉⲛⲉ|ⲙⲡⲉ|ⲡⲟⲩ|ϩⲏⲧ
ⲉⲧϯⲕⲁⲣⲡⲟⲥ	ⲉⲧ|ϯ|ⲕⲁⲣⲡⲟⲥ
ⲛⲛⲕⲟⲧⲕ	ⲛ|ⲛⲕⲟⲧⲕ
ⲡⲉⲕⲃⲟⲏⲑⲟⲥ	ⲡⲉⲕ|ⲃⲟⲏⲑⲟⲥ
ϫⲉⲉⲧⲃⲉⲡⲁⲓ	ϫⲉ|ⲉⲧⲃⲉ|ⲡⲁⲓ
ⲛⲧⲉⲡⲁⲉⲓⲱⲧ	ⲛⲧⲉ|ⲡⲁ|ⲉⲓⲱⲧ
ⲟⲩⲁⲥⲑⲉⲛⲏⲥ	ⲟⲩ|ⲁⲥⲑⲉⲛⲏⲥ
ⲛϥⲧⲁⲕⲉⲛⲉϭⲙⲏⲩ	ⲛ|ϥ|ⲧⲁⲕⲉ|ⲛⲉ|ϭⲙⲏⲩ
ϩⲛⲧⲉⲥⲙⲛⲧⲁⲧⲥⲟⲟⲩⲛ	ϩⲛ|ⲧⲉⲥ|ⲙⲛⲧⲁⲧⲥⲟⲟⲩⲛ
ⲛⲓⲙⲛ	ⲛⲓⲙ|ⲛ
ⲙⲛⲏⲥⲁⲓⲁⲥ	ⲙⲛ|ⲏⲥⲁⲓⲁⲥ
ⲡϫⲟⲉⲓⲥ	ⲡ|ϫⲟⲉⲓⲥ
ⲉⲡⲉⲕⲏⲓ	ⲉ|ⲡⲉⲕ|ⲏⲓ
ϩⲛⲟⲩⲙⲛⲧⲣⲉϥⲧⲱϩ	ϩⲛ|ⲟⲩ|ⲙⲛⲧⲣⲉϥⲧⲱϩ
ⲉⲙⲛⲛⲟⲃⲉ	ⲉ|ⲙⲛ|ⲛⲟⲃⲉ
ⲡⲙⲁⲉⲓⲛ	ⲡ|ⲙⲁⲉⲓⲛ
ϭⲱⲛⲧ	ϭⲱⲛⲧ
ⲟⲧϩ	ⲟⲧϩ
ⲙⲙⲛⲧϥⲕⲱ	ⲙⲙⲛⲧ|ϥ|ⲕⲱ
ⲉⲥⲃⲧⲉ	ⲉ|ⲥⲃⲧⲉ
ⲙⲛⲓⲁⲕⲱⲃⲟⲥ	ⲙⲛ|ⲓⲁⲕⲱⲃⲟⲥ
ⲉⲧⲛⲁϩⲉ	ⲉⲧ|ⲛⲁ|ϩⲉ
ⲛⲧⲉⲩⲯⲩⲭⲏ	ⲛ|ⲧⲉⲩ|ⲯⲩⲭⲏ
ⲙⲡⲁϫⲟⲉⲓⲥ	ⲙ|ⲡⲁ|ϫⲟⲉⲓⲥ
ϫⲉⲛⲉⲧⲁⲣⲭⲉⲓ	ϫⲉ|ⲛ|ⲉⲧ|ⲁⲣⲭⲉⲓ
ⲉⲡⲃⲟⲗ	ⲉ|ⲡ|ⲃⲟⲗ
ⲧⲛⲛⲟⲟⲩⲧ	ⲧⲛⲛⲟⲟⲩ|ⲧ
ⲉⲁⲩⲡⲁⲣⲁⲕⲁⲗⲉⲓ	ⲉ|ⲁ|ⲩ|ⲡⲁⲣⲁⲕⲁⲗⲉⲓ
ⲉⲣϩⲙϩⲁⲗ	ⲉ|ⲣ|ϩⲙϩⲁⲗ
ⲛⲉⲧⲕⲱⲗⲩ	ⲛ|ⲉⲧ|ⲕⲱⲗⲩ
ⲛⲥⲁⲛⲉϥϩⲓⲟⲟⲩⲉ	ⲛⲥⲁ|ⲛⲉϥ|ϩⲓⲟⲟⲩⲉ
ⲉⲁⲙⲁϩⲧⲉ	ⲉ|ⲁⲙⲁϩⲧⲉ
ⲛⲧⲉⲣⲉϥⲥⲱⲧⲙ	ⲛⲧⲉⲣⲉ|ϥ|ⲥⲱⲧⲙ
ⲛⲧⲉⲣⲉϥⲛⲁⲩ	ⲛⲧⲉⲣⲉ|ϥ|ⲛⲁⲩ
ⲉⲧⲃⲃⲏⲩ	ⲉⲧⲃⲃⲏ|ⲩ
ⲉⲧⲣⲉⲩⲃⲱⲕ	ⲉ|ⲧⲣⲉ|ⲩ|ⲃⲱⲕ
ⲉⲥⲓⲙⲱⲛ	ⲉ|ⲥⲓⲙⲱⲛ
ⲉⲣⲉⲧⲉϥϭⲓϫ	ⲉⲣⲉ|ⲧⲉϥ|ϭⲓϫ
ⲉⲕⲙⲟⲟϣⲉ	ⲉ|ⲕ|ⲙⲟⲟϣⲉ
ⲙⲡⲓⲟⲩⲟⲉⲓϣ	ⲙ|ⲡⲓ|ⲟⲩⲟⲉⲓϣ
ⲛⲙⲙⲁⲥ	ⲛⲙⲙⲁ|ⲥ
ⲧⲉϥ	ⲧⲉϥ
ⲙⲙⲛⲛⲟⲩⲛⲉ	ⲙⲙⲛ|ⲛⲟⲩⲛⲉ
ⲙⲙⲛϣϭⲟⲙ	ⲙⲙⲛ|ϣϭⲟⲙ
ϩⲣⲁⲃⲃⲉⲓ	ϩⲣⲁⲃⲃⲉⲓ
ⲉⲩⲛⲁϭⲱ	ⲉ|ⲩ|ⲛⲁ|ϭⲱ
ⲉⲛⲧⲉⲧⲛϩⲉⲛⲁⲧⲑⲁⲃ	ⲉ|ⲛⲧⲉⲧⲛ|ϩⲉⲛ|ⲁⲧⲑⲁⲃ
ⲉⲁϥⲥⲩⲙⲃⲟⲩⲗⲉⲩⲉ	ⲉ|ⲁ|ϥ|ⲥⲩⲙⲃⲟⲩⲗⲉⲩⲉ
ⲙⲡⲧⲁϣⲉⲟⲉⲓϣ	ⲙ|ⲡ|ⲧⲁϣⲉⲟⲉⲓϣ
ⲥⲉⲣⲙⲛⲧⲣⲉ	ⲥⲉ|ⲣⲙⲛⲧⲣⲉ
ϩⲁϩⲧⲉⲡⲕⲱϩⲧ	ϩⲁϩⲧⲉ|ⲡ|ⲕⲱϩⲧ
ⲛⲟⲩϩⲣⲉ	ⲛ|ⲟⲩ|ϩⲣⲉ
ⲉⲡⲥⲁⲧⲁⲛⲁⲥ	ⲉ|ⲡ|ⲥⲁⲧⲁⲛⲁⲥ
ⲛ̅ⲧⲟϥ	ⲛⲧⲟϥ
ⲛⲁⲉⲓ	ⲛⲁ|ⲉⲓ
ⲉⲣϣⲁⲛⲟⲩⲑⲗⲓⲯⲓⲥ	ⲉⲣϣⲁⲛ|ⲟⲩ|ⲑⲗⲓⲯⲓⲥ
ⲉⲣϩⲱⲃ	ⲉ|ⲣ|ϩⲱⲃ
ⲛⲓⲱϩⲉ	ⲛ|ⲓ|ⲱϩⲉ
ⲙⲡⲥⲣϩⲛⲁⲥ	ⲙⲡ|ⲥ|ⲣϩⲛⲁ|ⲥ
ⲛⲧⲉⲣⲉϥϫⲓⲟⲟⲣ	ⲛⲧⲉⲣⲉ|ϥ|ϫⲓⲟⲟⲣ
ϫⲉⲁⲗⲱⲧⲛ	ϫⲉ|ⲁⲗⲱ|ⲧⲛ
ⲛⲙⲙⲛⲧⲁⲡⲓⲥⲧⲟⲥ	ⲛ|ⲙ|ⲙⲛⲧⲁⲡⲓⲥⲧⲟⲥ
ⲁ	ⲁ
ⲉⲧⲉⲛⲧⲱⲧⲛ	ⲉⲧⲉ|ⲛⲧⲱⲧⲛ
ϩⲛⲛⲉⲩⲥⲡⲟⲧⲟⲩ	ϩⲛ|ⲛⲉⲩ|ⲥⲡⲟⲧⲟⲩ
ⲛⲥⲓⲟⲩⲣ	ⲛ|ⲥⲓⲟⲩⲣ
ⲛⲛⲁⲡⲉⲡⲛⲉⲩⲙⲁ	ⲛ|ⲛⲁ|ⲡⲉ|ⲡⲛⲉⲩⲙⲁ
ϩⲛⲛⲉⲛⲙⲟⲕⲙⲉⲕ	ϩⲛ|ⲛⲉⲛ|ⲙⲟⲕⲙⲉⲕ
ⲁϥⲁⲗⲉ	ⲁ|ϥ|ⲁⲗⲉ
ⲙⲙⲓⲛⲙⲙⲟⲟⲩ	ⲙⲙⲓⲛⲙⲙⲟ|ⲟⲩ
ⲁⲡⲉⲩⲥⲡⲉⲣⲙⲁ	ⲁ|ⲡⲉⲩ|ⲥⲡⲉⲣⲙⲁ
ⲉⲧⲉⲙⲙⲛϩⲁϩ	ⲉⲧⲉ|ⲙⲙⲛ|ϩⲁϩ
ⲉⲩⲃⲏⲕ	ⲉ|ⲩ|ⲃⲏⲕ
ⲁϥⲕⲧⲟϥ	ⲁ|ϥ|ⲕⲧⲟ|ϥ
ⲛⲟⲩⲟⲉⲓⲕ	ⲛ|ⲟⲩⲟⲉⲓⲕ
ⲃⲏⲥⲁⲣⲓⲟⲛ	ⲃⲏⲥⲁⲣⲓⲟⲛ
ⲙⲡⲉⲙⲧⲟ	ⲙ|ⲡⲉ|ⲙⲧⲟ
ϥⲛⲁⲛⲉϫⲡⲥⲁⲧⲁⲛⲁⲥ	ϥ|ⲛⲁ|ⲛⲉϫ|ⲡ|ⲥⲁⲧⲁⲛⲁⲥ
ⲣⲱⲧ	ⲣⲱⲧ
ϩⲓⲧⲙⲡϫⲟⲉⲓⲥ	ϩⲓⲧⲙ|ⲡ|ϫⲟⲉⲓⲥ
ⲡⲉⲧⲥⲁϣⲉ	ⲡ|ⲉⲧ|ⲥⲁϣⲉ
ϫⲉⲛⲁⲥⲛⲏⲩ	ϫⲉ|ⲛⲁ|ⲥⲛⲏⲩ
ⲙⲡⲉⲡⲛⲉⲩⲙⲁ	ⲙ|ⲡⲉ|ⲡⲛⲉⲩⲙⲁ
ⲛⲉⲩϣⲏⲣⲉⲙⲛ	ⲛⲉⲩ|ϣⲏⲣⲉ|ⲙⲛ
ⲧϩⲛⲉⲣⲱⲙⲉ	ⲧϩⲛⲉ|ⲣⲱⲙⲉ
ⲛϭⲟⲗ	ⲛ|ϭⲟⲗ
ⲧⲁⲛⲁⲅⲕⲏ	ⲧ|ⲁⲛⲁⲅⲕⲏ
ⲉⲛⲧⲁⲡⲉⲛⲉⲓⲱⲧ	ⲉⲛⲧ|ⲁ|ⲡⲉⲛ|ⲉⲓⲱⲧ
ⲉⲕϩⲩⲡⲟⲧⲁⲥⲥⲉ	ⲉ|ⲕ|ϩⲩⲡⲟⲧⲁⲥⲥⲉ
ⲛⲁⲕ	ⲛⲁ|ⲕ
ⲥⲉⲥⲱⲧⲙ	ⲥⲉ|ⲥⲱⲧⲙ
ⲉⲛϫⲓⲟⲩⲁ	ⲉ|ⲛ|ϫⲓ|ⲟⲩⲁ
ⲙⲁⲣⲓⲁ	ⲙⲁⲣⲓⲁ
ⲛⲓⲏⲥⲟⲩⲥ	ⲛ|ⲓⲏⲥⲟⲩⲥ
ϩⲛⲟⲩⲉⲝⲟⲩⲥⲓⲁ	ϩⲛ|ⲟⲩ|ⲉⲝⲟⲩⲥⲓⲁ
ϫⲉⲉⲛⲉ	ϫⲉ|ⲉⲛⲉ
ϩⲛⲧⲡⲟⲗⲓⲥ	ϩⲛ|ⲧ|ⲡⲟⲗⲓⲥ
ⲉϥϫⲟⲥⲉ	ⲉ|ϥ|ϫⲟⲥⲉ
ⲁⲥⲁⲩⲝⲁⲛⲉ	ⲁ|ⲥ|ⲁⲩⲝⲁⲛⲉ
ϩⲙⲡⲉⲓⲱⲛϩ	ϩⲙ|ⲡⲉⲓ|ⲱⲛϩ
ⲡϩⲙϩⲁⲗ	ⲡ|ϩⲙϩⲁⲗ
ⲉⲕⲁⲣⲱⲙⲉ	ⲉ|ⲕⲁ|ⲣⲱⲙⲉ
ⲁϥϩⲓⲧⲟⲟⲧϥ	ⲁ|ϥ|ϩⲓⲧⲟⲟⲧ|ϥ
ⲉⲧⲣⲉⲩϣⲓⲛⲉ	ⲉ|ⲧⲣⲉ|ⲩ|ϣⲓⲛⲉ
ⲡⲉⲧⲛⲁϯⲛⲁⲓ	ⲡ|ⲉⲧ|ⲛⲁ|ϯ|ⲛⲁⲓ
ⲛⲧⲉⲣⲉⲛⲉⲡⲛⲉⲩⲙⲁ	ⲛⲧⲉⲣⲉ|ⲛⲉ|ⲡⲛⲉⲩⲙⲁ
ⲁⲛϩⲟⲉⲓⲙ	ⲁ|ⲛ|ϩⲟⲉⲓⲙ
ⲙⲡⲟⲛⲏⲣⲟⲛ	ⲙ|ⲡⲟⲛⲏⲣⲟⲛ
ⲁⲩϫⲟⲟⲩ	ⲁ|ⲩ|ϫⲟⲟⲩ
ϩⲉⲛϣⲉ	ϩⲉⲛ|ϣⲉ
ⲉⲧⲉⲧⲛⲱⲗ	ⲉ|ⲧⲉⲧⲛ|ⲱⲗ
ⲙⲡⲉⲥⲕⲉⲣⲁⲧⲥ	ⲙⲡⲉ|ⲥ|ⲕⲉ|ⲣⲁⲧ|ⲥ
ⲛϣⲉⲗⲉⲉⲧ	ⲛ|ϣⲉⲗⲉⲉⲧ
ⲛϭⲓⲛⲥⲁⲇⲇⲟⲩⲕⲁⲓⲟⲥ	ⲛϭⲓ|ⲛ|ⲥⲁⲇⲇⲟⲩⲕⲁⲓⲟⲥ
ⲡⲉⲧⲉⲣⲉⲡⲉϥϫⲟⲉⲓⲥ	ⲡ|ⲉⲧⲉⲣⲉ|ⲡⲉ|ϥ|ϫⲟⲉⲓⲥ
ϩⲙⲡⲉⲕⲙⲉⲩⲉ	ϩⲙ|ⲡⲉⲕ|ⲙⲉⲩⲉ
ⲛϩⲏⲣⲱⲇⲓⲁⲥ	ⲛ|ϩⲏⲣⲱⲇⲓⲁⲥ
ϯⲛⲁⲣⲧⲏⲩⲧⲛ	ϯ|ⲛⲁ|ⲣ|ⲧⲏⲩⲧⲛ
ϫⲉⲁϫⲓⲥ	ϫⲉ|ⲁϫⲓ|ⲥ
ⲛⲕⲱⲃ	ⲛ|ⲕⲱⲃ
ⲉⲓϩⲁⲧⲉⲧⲏⲩⲧⲛ	ⲉ|ⲓ|ϩⲁⲧⲉ|ⲧⲏⲩⲧⲛ
ϫⲉⲧⲛϫⲕϩⲁϩ	ϫⲉ|ⲧⲛ|ϫⲕ|ϩⲁϩ
ⲁⲥⲉⲓ	ⲁ|ⲥ|ⲉⲓ
ⲉⲁⲏⲥⲁⲩ	ⲉ|ⲁ|ⲏⲥⲁⲩ
ⲉⲣⲉ	ⲉⲣⲉ
ⲉⲧⲁⲩⲝⲁⲛⲉ	ⲉⲧ|ⲁⲩⲝⲁⲛⲉ
ⲛⲉⲩϣⲉⲉⲣⲉ	ⲛⲉⲩ|ϣⲉⲉⲣⲉ
ⲛⲛⲏⲉⲓ	ⲛ|ⲛ|ⲏⲉⲓ
ⲧⲁⲙⲟ	ⲧⲁⲙⲟ
ⲙⲛⲧⲟⲩⲙⲛⲧⲃⲁⲃⲉⲣⲱⲙⲉ	ⲙⲛ|ⲧⲟⲩ|ⲙⲛⲧⲃⲁⲃⲉⲣⲱⲙⲉ
ϩⲁⲡⲉϩⲱⲃ	ϩⲁ|ⲡⲉ|ϩⲱⲃ
ⲛⲥⲁⲧⲏⲩⲧⲛ	ⲛ|ⲥⲁ|ⲧⲏⲩⲧⲛ
ⲥⲁϩⲟⲩ	ⲥⲁϩⲟⲩ
ⲛⲁⲅⲉⲗⲏ	ⲛ|ⲁⲅⲉⲗⲏ
ⲡⲉⲧⲛⲁⲥⲱⲱϥ	ⲡ|ⲉⲧ|ⲛⲁ|ⲥⲱⲱϥ
ⲁϥⲥⲉⲡⲥⲱⲡϥ	ⲁ|ϥ|ⲥⲉⲡⲥⲱⲡ|ϥ
ϫⲉⲁⲛⲟⲛ	ϫⲉ|ⲁⲛⲟⲛ
ϩⲛⲙⲁⲁⲃ	ϩⲛ|ⲙⲁⲁⲃ
ϫⲉⲉⲩⲉⲟⲩϫⲁⲓ	ϫⲉ|ⲉⲩⲉ|ⲟⲩϫⲁⲓ
ⲛⲓⲱϩⲁⲛⲛⲏⲥ	ⲛ|ⲓⲱϩⲁⲛⲛⲏⲥ
ϫⲉⲙⲡⲁⲧⲉⲛⲱⲥⲕ	ϫⲉ|ⲙⲡⲁⲧⲉ|ⲛ|ⲱⲥⲕ
ⲟⲩⲕⲁⲧⲁⲕⲣⲓⲙⲁ	ⲟⲩ|ⲕⲁⲧⲁⲕⲣⲓⲙⲁ
ϫⲉⲡⲉⲧⲛⲏⲩ	ϫⲉ|ⲡ|ⲉⲧ|ⲛⲏⲩ
ⲛⲁⲅⲁⲑⲟⲛ	ⲛ|ⲁⲅⲁⲑⲟⲛ
ⲉⲡⲉⲩⲟⲩⲱϣ	ⲉ|ⲡⲉⲩ|ⲟⲩⲱϣ
ⲛⲧⲉⲣⲉⲥⲥⲱⲧⲙ	ⲛⲧⲉⲣⲉ|ⲥ|ⲥⲱⲧⲙ
ⲉⲙⲡⲕϫⲓⲧϥ	ⲉ|ⲙⲡ|ⲕ|ϫⲓⲧ|ϥ
ⲛϥⲟⲩⲉϭⲡⲙⲡⲁⲓⲇⲉⲥ	ⲛ|ϥ|ⲟⲩⲉϭⲡ|ⲙ|ⲡⲁⲓⲇⲉⲥ
ⲁϥⲁⲓⲧⲉⲓ	ⲁ|ϥ|ⲁⲓⲧⲉⲓ
ⲉⲛⲛⲉⲧⲛⲡⲓⲥⲧⲓⲥ	ⲉⲛⲛⲉ|ⲧⲛ|ⲡⲓⲥⲧⲓⲥ
ⲁⲩⲁⲡⲟⲧⲁⲥⲥⲉ	ⲁ|ⲩ|ⲁⲡⲟⲧⲁⲥⲥⲉ
ϫⲉⲟⲩⲧⲉ	ϫⲉ|ⲟⲩⲧⲉ
ϩⲙⲡⲉⲛϩⲏⲧ	ϩⲙ|ⲡⲉⲛ|ϩⲏⲧ
ⲛϯⲛⲁⲣϩⲱⲃ	ⲛ|ϯ|ⲛⲁ|ⲣϩⲱⲃ
ⲧⲙⲧⲣⲉⲛϥⲓ	ⲧⲙ|ⲧⲣⲉ|ⲛ|ϥⲓ
ⲛⲉⲣⲉⲟⲩϩⲟⲧⲉ	ⲛⲉⲣⲉ|ⲟⲩ|ϩⲟⲧⲉ
ϫⲉⲙⲙⲛⲁⲛⲁⲥⲧⲁⲥⲓⲥ	ϫⲉ|ⲙⲙⲛ|ⲁⲛⲁⲥⲧⲁⲥⲓⲥ
ϩⲧⲟⲟⲩ	ϩⲧⲟⲟⲩ
ⲉϥⲟⲩⲏⲩ	ⲉ|ϥ|ⲟⲩⲏⲩ
ⲧⲉⲧⲛⲧⲱⲣⲡ	ⲧⲉⲧⲛ|ⲧⲱⲣⲡ
ⲛϩⲟⲩⲛ	ⲛϩⲟⲩⲛ
ϩⲛⲛⲇⲉⲓⲡⲛⲟⲛ	ϩⲛ|ⲛ|ⲇⲉⲓⲡⲛⲟⲛ
ⲙⲙⲓⲛⲉ	ⲙ|ⲙⲓⲛⲉ
ⲡⲉⲛⲧⲁⲗⲉⲅⲉⲱⲛ	ⲡⲉ|ⲛⲧ|ⲁ|ⲗⲉⲅⲉⲱⲛ
ⲉⲧⲁϣⲉⲟⲉⲓϣ	ⲉ|ⲧⲁϣⲉⲟⲉⲓϣ
ⲁϥϫⲟⲟⲩ	ⲁ|ϥ|ϫⲟⲟⲩ
ⲙⲡⲉⲓⲕⲟⲥⲙⲟⲥ	ⲙ|ⲡⲉⲓ|ⲕⲟⲥⲙⲟⲥ
ⲟⲩⲛⲧⲏⲧⲛ	ⲟⲩⲛ|ⲧⲏⲧⲛ
ⲉⲧⲣⲉⲩⲥⲧⲁⲩⲣⲟⲩ	ⲉ|ⲧⲣⲉ|ⲩ|ⲥⲧⲁⲩⲣⲟⲩ
ϫⲉⲛⲛⲉⲩⲟⲩⲟⲛϩϥ	ϫⲉ|ⲛⲛⲉ|ⲩ|ⲟⲩⲟⲛϩ|ϥ
ⲙⲡⲣϭⲱⲛⲧ	ⲙⲡⲣ|ϭⲱⲛⲧ
ϫⲉⲉⲩⲧⲛⲧⲱⲛ	ϫⲉ|ⲉ|ⲩ|ⲧⲛⲧⲱⲛ
ⲛⲟⲩϣⲁϫⲉ	ⲛ|ⲟⲩ|ϣⲁϫⲉ
ⲛⲧⲁϥϯ	ⲛⲧ|ⲁ|ϥ|ϯ
ⲛⲛⲉϥⲙⲁⲑⲏⲧⲏⲥ	ⲛ|ⲛⲉϥ|ⲙⲁⲑⲏⲧⲏⲥ
ⲙⲡⲁϣⲏⲣⲉ	ⲙ|ⲡⲁ|ϣⲏⲣⲉ
ⲉⲛⲭⲓⲗⲓⲁⲣⲭⲟⲥ	ⲉ|ⲛ|ⲭⲓⲗⲓⲁⲣⲭⲟⲥ
ⲁⲩϫⲓⲧϥ	ⲁ|ⲩ|ϫⲓⲧ|ϥ
ⲉⲓϣⲁϫⲉ	ⲉ|ⲓ|ϣⲁϫⲉ
ⲉϫⲛⲛϣⲟⲛⲧⲉ	ⲉϫⲛ|ⲛ|ϣⲟⲛⲧⲉ
ⲛⲉϫⲏⲣⲡ	ⲛⲉϫ|ⲏⲣⲡ
ⲛⲟⲩⲙⲁ	ⲛ|ⲟⲩ|ⲙⲁ
ⲙⲡⲟⲟⲩ	ⲙ|ⲡⲟⲟⲩ
ⲓⲁⲕⲱⲃ	ⲓⲁⲕⲱⲃ
ⲉⲟⲩⲙⲛⲧⲙⲛⲧⲣⲉ	ⲉ|ⲟⲩ|ⲙⲛⲧⲙⲛⲧⲣⲉ
ⲉⲡⲙⲟⲩ	ⲉ|ⲡ|ⲙⲟⲩ
ⲛϯⲁⲛⲁⲕⲣⲓⲛⲉ	ⲛ|ϯ|ⲁⲛⲁⲕⲣⲓⲛⲉ
ⲙⲛⲛⲉⲩⲉⲓⲟⲧⲉ	ⲙⲛ|ⲛⲉⲩ|ⲉⲓⲟⲧⲉ
ⲛⲧⲉⲣⲉϥⲁⲡⲟⲥⲧⲁⲥⲥⲉ	ⲛⲧⲉⲣⲉ|ϥ|ⲁⲡⲟⲥⲧⲁⲥⲥⲉ
ⲉⲩⲥⲱ	ⲉ|ⲩ|ⲥⲱ
ϫⲉⲁⲩⲙⲓϣⲉ	ϫⲉ|ⲁ|ⲩ|ⲙⲓϣⲉ
ϩⲙⲡⲧⲣⲉⲩⲥϭⲏⲣ	ϩⲙ|ⲡ|ⲧⲣⲉ|ⲩ|ⲥϭⲏⲣ
ⲙⲙⲓⲛⲙⲙⲟⲛ	ⲙⲙⲓⲛⲙⲙⲟ|ⲛ
ⲉⲧⲱⲟⲩⲛ	ⲉ|ⲧⲱⲟⲩⲛ
ⲉϫⲛⲛⲛⲟⲃⲉ	ⲉϫⲛ|ⲛ|ⲛⲟⲃⲉ
ⲧⲉⲧⲛⲣⲓⲙⲉ	ⲧⲉⲧⲛ|ⲣⲓⲙⲉ
ⲡⲉⲧⲛⲁⲥⲡ	ⲡ|ⲉⲧ|ⲛⲁ|ⲥⲡ
ⲛⲁⲧⲁⲕⲟϥ	ⲛⲁ|ⲧⲁⲕⲟ|ϥ
ⲉⲧⲛ̅ⲧⲟⲟⲧ	ⲉⲧ|ⲛ|ⲧⲟⲟⲧ
ⲙⲛⲟⲩⲑⲗⲓⲯⲓⲥ	ⲙⲛ|ⲟⲩ|ⲑⲗⲓⲯⲓⲥ
ϫⲉⲛⲁϩⲙϩⲁϩ	ϫⲉ|ⲛⲁ|ϩⲙ|ϩⲁϩ
ⲛⲥⲉⲙⲟⲟⲩⲧϥ	ⲛ|ⲥⲉ|ⲙⲟⲟⲩⲧ|ϥ
ϫⲉⲁⲛⲧⲁⲁⲛ	ϫⲉ|ⲁ|ⲛ|ⲧⲁⲁ|ⲛ
ⲕⲧⲱⲣⲡ	ⲕ|ⲧⲱⲣⲡ
ϫⲉⲧⲁⲯⲩⲭⲏ	ϫⲉ|ⲧⲁ|ⲯⲩⲭⲏ
ⲡϩⲱⲃ	ⲡ|ϩⲱⲃ
ⲉⲡⲟⲩϫⲁⲓ	ⲉ|ⲡ|ⲟⲩϫⲁⲓ
ⲁϥⲛⲉϩⲙⲛⲧⲥⲛⲟⲟⲩⲥ	ⲁ|ϥ|ⲛⲉϩ|ⲙⲛⲧⲥⲛⲟⲟⲩⲥ
ⲙⲛⲛⲉⲕⲥⲛⲏⲩ	ⲙⲛ|ⲛⲉⲕ|ⲥⲛⲏⲩ
ⲛⲟⲩⲡⲁⲣⲁⲇⲓⲥⲟⲥ	ⲛ|ⲟⲩ|ⲡⲁⲣⲁⲇⲓⲥⲟⲥ
[...]ⲟⲧⲡ	[...]ⲟⲧⲡ
ⲛⲉⲧⲧⲁϩⲙ	ⲛ|ⲉⲧ|ⲧⲁϩⲙ
ⲙⲡⲉϩⲙⲟⲧ	ⲙ|ⲡⲉ|ϩⲙⲟⲧ
ⲉⲣⲟⲓ	ⲉⲣⲟ|ⲓ
ϫⲉⲉⲩⲉⲕⲁⲁⲩ	ϫⲉ|ⲉⲩⲉ|ⲕⲁⲁ|ⲩ
ⲙⲛⲛⲉⲡⲣⲟⲫⲏⲧⲏⲥ	ⲙⲛ|ⲛⲉ|ⲡⲣⲟⲫⲏⲧⲏⲥ
ϫⲉⲧⲁⲗⲉⲓⲑⲁ	ϫⲉ|ⲧⲁⲗⲉⲓⲑⲁ
ⲙⲡⲁⲓ	ⲙ|ⲡⲁⲓ
ⲙⲛⲧⲟⲩⲙⲁⲁⲩ	ⲙⲛ|ⲧⲟⲩ|ⲙⲁⲁⲩ
ⲉϫⲙⲯⲩⲭⲏ	ⲉϫⲙ|ⲯⲩⲭⲏ
ⲉⲩⲱⲥⲕ	ⲉ|ⲩ|ⲱⲥⲕ
ⲛϥϫⲓⲃⲁⲡⲧⲓⲥⲙⲁ	ⲛ|ϥ|ϫⲓ|ⲃⲁⲡⲧⲓⲥⲙⲁ
ϫⲉⲙⲫⲟⲛⲟⲥ	ϫⲉ|ⲙ|ⲫⲟⲛⲟⲥ
ⲙⲡⲟⲩ[..]ⲥⲃⲱ	ⲙⲡⲟⲩ|[..]ⲥⲃⲱ
ϩⲓϫⲱⲓ	ϩⲓϫⲱ|ⲓ
ⲉⲧⲃⲏⲏⲧⲕ	ⲉⲧⲃⲏⲏⲧ|ⲕ
ⲉⲡⲡⲁⲡⲁⲥ	ⲉ|ⲡ|ⲡⲁⲡⲁⲥ
ⲉⲧⲉⲣⲉⲡⲁⲓ	ⲉⲧⲉⲣⲉ|ⲡⲁⲓ
ⲧⲁⲣⲉⲛⲉⲧⲥⲟⲟⲩⲛ	ⲧⲁⲣⲉ|ⲛ|ⲉⲧ|ⲥⲟⲟⲩⲛ
ϫⲉⲙⲡⲓⲙⲧⲟⲛ	ϫⲉ|ⲙⲡ|ⲓ|ⲙⲧⲟⲛ
ⲛⲛⲉⲧⲟⲛϩ	ⲛ|ⲛ|ⲉⲧ|ⲟⲛϩ
ⲛⲛⲓⲃⲗⲗⲉ	ⲛ|ⲛⲓ|ⲃⲗⲗⲉ
ⲉⲁϩⲏⲣⲱⲇⲏⲥ	ⲉ|ⲁ|ϩⲏⲣⲱⲇⲏⲥ
ⲧⲉⲧⲛϫⲱ	ⲧⲉⲧⲛ|ϫⲱ
ⲁⲩⲧⲥⲧⲟ	ⲁ|ⲩ|ⲧⲥⲧⲟ
ⲁⲩϩⲓⲟⲩⲉ	ⲁ|ⲩ|ϩⲓⲟⲩⲉ
ⲡⲉϫⲉⲓⲏⲥⲟⲩⲥ	ⲡⲉϫⲉ|ⲓⲏⲥⲟⲩⲥ
ϫⲉⲕⲁⲁⲥ	ϫⲉⲕⲁⲁⲥ
ⲥⲙⲟⲩ	ⲥⲙⲟⲩ
ⲙⲛϩⲟⲓⲛⲉ	ⲙⲛ|ϩⲟⲓⲛⲉ
ⲛⲁϭⲱ	ⲛⲁ|ϭⲱ
ϩⲛⲛⲉⲭⲁⲣⲧⲏⲥ	ϩⲛ|ⲛⲉ|ⲭⲁⲣⲧⲏⲥ
ⲁⲩϯ	ⲁ|ⲩ|ϯ
ⲛⲇⲩⲛⲁⲧⲟⲥ	ⲛ|ⲇⲩⲛⲁⲧⲟⲥ
ⲉⲁϥⲁⲙⲁϩⲧⲉ	ⲉ|ⲁ|ϥ|ⲁⲙⲁϩⲧⲉ
ϩⲛⲛⲧⲃⲧ	ϩⲛ|ⲛ|ⲧⲃⲧ
ϫⲟⲟⲥ	ϫⲟⲟ|ⲥ
ⲉⲛⲡⲁⲣⲁⲃⲟⲗⲏ	ⲉ|ⲛ|ⲡⲁⲣⲁⲃⲟⲗⲏ
ⲛⲧϩⲉ	ⲛ|ⲧ|ϩⲉ
ⲁϥⲃⲱⲕ	ⲁ|ϥ|ⲃⲱⲕ
ϣⲁⲥϯⲟⲩⲱ	ϣⲁ|ⲥ|ϯ|ⲟⲩⲱ
ⲡϣⲟⲣϣⲣ	ⲡ|ϣⲟⲣϣⲣ
ⲁϩⲟⲉⲓⲛⲉ	ⲁ|ϩⲟⲉⲓⲛⲉ
ⲛⲛϩⲓⲥⲉ	ⲛ|ⲛ|ϩⲓⲥⲉ
ⲙⲟⲕϩ	ⲙⲟⲕϩ
ⲙⲡⲉⲥϭⲙϭⲟⲙ	ⲙⲡⲉ|ⲥ|ϭⲙϭⲟⲙ
ⲛⲃⲁⲗ	ⲛ|ⲃⲁⲗ
ⲙⲛⲡⲏⲓ	ⲙⲛ|ⲡ|ⲏⲓ
ⲛⲁⲟⲩⲱⲛϩ	ⲛⲁ|ⲟⲩ|ⲱⲛϩ
ⲡⲉϫⲉⲡⲓⲗⲁⲧⲟⲥ	ⲡⲉϫⲉ|ⲡⲓⲗⲁⲧⲟⲥ
ϩⲙⲡⲉⲣⲡⲉ	ϩⲙ|ⲡⲉ|ⲣⲡⲉ
ⲉⲛⲉϥϣⲏⲣⲉ	ⲉ|ⲛⲉϥ|ϣⲏⲣⲉ
ⲛⲛⲉⲥⲓⲟⲩⲣ	ⲛ|ⲛⲉ|ⲥⲓⲟⲩⲣ
ⲉⲧⲉⲙⲛⲧⲟⲩϣⲏⲣⲉ	ⲉⲧⲉ|ⲙⲛⲧ|ⲟⲩ|ϣⲏⲣⲉ
ⲛⲛⲉⲧⲛⲁⲙⲟⲩⲟⲩⲧ	ⲛ|ⲛⲉⲧ|ⲛⲁ|ⲙⲟⲩⲟⲩⲧ
ⲉⲧⲣⲉϩⲓⲟⲛⲉ	ⲉ|ⲧⲣⲉ|ϩⲓⲟⲛⲉ
ⲡⲧⲏⲩ	ⲡ|ⲧⲏⲩ
ⲕⲁⲓ	ⲕⲁⲓ
ⲙⲡⲉϥϣⲁϫⲉ	ⲙ|ⲡⲉϥ|ϣⲁϫⲉ
ⲟⲩⲯⲩⲭⲓⲕⲟⲥ	ⲟⲩ|ⲯⲩⲭⲓⲕⲟⲥ
ⲁⲩⲛⲉϫⲧⲁϥ	ⲁ|ⲩ|ⲛⲉϫ|ⲧⲁϥ
ⲉⲩⲟⲩⲟϭⲡ	ⲉ|ⲩ|ⲟⲩⲟϭⲡ
ⲡⲏⲉⲓ	ⲡ|ⲏⲉⲓ
ⲛⲧⲁⲛⲟⲙⲓⲁ	ⲛ|ⲧ|ⲁⲛⲟⲙⲓⲁ
ϯⲥⲟⲟⲩⲛ	ϯ|ⲥⲟⲟⲩⲛ
ⲛⲧⲁϥϩⲱⲛ	ⲛ|ⲧⲁ|ϥ|ϩⲱⲛ
ⲕⲁⲁⲛ	ⲕⲁⲁ|ⲛ
ⲛⲛϩⲙϩⲁⲗ	ⲛ|ⲛ|ϩⲙϩⲁⲗ
ⲡⲟⲣϫⲥ	ⲡⲟⲣϫ|ⲥ
ⲛⲛϣⲟⲣⲡ	ⲛ|ⲛ|ϣⲟⲣⲡ
ⲁⲅⲁⲑⲟⲥ	ⲁⲅⲁⲑⲟⲥ
ⲁϥⲕⲁⲁϥ	ⲁ|ϥ|ⲕⲁⲁ|ϥ
ⲉⲡⲉϥⲣⲁⲛ	ⲉ|ⲡⲉϥ|ⲣⲁⲛ
ϩⲛⲑⲉⲛⲉⲉⲧⲏ	ϩⲛ|ⲧ|ϩⲉⲛⲉⲉⲧⲏ
ⲁⲧⲉⲧⲛⲣⲥⲟϭ	ⲁ|ⲧⲉⲧⲛ|ⲣⲥⲟϭ
ⲉⲡⲙⲁ	ⲉ|ⲡ|ⲙⲁ
ⲙⲡⲓⲙⲉⲉⲩⲉ	ⲙⲡ|ⲓ|ⲙⲉⲉⲩⲉ
ϩⲙⲡⲉϩⲟⲟⲩ	ϩⲙ|ⲡⲉ|ϩⲟⲟⲩ
ⲙⲡⲛⲁⲩ	ⲙ|ⲡ|ⲛⲁⲩ
ⲉⲧϫⲉⲣⲟ	ⲉⲧ|ϫⲉⲣⲟ
ⲛⲇⲓⲱⲅⲙⲟⲥ	ⲛ|ⲇⲓⲱⲅⲙⲟⲥ
ⲉⲧⲣⲁⲙⲟⲩ	ⲉ|ⲧⲣ|ⲁ|ⲙⲟⲩ
ⲉⲩϫⲱ	ⲉ|ⲩ|ϫⲱ
ⲛⲧⲁⲩϫⲡⲓⲟ	ⲛⲧ|ⲁ|ⲩ|ϫⲡⲓⲟ
ⲉⲩⲉⲛⲁⲩ	ⲉ|ⲩ|ⲉ|ⲛⲁⲩ
ⲙⲡⲉⲣⲣⲟ	ⲙ|ⲡⲉ|ⲣⲣⲟ
ⲙⲙⲛⲛⲥⲁϩⲟⲟⲩ	ⲙⲙⲛⲛⲥⲁ|ϩⲟⲟⲩ
ⲙⲛⲧⲙⲛⲧϫⲁⲥⲓϩⲏⲧ	ⲙⲛ|ⲧ|ⲙⲛⲧϫⲁⲥⲓϩⲏⲧ
ⲙⲛⲛⲟⲃⲉ	ⲙⲛ|ⲛⲟⲃⲉ
[ ]	[ ]
ⲁϥⲧⲁⲁⲥ	ⲁ|ϥ|ⲧⲁⲁ|ⲥ
ⲑⲉⲱⲫⲓⲗⲟⲥ	ⲑⲉⲱⲫⲓⲗⲟⲥ
ⲉⲛϩⲁⲣⲁⲧⲟⲩ	ⲉ|ⲛ|ϩⲁⲣⲁⲧ|ⲟⲩ
ⲙⲛ[...]ϣⲉⲉⲣⲉ	ⲙⲛ|[...]|ϣⲉⲉⲣⲉ
ⲉⲧⲉⲓⲛⲉ	ⲉⲧ|ⲉⲓⲛⲉ
ϫⲉⲛϯⲥⲟⲟⲩⲛ	ϫⲉ|ⲛ|ϯ|ⲥⲟⲟⲩⲛ
ⲛⲣⲉϥⲣϩⲱⲃ	ⲛ|ⲣⲉϥⲣ|ϩⲱⲃ
ⲛⲥⲱⲛⲧ	ⲛ|ⲥⲱⲛⲧ
ⲙⲱⲩⲥⲏⲥ	ⲙⲱⲩⲥⲏⲥ
ⲟⲩⲛⲟϭ	ⲟⲩ|ⲛⲟϭ
ⲛϣⲏⲣⲉϣⲏⲙ	ⲛ|ϣⲏⲣⲉ|ϣⲏⲙ
ⲙⲡⲁⲥⲭⲁ	ⲙ|ⲡⲁⲥⲭⲁ
ⲛⲧⲇⲓⲁⲑⲏⲕⲏ	ⲛ|ⲧ|ⲇⲓⲁⲑⲏⲕⲏ
ⲛⲧⲉⲭⲱⲣⲁ	ⲛ|ⲧⲉ|ⲭⲱⲣⲁ
ⲛⲧⲓⲙⲏ	ⲛ|ⲧⲓⲙⲏ
ⲛⲉⲩⲉⲣⲏⲩ	ⲛⲉⲩ|ⲉⲣⲏⲩ
ⲛⲧⲥⲱϣⲉ	ⲛ|ⲧ|ⲥⲱϣⲉ
ⲙⲡⲁⲥⲛⲁⲩ	ⲙ|ⲡⲁ|ⲥⲛⲁⲩ
ⲉⲃⲁⲡⲧⲓⲍⲉ	ⲉ|ⲃⲁⲡⲧⲓⲍⲉ
ⲛⲥⲉⲥⲟⲧⲡⲥ	ⲛ|ⲥⲉ|ⲥⲟⲧⲡ|ⲥ
ⲛⲥⲁⲟⲩⲉⲩⲕⲁⲓⲣⲓⲁ	ⲛⲥⲁ|ⲟⲩ|ⲉⲩⲕⲁⲓⲣⲓⲁ
ⲛⲧⲉⲕⲕⲁⲕⲓⲁ	ⲛ|ⲧⲉⲕ|ⲕⲁⲕⲓⲁ
ⲡⲉⲥⲃⲓⲟⲥ	ⲡⲉⲥ|ⲃⲓⲟⲥ
ⲉⲃⲱⲕ	ⲉ|ⲃⲱⲕ
ⲁⲩⲁϩⲟⲩ	ⲁⲩ|ⲁϩⲟⲩ
ϯⲛⲁⲧⲣⲉⲩⲉⲓⲣⲉ	ϯ|ⲛⲁ|ⲧⲣⲉ|ⲩ|ⲉⲓⲣⲉ
ⲉⲛⲧⲁⲩⲧⲁⲁⲥ	ⲉⲛⲧ|ⲁ|ⲩ|ⲧⲁⲁ|ⲥ
ⲙⲙⲁⲗⲁⲕⲟⲥ	ⲙ|ⲙⲁⲗⲁⲕⲟⲥ
ⲥⲉϯⲕⲗⲯ	ⲥⲉ|ϯ|ⲕⲗⲯ
ⲛⲧⲉⲥⲙⲁⲁⲩ	ⲛ|ⲧⲉⲥ|ⲙⲁⲁⲩ
ⲛ̅ⲁⲡⲁ	ⲛ|ⲁⲡⲁ
ⲁⲥⲣⲁⲛⲁϥ	ⲁ|ⲥ|ⲣⲁⲛⲁ|ϥ
ⲛⲛⲣⲉϥⲣⲛⲟⲃⲉ	ⲛ|ⲛ|ⲣⲉϥⲣⲛⲟⲃⲉ
ⲛⲧⲙⲛⲧⲉⲣⲟ	ⲛ|ⲧ|ⲙⲛⲧⲉⲣⲟ
ⲥ	ⲥ
ⲛϭⲓⲧⲙⲛⲧⲣⲣⲟ	ⲛϭⲓ|ⲧ|ⲙⲛⲧⲣⲣⲟ
ⲙⲡⲉⲓⲣⲡⲉ	ⲙ|ⲡⲉⲓ|ⲣⲡⲉ
ⲙⲡⲣⲕⲣⲓⲛⲉ	ⲙⲡⲣ|ⲕⲣⲓⲛⲉ
ⲡⲉⲧⲣⲟⲥ	ⲡⲉⲧⲣⲟⲥ
ⲛⲁⲡⲉϩⲛϩⲱⲧ	ⲛⲁ|ⲡⲉϩ|ⲛ|ϩⲱⲧ
ϩⲛⲧⲇⲉⲕⲁⲡⲟⲗⲓⲥ	ϩⲛ|ⲧ|ⲇⲉⲕⲁⲡⲟⲗⲓⲥ
ⲛⲏⲧⲛ	ⲛⲏ|ⲧⲛ
ⲛⲁⲕⲱⲧ	ⲛⲁ|ⲕⲱⲧ
ⲁϥⲕⲁⲧⲟⲟⲧϥ	ⲁ|ϥ|ⲕⲁ|ⲧⲟⲟⲧ|ϥ
ⲛⲗⲁⲁⲩ	ⲛ|ⲗⲁⲁⲩ
ⲡⲉⲧⲛⲁⲧⲱϣ	ⲡ|ⲉⲧ|ⲛⲁ|ⲧⲱϣ
ⲉⲛⲧⲁϥⲕⲁⲏⲉⲓ	ⲉⲛⲧ|ⲁ|ϥ|ⲕⲁ|ⲏⲉⲓ
ⲉⲛⲛⲁϣⲁⲁϥ	ⲉ|ⲛ|ⲛⲁ|ϣⲁⲁ|ϥ
ⲛϭⲓⲙⲙⲁⲑⲏⲧⲏⲥ	ⲛϭⲓ|ⲙ|ⲙⲁⲑⲏⲧⲏⲥ
ϩⲛⲛⲉⲩⲥⲩⲛⲁⲅⲱⲅⲏ	ϩⲛ|ⲛⲉⲩ|ⲥⲩⲛⲁⲅⲱⲅⲏ
ⲉⲓⲥ	ⲉⲓⲥ
ⲁⲧⲉⲧⲛⲕⲉⲧ	ⲁ|ⲧⲉⲧⲛ|ⲕⲉⲧ
ⲛⲁϥⲓⲡⲕⲱⲧⲉ	ⲛⲁ|ϥⲓ|ⲡ|ⲕⲱⲧⲉ
ϩⲙⲡⲕⲉⲟⲩⲁ	ϩⲙ|ⲡ|ⲕⲉ|ⲟⲩⲁ
ⲛⲓⲥⲁⲁⲕ	ⲛ|ⲓⲥⲁⲁⲕ
ⲛⲧⲛϩⲱⲃⲥ	ⲛ|ⲧⲛ|ϩⲱⲃⲥ
ⲙⲛⲃⲁⲗⲗⲁ	ⲙⲛ|ⲃⲁⲗⲗⲁ
ⲡⲇⲓⲁⲃⲟⲗⲟⲥ	ⲡ|ⲇⲓⲁⲃⲟⲗⲟⲥ
ⲙⲡⲙⲉⲉⲩⲉ	ⲙ|ⲡ|ⲙⲉⲉⲩⲉ
ⲉⲧⲥⲧⲟⲥ	ⲉ|ⲧⲥⲧⲟ|ⲥ
ⲛⲉⲛⲉϩ	ⲛ|ⲉⲛⲉϩ
ⲡⲱϩⲧ	ⲡⲱϩⲧ
ⲙⲡⲓϭⲛ	ⲙⲡ|ⲓ|ϭⲛ
ⲥⲉϣⲟⲩⲉⲓⲧ	ⲥⲉ|ϣⲟⲩⲉⲓⲧ
ⲟⲩⲛⲕⲱϩ	ⲟⲩⲛ|ⲕⲱϩ
ϩⲛⲛⲉⲕ	ϩⲛ|ⲛⲉⲕ
ⲡⲉⲧⲛⲁⲉⲓⲣⲉ	ⲡ|ⲉⲧ|ⲛⲁ|ⲉⲓⲣⲉ
ⲉⲧⲉⲡϫⲓⲟⲩⲉⲡⲉ	ⲉⲧⲉ|ⲡ|ϫⲓⲟⲩⲉ|ⲡⲉ
ⲓⲁⲉⲓⲣⲟⲥ	ⲓⲁⲉⲓⲣⲟⲥ
ⲉϫⲛⲧⲉϥⲥⲃⲱ	ⲉϫⲛ|ⲧⲉϥ|ⲥⲃⲱ
ϫⲉⲁⲛⲱϫⲛ	ϫⲉ|ⲁ|ⲛ|ⲱϫⲛ
ⲛϭⲓⲡⲣⲣⲟ	ⲛϭⲓ|ⲡ|ⲣⲣⲟ
ϣⲁⲛⲧⲉⲧⲛϭⲟⲧⲡⲟⲩ	ϣⲁⲛⲧⲉ|ⲧⲛ|ϭⲟⲧⲡ|ⲟⲩ
ⲥⲉϣⲓⲛⲉ	ⲥⲉ|ϣⲓⲛⲉ
ⲉⲧⲣⲉⲡⲉⲩⲉⲓⲱⲧ	ⲉ|ⲧⲣⲉ|ⲡⲉⲩ|ⲉⲓⲱⲧ
ⲙⲛⲧⲉⲩⲙⲛⲧⲛⲁϣⲧϩⲏⲧ	ⲙⲛ|ⲧⲉⲩ|ⲙⲛⲧⲛⲁϣⲧϩⲏⲧ
ⲥⲉⲛⲏⲥⲧⲉⲩⲉ	ⲥⲉ|ⲛⲏⲥⲧⲉⲩⲉ
ⲉⲡⲟⲩⲟⲉⲓⲛ	ⲉ|ⲡ|ⲟⲩⲟⲉⲓⲛ
ⲉⲧⲣⲉⲩⲛⲏⲥⲧⲉⲩⲉ	ⲉ|ⲧⲣⲉ|ⲩ|ⲛⲏⲥⲧⲉⲩⲉ
ⲛⲁⲣ	ⲛⲁ|ⲣ
ϩⲁⲡⲉⲕⲗⲁⲟⲥ	ϩⲁ|ⲡⲉⲕ|ⲗⲁⲟⲥ
ⲙⲙⲛⲡⲉⲧϩⲟⲃⲥ	ⲙⲙⲛ|ⲡ|ⲉⲧ|ϩⲟⲃⲥ
ϩⲙⲡⲉⲓⲁⲓⲱⲛ	ϩⲙ|ⲡⲉⲓ|ⲁⲓⲱⲛ
ϩⲙⲡϣⲟϫⲛⲉ	ϩⲙ|ⲡ|ϣⲟϫⲛⲉ
ϫⲉⲡⲉϫⲉⲡϫⲟⲉⲓⲥ	ϫⲉ|ⲡⲉϫⲉ|ⲡ|ϫⲟⲉⲓⲥ
ⲛⲛⲁⲅⲅⲉⲗⲟⲥ	ⲛ|ⲛ|ⲁⲅⲅⲉⲗⲟⲥ
ⲛⲥⲉⲧⲙⲥⲣϥⲉ	ⲛ|ⲥⲉ|ⲧⲙ|ⲥⲣϥⲉ
ⲁⲛⲟⲛ	ⲁⲛⲟⲛ
ϩⲙⲡⲉϥⲟⲩⲉϩ	ϩⲙ|ⲡⲉ|ϥ|ⲟⲩⲉϩ
ⲛⲛⲉⲩⲁⲡⲏⲩⲉ	ⲛ|ⲛⲉⲩ|ⲁⲡⲏⲩⲉ
ⲙⲡⲧⲏⲩ	ⲙ|ⲡ|ⲧⲏⲩ
ⲛⲉⲣⲉϩⲉⲛϥⲱ	ⲛⲉⲣⲉ|ϩⲉⲛ|ϥⲱ
ⲡⲙⲉϩⲥⲛⲁⲩ	ⲡ|ⲙⲉϩⲥⲛⲁⲩ
ⲕⲱⲧ	ⲕⲱⲧ
ⲉⲛϣⲟⲟⲡ	ⲉ|ⲛ|ϣⲟⲟⲡ
ⲁⲩϯⲕⲁⲣⲡⲟⲥ	ⲁ|ⲩ|ϯ|ⲕⲁⲣⲡⲟⲥ
ⲙⲡⲉⲉⲓⲕⲟⲥⲙⲟⲥ	ⲙ|ⲡⲉⲉⲓ|ⲕⲟⲥⲙⲟⲥ
ⲉⲛϯⲥⲃⲱ	ⲉ|ⲛ|ϯ|ⲥⲃⲱ
ⲉϫⲛ	ⲉϫⲛ
ⲁϥϯⲥⲃⲱ	ⲁ|ϥ|ϯⲥⲃⲱ
ⲉⲧϩⲓⲉⲣⲟⲥⲟⲗⲩⲙⲁ	ⲉ|ⲧ|ϩⲓⲉⲣⲟⲥⲟⲗⲩⲙⲁ
ⲁⲥⲧⲁⲙⲙⲉ	ⲁ|ⲥ|ⲧⲁⲙⲙⲉ
ⲛⲥⲁⲛⲃⲟⲗ	ⲛⲥⲁ|ⲛ|ⲃⲟⲗ
ⲉⲧⲕⲓⲙ	ⲉⲧ|ⲕⲓⲙ
ⲉϥⲛϩⲏⲧⲥ	ⲉ|ϥ|ⲛϩⲏⲧ|ⲥ
ϫⲉⲙⲉ	ϫⲉ|ⲙⲉ
ⲉⲣϣⲁⲛⲡϫⲟⲉⲓⲥ	ⲉⲣϣⲁⲛ|ⲡ|ϫⲟⲉⲓⲥ
ⲙⲡϫⲁⲓⲉ	ⲙ|ⲡ|ϫⲁⲓⲉ
ⲛϥⲟⲩⲱⲛϩ	ⲛ|ϥ|ⲟⲩⲱⲛϩ
ϩⲛⲟⲩⲙⲛⲧⲁⲡⲟⲧⲁⲕⲧⲓⲕⲟⲥ	ϩⲛ|ⲟⲩ|ⲙⲛⲧ|ⲁⲡⲟⲧⲁⲕⲧⲓⲕⲟⲥ
ⲙⲡⲉⲓⲑⲁⲃ	ⲙ|ⲡⲉⲓ|ⲑⲁⲃ
ⲙⲛⲡⲕⲉⲡⲉⲧⲣⲟⲥ	ⲙⲛ|ⲡ|ⲕⲉ|ⲡⲉⲧⲣⲟⲥ
ⲙⲛⲟⲩϩⲁⲓ	ⲙⲛ|ⲟⲩ|ϩⲁⲓ
ⲛϭⲓϫ	ⲛ|ϭⲓϫ
ⲉⲧϥⲟ	ⲉⲧ|ϥ|ⲟ
ϩⲙⲡⲉⲡⲛⲉⲩⲙⲁ	ϩⲙ|ⲡⲉ|ⲡⲛⲉⲩⲙⲁ
ⲁⲥⲧⲁⲁⲥ	ⲁ|ⲥ|ⲧⲁⲁ|ⲥ
ⲉⲁⲩⲥⲧⲁⲩⲣⲟⲩ	ⲉ|ⲁ|ⲩ|ⲥⲧⲁⲩⲣⲟⲩ
ϩⲱⲛ	ϩⲱⲛ
ϩⲛⲟⲩϣⲥⲛⲉ	ϩⲛ|ⲟⲩ|ϣⲥⲛⲉ
ⲛⲉⲣⲉⲛⲉⲩⲃⲁⲗ	ⲛⲉⲣⲉ|ⲛⲉⲩ|ⲃⲁⲗ
ϫⲉⲛⲅⲟⲩⲏⲩ	ϫⲉ|ⲛ|ⲅ|ⲟⲩⲏⲩ
ⲁϩⲟⲓⲛⲉ	ⲁ|ϩⲟⲓⲛⲉ
ⲡⲉⲣⲟ	ⲡⲉ|ⲣⲟ
ⲛϣⲱⲣⲡ	ⲛ|ϣⲱⲣⲡ
ⲛⲕⲟⲟϩ	ⲛ|ⲕⲟⲟϩ
ⲉⲧⲣⲉⲩⲣⲟⲉⲓⲥ	ⲉ|ⲧⲣⲉ|ⲩ|ⲣⲟⲉⲓⲥ
ⲙⲙⲛⲧⲣⲉϥϩⲉⲧⲃⲯⲩⲭⲏ	ⲙ|ⲙⲛⲧⲣⲉϥϩⲉⲧⲃⲯⲩⲭⲏ
ⲉⲣⲉⲟⲩⲟⲛⲛⲓⲙⲙⲟⲥⲧⲉ	ⲉⲣⲉ|ⲟⲩⲟⲛ|ⲛⲓⲙ|ⲙⲟⲥⲧⲉ
ϫⲉϩⲛϩⲱⲃ	ϫⲉ|ϩⲛ|ϩⲱⲃ
ⲉⲩⲡⲟⲣⲛⲉⲓⲁ	ⲉ|ⲩ|ⲡⲟⲣⲛⲉⲓⲁ
ⲙⲁⲣⲉⲛⲣⲱⲙⲉ	ⲙⲁⲣⲉ|ⲛ|ⲣⲱⲙⲉ
ⲛⲛⲟⲩϩⲓⲥⲉ	ⲛ|ⲛⲟⲩ|ϩⲓⲥⲉ
ⲙⲛⲡⲉⲕϣⲓⲡⲉ	ⲙⲛ|ⲡⲉⲕ|ϣⲓⲡⲉ
ⲛϩⲛϣⲧⲏⲛ	ⲛ|ϩⲉⲛ|ϣⲧⲏⲛ
ⲙⲛⲛϣⲏⲛ	ⲙⲛ|ⲛ|ϣⲏⲛ
ϫⲉⲥⲉⲛⲁⲧⲱⲟⲩⲛ	ϫⲉ|ⲥⲉ|ⲛⲁ|ⲧⲱⲟⲩⲛ
ⲉϥⲉⲓⲛⲉ	ⲉ|ϥ|ⲉⲓⲛⲉ
ⲉⲟⲩⲉⲙⲡⲉⲩⲟⲉⲓⲕ	ⲉ|ⲟⲩⲉⲙ|ⲡⲉⲩ|ⲟⲉⲓⲕ
ⲁⲧⲉⲧⲛϯⲛⲟⲩϭⲥ	ⲁ|ⲧⲉⲧⲛ|ϯ|ⲛⲟⲩϭⲥ
ⲁⲩⲣⲁⲧⲛⲁϩⲧⲉ	ⲁ|ⲩ|ⲣⲁⲧⲛⲁϩⲧⲉ
ⲕⲁⲧⲁⲡⲉⲩϩⲏⲧ	ⲕⲁⲧⲁ|ⲡⲉⲩ|ϩⲏⲧ
ϫⲛⲉϫⲟⲟⲥ	ϫⲛⲉ|ϫⲟⲟ|ⲥ
ⲉⲛϣⲁⲛⲉⲓⲙⲉ	ⲉⲛϣⲁⲛ|ⲉⲓⲙⲉ
ⲛⲧⲁⲧⲉⲧⲛⲧⲟϣϥ	ⲛⲧ|ⲁ|ⲧⲉⲧⲛ|ⲧⲟϣ|ϥ
ⲡⲟⲩⲁⲛⲁϫⲓ	ⲡ|ⲟⲩⲁ|ⲛⲁ|ϫⲓ
ϩⲛⲧⲉϥⲡⲟⲗⲓⲥ	ϩⲛ|ⲧⲉϥ|ⲡⲟⲗⲓⲥ
ϫⲉⲙⲛ	ϫⲉ|ⲙⲛ
ⲛϭⲁⲙⲟⲩⲗ	ⲛ|ϭⲁⲙⲟⲩⲗ
ⲛⲉⲧⲛⲛⲁⲁⲁⲩ	ⲛⲉ|ⲧⲛ|ⲛⲁ|ⲁⲁ|ⲩ
ⲉⲕⲧⲣⲩⲫⲁ	ⲉ|ⲕ|ⲧⲣⲩⲫⲁ
ⲛⲛϩⲗⲗⲟ	ⲛ|ⲛ|ϩⲗⲗⲟ
ⲧⲛ	ⲧⲛ
ⲡⲁⲣⲁⲧⲉⲩⲁⲥⲟⲩ	ⲡⲁⲣⲁ|ⲧⲉⲩ|ⲁⲥⲟⲩ
ⲙⲁⲣⲉⲡⲉⲓⲁⲡⲟⲧ	ⲙⲁⲣⲉ|ⲡⲉⲓ|ⲁⲡⲟⲧ
ⲙⲛⲛϩⲟⲟⲩⲧ	ⲙⲛ|ⲛ|ϩⲟⲟⲩⲧ
ϣⲁⲧⲡⲁϣⲉ	ϣⲁ|ⲧ|ⲡⲁϣⲉ
ⲛⲧⲁϩⲁϩ	ⲛⲧ|ⲁ|ϩⲁϩ
ⲁϥⲥⲙⲟⲩ	ⲁ|ϥ|ⲥⲙⲟⲩ
ϩⲱⲥⲧⲉ	ϩⲱⲥⲧⲉ
ⲙⲡϩⲗⲗⲟ	ⲙ|ⲡ|ϩⲗⲗⲟ
ⲙⲡϩⲓⲥⲉ	ⲙ|ⲡ|ϩⲓⲥⲉ
ⲡⲣⲡⲉ	ⲡ|ⲣⲡⲉ
ϫⲓ	ϫⲓ
ϩⲓⲧⲙⲡⲕⲱϩⲧ	ϩⲓⲧⲙ|ⲡ|ⲕⲱϩⲧ
ϣⲟⲙⲛⲧ	ϣⲟⲙⲛⲧ
ⲁϥⲣⲉϩⲧⲡϩⲙϩⲁⲗ	ⲁ|ϥ|ⲣⲉϩⲧ|ⲡ|ϩⲙϩⲁⲗ
ⲁⲩⲛⲉϫⲕⲗⲏⲣⲟⲥ	ⲁ|ⲩ|ⲛⲉϫ|ⲕⲗⲏⲣⲟⲥ
ⲛϩⲉⲛϭⲙⲏⲟⲩ	ⲛ|ϩⲉⲛ|ϭⲙⲏⲟⲩ
ⲁⲩⲙⲓϣⲉ	ⲁ|ⲩ|ⲙⲓϣⲉ
ⲛⲁⲥⲡⲁⲍⲉ	ⲛ|ⲁⲥⲡⲁⲍⲉ
ⲛⲉⲧⲛⲉⲓⲣⲉ	ⲛⲉⲧⲛ|ⲉⲓⲣⲉ
ⲛⲛⲉⲕⲥⲙⲟⲩ	ⲛ|ⲛⲉⲕ|ⲥⲙⲟⲩ
ⲙⲕⲁϩ	ⲙⲕⲁϩ
ⲡⲉϩⲙⲟⲙ	ⲡⲉ|ϩⲙⲟⲙ
ϩⲛⲧⲉⲩⲙⲛⲧⲁⲧⲥⲟⲟⲩⲛ	ϩⲛ|ⲧⲉⲩ|ⲙⲛⲧⲁⲧⲥⲟⲟⲩⲛ
ⲙⲙⲟⲓ	ⲙⲙⲟ|ⲓ
ⲡⲕⲁϩ	ⲡ|ⲕⲁϩ
ⲛⲛⲉⲥⲓ[....]ⲟⲩⲙⲁ	ⲛ|ⲛⲉ|ⲥⲓ[....]ⲟⲩ|ⲙⲁ
ⲛϩⲏⲣⲱⲇⲏⲥ	ⲛ|ϩⲏⲣⲱⲇⲏⲥ
ⲁⲩⲙⲟⲩⲧⲉ	ⲁ|ⲩ|ⲙⲟⲩⲧⲉ
ⲥⲁⲛⲟⲩϣ	ⲥⲁⲛⲟⲩϣ
ⲉⲩϣⲁⲛϫⲟⲥ	ⲉ|ⲩ|ϣⲁⲛ|ϫⲟⲥ
ϫⲉⲡϣⲏⲣⲉ	ϫⲉ|ⲡ|ϣⲏⲣⲉ
ⲉⲛⲧⲁⲩⲥⲁⲛⲟⲩϣⲉ	ⲉⲛⲧ|ⲁ|ⲩ|ⲥⲁⲛⲟⲩϣ|ⲉ
ⲡⲉⲡⲛⲉⲩⲙⲁⲧⲓⲕⲟⲥ	ⲡⲉ|ⲡⲛⲉⲩⲙⲁⲧⲓⲕⲟⲥ
ⲛⲅⲑⲃⲃⲓⲉ	ⲛ|ⲅ|ⲑⲃⲃⲓⲉ
ⲙⲛⲟⲩⲕⲓⲙ	ⲙⲛ|ⲟⲩ|ⲕⲓⲙ
ⲙⲛⲧⲙⲛⲧⲣⲙⲛϩⲏⲧ	ⲙⲛ|ⲧ|ⲙⲛⲧⲣⲙⲛϩⲏⲧ
ⲉϥⲛⲁϥⲓ	ⲉ|ϥ|ⲛⲁ|ϥⲓ
ⲁϥⲕⲱϩ	ⲁ|ϥ|ⲕⲱϩ
ⲛⲛⲉⲛⲉⲣⲏⲩ	ⲛ|ⲛⲉⲛ|ⲉⲣⲏⲩ
ⲕⲟⲩⲱϣ	ⲕ|ⲟⲩⲱϣ
ⲛⲁⲩⲏⲧ	ⲛ|ⲁⲩⲏⲧ
ⲉⲟⲩⲉⲗⲁⲭⲓⲥⲧⲟⲛ	ⲉ|ⲟⲩ|ⲉⲗⲁⲭⲓⲥⲧⲟⲛ
ⲧⲏⲙ	ⲧⲏⲙ
ⲛⲥⲱϥ	ⲛⲥⲱ|ϥ
ⲛⲍⲉⲃⲉⲇⲁⲓⲟⲥ	ⲛ|ⲍⲉⲃⲉⲇⲁⲓⲟⲥ
ⲉⲡⲁⲁⲅⲅⲏⲛ	ⲉ|ⲡⲁ|ⲁⲅⲅⲏⲛ
ⲛϫⲏϭⲉ	ⲛ|ϫⲏϭⲉ
ⲉⲙⲁⲩⲕⲁⲁⲩ	ⲉ|ⲙⲁ|ⲩ|ⲕⲁⲁ|ⲩ
ϩⲛⲓⲥⲁⲁⲕ	ϩⲛ|ⲓⲥⲁⲁⲕ
ⲧⲛⲡⲁⲣⲁⲕⲁⲗⲉⲓ	ⲧⲛ|ⲡⲁⲣⲁⲕⲁⲗⲉⲓ
ⲧⲛⲥⲏϣ	ⲧⲛ|ⲥⲏϣ
ⲉⲙⲛⲗⲁⲁⲩ	ⲉ|ⲙⲛ|ⲗⲁⲁⲩ
ⲉⲉⲓⲛⲉ	ⲉ|ⲉⲓⲛⲉ
ⲛϥϩⲉ	ⲛ|ϥ|ϩⲉ
ⲡⲣⲱⲙⲉ	ⲡ|ⲣⲱⲙⲉ
ϩⲙⲡⲉⲩϣⲱⲛⲉ	ϩⲙ|ⲡⲉⲩ|ϣⲱⲛⲉ
ⲛⲕⲣⲟⲛⲟⲥ	ⲛ|ⲕⲣⲟⲛⲟⲥ
ⲛⲅⲟⲩⲱⲙ	ⲛ|ⲅ|ⲟⲩⲱⲙ
ⲡⲁⲗⲓⲛ	ⲡⲁⲗⲓⲛ
ⲁϥⲕⲱ	ⲁ|ϥ|ⲕⲱ
ⲙⲡϫⲱⲱⲣⲉ	ⲙ|ⲡ|ϫⲱⲱⲣⲉ
ϫⲉϯⲡⲓⲥⲧⲉⲩⲉ	ϫⲉ|ϯ|ⲡⲓⲥⲧⲉⲩⲉ
ⲙⲛⲛⲉⲓⲁⲥⲕⲏⲥⲓⲥ	ⲙⲛ|ⲛⲉⲓ|ⲁⲥⲕⲏⲥⲓⲥ
ⲉⲣⲉⲡⲁⲧϣⲉⲗⲉⲉⲧ	ⲉⲣⲉ|ⲡⲁ|ⲧ|ϣⲉⲗⲉⲉⲧ
ⲉⲧⲟⲟⲧⲟⲩ	ⲉⲧⲟⲟⲧ|ⲟⲩ
ⲏⲥⲁⲓⲁⲥ	ⲏⲥⲁⲓⲁⲥ
ϣⲟⲩϣⲟⲩ	ϣⲟⲩϣⲟⲩ
ⲛⲧⲉⲕⲗⲏⲣⲟⲛⲟⲙⲓⲁ	ⲛ|ⲧⲉ|ⲕⲗⲏⲣⲟⲛⲟⲙⲓⲁ
ⲛⲁⲙⲉ	ⲛⲁⲙⲉ
ⲥⲉⲉⲡⲓⲑⲩⲙⲉⲓ	ⲥⲉ|ⲉⲡⲓⲑⲩⲙⲉⲓ
ⲙⲙⲱⲩⲥⲏⲥ	ⲙ|ⲙⲱⲩⲥⲏⲥ
ⲉⲁⲩϫⲡⲟ	ⲉ|ⲁ|ⲩ|ϫⲡⲟ
ϫⲉⲉⲓⲉⲉⲓⲙⲉ	ϫⲉ|ⲉⲓⲉ|ⲉⲓⲙⲉ
ϣⲁⲩⲡⲁϩⲧⲟⲩ	ϣⲁ|ⲩ|ⲡⲁϩⲧ|ⲟⲩ
ⲛⲉⲧϩⲁⲣⲁⲧⲛ	ⲛ|ⲉⲧ|ϩⲁⲣⲁⲧ|ⲛ
ⲉϯⲕⲏⲛⲥⲟⲥ	ⲉ|ϯ|ⲕⲏⲛⲥⲟⲥ
ϫⲉⲧⲁⲡⲣⲣⲟ	ϫⲉ|ⲧⲁ|ⲡ|ⲣⲣⲟ
ⲁⲛⲅⲡⲁⲕⲏⲫⲁ	ⲁⲛⲅ|ⲡⲁ|ⲕⲏⲫⲁ
ϫⲉⲓⲁⲕⲱⲃ	ϫⲉ|ⲓⲁⲕⲱⲃ
ⲉⲧⲁⲕⲟⲛ	ⲉ|ⲧⲁⲕⲟ|ⲛ
ⲛⲧⲉⲡϫⲟⲉⲓⲥ	ⲛⲧⲉ|ⲡ|ϫⲟⲉⲓⲥ
ϫⲉⲁⲡⲉⲩⲟⲉⲓϣ	ϫⲉ|ⲁ|ⲡⲉ|ⲩⲟⲉⲓϣ
ⲙⲡⲟⲛⲏⲣⲟⲥ	ⲙ|ⲡⲟⲛⲏⲣⲟⲥ
ⲁϥⲉⲡⲓⲧⲓⲙⲁ	ⲁ|ϥ|ⲉⲡⲓⲧⲓⲙⲁ
ϣⲁϥⲉⲓ	ϣⲁ|ϥ|ⲉⲓ
ⲉⲁϥϫⲓ	ⲉ|ⲁ|ϥ|ϫⲓ
ⲉⲁⲃⲣⲁϩⲁⲙ	ⲉ|ⲁⲃⲣⲁϩⲁⲙ
ⲛⲉⲧⲉⲧⲛⲛⲁⲉⲡⲓⲑⲩⲙⲉⲓ	ⲛⲉ|ⲧⲉⲧⲛ|ⲛⲁ|ⲉⲡⲓⲑⲩⲙⲉⲓ
ϩⲛⲧⲡⲉⲧⲣⲁ	ϩⲛ|ⲧ|ⲡⲉⲧⲣⲁ
ⲉⲛⲉϥⲉⲣⲏⲩ	ⲉ|ⲛⲉϥ|ⲉⲣⲏⲩ
ϫⲉⲛϯⲛⲁⲃⲱⲕ	ϫⲉ|ⲛ|ϯ|ⲛⲁ|ⲃⲱⲕ
ⲛ̅ϭⲓⲁⲡⲁ	ⲛϭⲓ|ⲁⲡⲁ
ⲁⲩⲕⲁⲣⲱⲟⲩ	ⲁ|ⲩ|ⲕⲁⲣⲱ|ⲟⲩ
ϣⲁⲣⲟⲓ	ϣⲁⲣⲟ|ⲓ
ⲛⲉϥⲁⲅⲅⲉⲗⲟⲥ	ⲛⲉϥ|ⲁⲅⲅⲉⲗⲟⲥ
ⲛⲣⲉϥϯϩⲉ	ⲛ|ⲣⲉϥϯϩⲉ
ϫⲉⲡⲉⲧⲉⲟⲩⲛϭⲟⲙ	ϫⲉ|ⲡ|ⲉⲧⲉ|ⲟⲩⲛ|ϭⲟⲙ
ϩⲛⲧⲥⲟⲫⲓⲁ	ϩⲛ|ⲧ|ⲥⲟⲫⲓⲁ
ⲛⲉϥϩⲛⲧⲉⲣⲏⲙⲟⲥ	ⲛⲉ|ϥ|ϩⲛ|ⲧ|ⲉⲣⲏⲙⲟⲥ
ⲡⲉⲛⲧⲁϥⲡⲁⲣⲁⲇⲓⲇⲟⲩ	ⲡ|ⲉⲛⲧ|ⲁ|ϥ|ⲡⲁⲣⲁⲇⲓⲇⲟⲩ
ⲛϩⲙϫ	ⲛ|ϩⲙϫ
ⲉⲛⲉⲣⲣⲣⲟ	ⲉ|ⲛ|ⲉ|ⲣⲣⲣⲟ
ⲁϥⲉⲓⲙⲉ	ⲁ|ϥ|ⲉⲓⲙⲉ
ϩⲓϫⲛⲡⲧⲟⲟⲩ	ϩⲓϫⲛ|ⲡ|ⲧⲟⲟⲩ
ϫⲉϥⲛϩⲏⲧϥ	ϫⲉ|ϥ|ⲛϩⲏⲧ|ϥ
ⲛⲛⲉϥⲥⲃⲟⲟⲩⲉ	ⲛ|ⲛⲉϥ|ⲥⲃⲟⲟⲩⲉ
ϯϫⲱ	ϯ|ϫⲱ
ⲉⲩⲧⲁϩⲉ	ⲉ|ⲩ|ⲧⲁϩⲉ
ϩⲙⲡⲉϥϩⲟ	ϩⲙ|ⲡⲉϥ|ϩⲟ
ⲧⲉϥⲥⲏϥⲉ	ⲧⲉϥ|ⲥⲏϥⲉ
ⲉⲧⲃⲏⲏⲧⲟⲩ	ⲉⲧⲃⲏⲏⲧ|ⲟⲩ
ⲙⲛⲥⲓⲇⲱⲛ	ⲙⲛ|ⲥⲓⲇⲱⲛ
ϫⲉⲉⲣⲉⲡϫⲟⲉⲓⲥ	ϫⲉ|ⲉⲣⲉ|ⲡ|ϫⲟⲉⲓⲥ
ⲣⲱϣⲉ	ⲣⲱϣⲉ
ⲛⲣⲉϥⲥⲁϩⲟⲩ	ⲛ|ⲣⲉϥⲥⲁϩⲟⲩ
ⲛⲉⲫⲁⲣⲣⲓⲥⲁⲓⲟⲥ	ⲛⲉ|ⲫⲁⲣⲣⲓⲥⲁⲓⲟⲥ
ϫⲉⲛⲟⲩϫⲉ	ϫⲉ|ⲛⲟⲩϫⲉ
ⲁⲧⲉⲧⲛϩⲱⲣⲡ	ⲁ|ⲧⲉⲧⲛ|ϩⲱⲣⲡ
ⲧⲉⲧⲛⲟⲩⲉϩϩⲓⲥⲉ	ⲧⲉⲧⲛ|ⲟⲩⲉϩ|ϩⲓⲥⲉ
ⲕⲁⲧⲁⲡⲕⲟⲥⲙⲟⲥ	ⲕⲁⲧⲁ|ⲡ|ⲕⲟⲥⲙⲟⲥ
ⲙⲡϥϫⲓⲧϥ	ⲙⲡ|ϥ|ϫⲓⲧ|ϥ
ϩⲙⲡⲉⲥⲡⲉⲣⲙⲁ	ϩⲙ|ⲡⲉ|ⲥⲡⲉⲣⲙⲁ
ⲛⲧⲕⲟⲩϣⲟⲛⲧⲉ	ⲛⲧⲕ|ⲟⲩ|ϣⲟⲛⲧⲉ
ⲛⲛⲁⲭⲗⲟⲏ	ⲛ|ⲛⲁ|ⲭⲗⲟⲏ
ⲁⲩⲣϩⲛⲁⲩ	ⲁ|ⲩ|ⲣ|ϩⲛⲁⲩ
ϩⲁⲡⲉⲩⲃⲉⲕⲉ	ϩⲁ|ⲡⲉⲩ|ⲃⲉⲕⲉ
ⲉⲧⲃⲉⲧⲏⲩⲧⲛ	ⲉⲧⲃⲉ|ⲧⲏⲩⲧⲛ
ⲛϩⲓⲥⲉ	ⲛ|ϩⲓⲥⲉ
ⲁⲓⲥⲉⲧⲡⲧⲏⲩⲧⲛ	ⲁ|ⲓ|ⲥⲉⲧⲡ|ⲧⲏⲩⲧⲛ
ⲛⲅⲧⲁⲟⲩⲟ	ⲛ|ⲅ|ⲧⲁⲟⲩⲟ
ⲣϩⲙϩⲁⲗ	ⲣ|ϩⲙϩⲁⲗ
ⲛⲧⲁⲩⲣⲛⲟⲃⲉ	ⲛⲧ|ⲁ|ⲩ|ⲣ|ⲛⲟⲃⲉ
ⲉⲣⲉⲡⲙⲟⲩⲓⲧⲣⲣⲉ	ⲉⲣⲉ|ⲡ|ⲙⲟⲩⲓ|ⲧⲣⲣⲉ
ϩⲛⲛⲁⲅⲟⲣⲁ	ϩⲛ|ⲛ|ⲁⲅⲟⲣⲁ
ⲛⲉⲩⲡⲁⲣⲁⲧⲏⲣⲉⲓ	ⲛⲉ|ⲩ|ⲡⲁⲣⲁⲧⲏⲣⲉⲓ
ⲉⲛⲧⲁⲧⲙⲛⲧⲙⲛⲧⲣⲉ	ⲉⲛⲧ|ⲁ|ⲧ|ⲙⲛⲧⲙⲛⲧⲣⲉ
ϫⲉⲟⲩⲛⲧϥⲉⲝⲟⲩⲥⲓⲁ	ϫⲉ|ⲟⲩⲛⲧ|ϥ|ⲉⲝⲟⲩⲥⲓⲁ
ⲑⲉⲟⲇⲟⲣⲟⲥ	ⲑⲉⲟⲇⲟⲣⲟⲥ
ϣⲓⲡⲉ	ϣⲓⲡⲉ
ϯⲛⲁϣⲁϫⲉ	ϯ|ⲛⲁ|ϣⲁϫⲉ
ⲛⲉⲧⲉⲙⲙⲁⲥⲧⲓⲅⲝ	ⲛ|ⲉⲧⲉ|ⲙ|ⲙⲁⲥⲧⲓⲅⲝ
ϥϣⲟⲟⲡ	ϥ|ϣⲟⲟⲡ
ⲡⲙⲉϩϣⲟⲙⲛⲧ	ⲡ|ⲙⲉϩϣⲟⲙⲛⲧ
ⲟⲩⲉⲃⲟⲗ	ⲟⲩ|ⲉⲃⲟⲗ
ⲧⲉⲛⲙⲛⲧϩⲁⲣϣϩⲏⲧ	ⲧⲉⲛ|ⲙⲛⲧϩⲁⲣϣϩⲏⲧ
ⲉⲧⲟⲩⲉⲧⲟⲩⲱⲧ	ⲉⲧ|ⲟⲩⲉⲧⲟⲩⲱⲧ
ⲙⲡⲧⲟⲟⲩ	ⲙ|ⲡ|ⲧⲟⲟⲩ
ⲛⲧⲉⲣⲉⲟⲩϩⲟⲟⲩ	ⲛⲧⲉⲣⲉ|ⲟⲩ|ϩⲟⲟⲩ
ⲛⲟⲇⲟⲗⲗⲁ	ⲛ|ⲟⲇⲟⲗⲗⲁ
ⲁⲕⲉⲓ	ⲁ|ⲕ|ⲉⲓ
ⲙⲛⲛⲥⲁⲛⲥⲉⲡⲁⲣⲁⲇⲓⲇⲟⲩ	ⲙⲛⲛⲥⲁ|ⲛ|ⲥⲉ|ⲡⲁⲣⲁⲇⲓⲇⲟⲩ
ϩⲛⲟⲩϩⲱⲡ	ϩⲛ|ⲟⲩ|ϩⲱⲡ
ⲙ̅ⲡⲉⲓⲙⲁ	ⲙ|ⲡⲉⲓ|ⲙⲁ
ⲛⲧⲉⲧⲛϩⲉⲛⲉⲃⲟⲗ	ⲛⲧⲉⲧⲛ|ϩⲉⲛ|ⲉⲃⲟⲗ
ⲛⲧⲁϥϫⲟⲟⲥ	ⲛⲧ|ⲁ|ϥ|ϫⲟⲟ|ⲥ
ⲁⲩϫⲉⲩϩⲟⲉⲓⲛⲉ	ⲁ|ⲩ|ϫⲉⲩ|ϩⲟⲉⲓⲛⲉ
ϫⲉϩⲙⲟⲟⲥ	ϫⲉ|ϩⲙⲟⲟⲥ
ⲙⲙⲛϭⲉ	ⲙⲙⲛ|ϭⲉ
ϩⲙⲡϣⲓ	ϩⲙ|ⲡ|ϣⲓ
ⲛϭⲓⲧⲡⲏⲅⲏ	ⲛϭⲓ|ⲧ|ⲡⲏⲅⲏ
ⲛⲟⲩⲃⲉⲕⲉ	ⲛ|ⲟⲩ|ⲃⲉⲕⲉ
ⲛⲉϥϣⲟⲟⲡ	ⲛⲉ|ϥ|ϣⲟⲟⲡ
ⲉⲛⲉⲣⲅⲉⲓ	ⲉⲛⲉⲣⲅⲉⲓ
ⲉⲩϩⲟⲟⲩⲧ	ⲉ|ⲩ|ϩⲟⲟⲩⲧ
ⲉϥⲛⲏⲩ	ⲉ|ϥ|ⲛⲏⲩ
ⲛⲧⲁⲩϫⲟⲟⲥ	ⲛⲧ|ⲁ|ⲩ|ϫⲟⲟ|ⲥ
ⲉⲉⲓ	ⲉ|ⲉⲓ
ⲡⲡⲉⲧϩⲟⲟⲩ	ⲡ|ⲡ|ⲉⲧ|ϩⲟⲟⲩ
ϫⲉⲧϣⲉⲉⲣⲉ	ϫⲉ|ⲧ|ϣⲉⲉⲣⲉ
ⲉⲧⲉⲧⲛⲉⲉⲓⲙⲉ	ⲉ|ⲧⲉⲧⲛ|ⲉ|ⲉⲓⲙⲉ
ⲉⲛⲧⲉⲧⲛⲥⲟⲟⲩⲛ	ⲉ|ⲛ|ⲧⲉⲧⲛ|ⲥⲟⲟⲩⲛ
ⲙⲛϩⲉⲛⲛⲟϭ	ⲙⲛ|ϩⲉⲛ|ⲛⲟϭ
ⲟⲩⲛⲟⲩⲥⲟⲛ	ⲟⲩⲛ|ⲟⲩ|ⲥⲟⲛ
ϫⲉⲛⲧⲁⲥⲁⲑⲉⲧⲓ	ϫⲉ|ⲛⲧ|ⲁ|ⲥ|ⲁⲑⲉⲧⲓ
ⲛⲧⲁϥⲥⲙⲟⲩ	ⲛⲧ|ⲁ|ϥ|ⲥⲙⲟⲩ
ⲉⲩⲛⲁⲃⲱⲕ	ⲉ|ⲩ|ⲛⲁ|ⲃⲱⲕ
ⲙⲙⲱⲧⲛ	ⲙⲙⲱ|ⲧⲛ
ϩⲛⲛⲉⲩϩⲃⲏⲩⲉ	ϩⲛ|ⲛⲉⲩ|ϩⲃⲏⲩⲉ
ⲉϥϭⲱϣⲧ	ⲉ|ϥ|ϭⲱϣⲧ
ⲉϣⲡϩⲓⲥⲉ	ⲉ|ϣⲡ|ϩⲓⲥⲉ
ϩⲁⲣⲟϥ	ϩⲁⲣⲟ|ϥ
ⲛⲟⲩⲭⲟⲣⲧⲟⲥ	ⲛ|ⲟⲩ|ⲭⲟⲣⲧⲟⲥ
ⲛⲛⲉⲅⲣⲁⲙⲙⲁⲧⲉⲩⲥ	ⲛ|ⲛⲉ|ⲅⲣⲁⲙⲙⲁⲧⲉⲩⲥ
ⲛⲁⲕⲁⲑⲁⲣⲧⲟⲛ	ⲛ|ⲁⲕⲁⲑⲁⲣⲧⲟⲛ
ϩⲛⲙⲉ	ϩⲛ|ⲙⲉ
ⲙⲡⲏⲉⲓ	ⲙ|ⲡ|ⲏⲉⲓ
ϩⲁⲣⲱⲟⲩ	ϩⲁⲣⲱ|ⲟⲩ
ⲧⲉⲓⲙⲛⲧⲁⲧⲥⲱⲧⲙ	ⲧⲉⲓ|ⲙⲛⲧⲁⲧⲥⲱⲧⲙ
ⲙⲛⲛⲉⲧⲛϫⲓⲛϭⲟⲛⲥ	ⲙⲛ|ⲛⲉⲧⲛ|ϫⲓⲛ|ϭⲟⲛⲥ
ⲛⲥⲟⲉⲓⲧ	ⲛ|ⲥⲟⲉⲓⲧ
ⲉⲩϭⲱⲙ	ⲉ|ⲩ|ϭⲱⲙ
ϩⲛⲧⲟⲩⲙⲁⲥⲧⲓⲅⲝ	ϩⲛ|ⲧⲟⲩ|ⲙⲁⲥⲧⲓⲅⲝ
ϫⲉⲅⲟⲗⲅⲟⲑⲁ	ϫⲉ|ⲅⲟⲗⲅⲟⲑⲁ
ⲛⲛⲉⲧⲛⲁϩⲉ	ⲛ|ⲛ|ⲉⲧ|ⲛⲁ|ϩⲉ
ⲉⲧⲙⲧⲣⲉⲕϣⲗⲏⲗ	ⲉ|ⲧⲙ|ⲧⲣⲉ|ⲕ|ϣⲗⲏⲗ
ϩⲙⲡⲗⲁⲟⲥ	ϩⲙ|ⲡ|ⲗⲁⲟⲥ
ϩⲙⲡⲣⲁⲛ	ϩⲙ|ⲡ|ⲣⲁⲛ
ⲧⲙⲁⲅⲇⲁⲗⲏⲛⲏ	ⲧ|ⲙⲁⲅⲇⲁⲗⲏⲛⲏ
ⲧⲙⲉϩⲥⲛⲧⲉ	ⲧ|ⲙⲉϩⲥⲛⲧⲉ
ϩⲙⲡⲉϥⲙϩⲁⲁⲩ	ϩⲙ|ⲡⲉϥ|ⲙϩⲁⲁⲩ
ⲛⲛⲁⲓⲱⲛ	ⲛ|ⲛ|ⲁⲓⲱⲛ
ⲧⲉⲏⲡ	ⲧⲉ|ⲏⲡ
ⲙⲡⲏⲓ	ⲙ|ⲡ|ⲏⲓ
ϩⲛⲛⲉϥⲙⲉⲣⲟⲥ	ϩⲛ|ⲛⲉϥ|ⲙⲉⲣⲟⲥ
ⲡⲧⲁϫⲣⲟ	ⲡ|ⲧⲁϫⲣⲟ
ⲙⲡⲉⲧⲛϩⲱⲃ	ⲙ|ⲡⲉⲧⲛ|ϩⲱⲃ
ϩⲛϩⲉⲛⲙⲁ	ϩⲛ|ϩⲉⲛ|ⲙⲁ
ⲙⲛⲛⲉⲧϩⲛⲙⲙⲟⲩ	ⲙⲛ|ⲛ|ⲉⲧ|ϩⲛ|ⲙⲙⲟⲩ
ⲛ̅ⲟⲩϣⲏⲙ	ⲛ|ⲟⲩ|ϣⲏⲙ
ⲛⲛⲉϥϩⲙϩⲁⲗ	ⲛ|ⲛⲉϥ|ϩⲙϩⲁⲗ
ⲁϥϩⲉ	ⲁ|ϥ|ϩⲉ
ⲡⲡⲁⲥⲭⲁ	ⲡ|ⲡⲁⲥⲭⲁ
ϩⲛⲟⲩⲧⲱⲧ	ϩⲛ|ⲟⲩ|ⲧⲱⲧ
ⲟⲩⲱⲧ	ⲟⲩⲱⲧ
ⲉⲡⲅⲁⲍⲟⲫⲩⲗⲁⲕⲓⲟⲛ	ⲉ|ⲡ|ⲅⲁⲍⲟⲫⲩⲗⲁⲕⲓⲟⲛ
ⲛⲧⲉⲩϣⲏ	ⲛ|ⲧⲉ|ⲩϣⲏ
ⲉⲩⲥⲏϣ	ⲉ|ⲩ|ⲥⲏϣ
ⲛⲥϫⲓⲥⲉ	ⲛ|ⲥ|ϫⲓⲥⲉ
ⲧⲟⲗⲙⲁ	ⲧⲟⲗⲙⲁ
ⲛⲉⲩϩⲃⲏⲩⲉ	ⲛⲉⲩ|ϩⲃⲏⲩⲉ
ⲛⲥⲉⲣϣⲁ	ⲛ|ⲥⲉ|ⲣϣⲁ
ⲁϥⲡⲟϣϥ	ⲁ|ϥ|ⲡⲟϣ|ϥ
ϩⲣⲁⲭⲏⲗ	ϩⲣⲁⲭⲏⲗ
ⲉⲣⲙⲟⲛⲁⲭⲟⲥ	ⲉ|ⲣⲙⲟⲛⲁⲭⲟⲥ
ⲛⲁⲓⲛⲧⲁⲩϣⲱⲡⲉ	ⲛⲁⲓ|ⲛⲧ|ⲁ|ⲩ|ϣⲱⲡⲉ
ⲉⲧⲉⲛⲧⲱⲧⲛⲡⲉ	ⲉⲧⲉ|ⲛⲧⲱⲧⲛ|ⲡⲉ
ⲟⲩⲏϩ	ⲟⲩⲏϩ
ⲛϥϫⲟⲟⲩⲥⲉ	ⲛ|ϥ|ϫⲟⲟⲩ|ⲥⲉ
ⲉⲕϫⲱ	ⲉ|ⲕ|ϫⲱ
ⲡⲉⲧⲛⲁϫⲓⲟⲩⲁ	ⲡ|ⲉⲧ|ⲛⲁ|ϫⲓ|ⲟⲩⲁ
ϥⲛⲁϯⲟⲥⲉ	ϥ|ⲛⲁ|ϯ|ⲟⲥⲉ
ⲁⲛⲁⲕⲣⲓⲛⲉ	ⲁⲛⲁⲕⲣⲓⲛⲉ
ⲛⲥⲟϭ	ⲛ|ⲥⲟϭ
ϩⲁⲣⲁⲧϥ	ϩⲁⲣⲁⲧ|ϥ
ϫⲉⲉⲩⲥⲟⲟⲩⲛ	ϫⲉ|ⲉ|ⲩ|ⲥⲟⲟⲩⲛ
ⲙⲡϫⲱⲱⲙⲉ	ⲙ|ⲡ|ϫⲱⲱⲙⲉ
ⲉⲧⲙⲧⲣⲉⲧⲛϣⲱⲱⲧ	ⲉ|ⲧⲙ|ⲧⲣⲉ|ⲧⲛ|ϣⲱⲱⲧ
ⲉϥϯ	ⲉ|ϥ|ϯ
ⲉⲡⲁϣⲁϫⲉ	ⲉ|ⲡⲁ|ϣⲁϫⲉ
ⲧⲉⲟⲩⲱϣ	ⲧⲉ|ⲟⲩⲱϣ
ϩⲙⲡⲉϣⲧⲉⲕⲟ	ϩⲙ|ⲡⲉ|ϣⲧⲉⲕⲟ
ⲛⲧⲉⲕϩⲉ	ⲛ|ⲧⲉⲕ|ϩⲉ
ⲁϥϣⲁϫⲉ	ⲁ|ϥ|ϣⲁϫⲉ
ⲉⲧⲉϣⲁⲩϫⲓⲧⲟⲩ	ⲉⲧⲉ|ϣⲁ|ⲩ|ϫⲓⲧ|ⲟⲩ
ϫⲉⲁⲓⲡⲁⲣⲁⲇⲓⲅⲙⲁⲧⲓⲍⲉ	ϫⲉ|ⲁ|ⲓ|ⲡⲁⲣⲁⲇⲓⲅⲙⲁⲧⲓⲍⲉ
ⲁⲁϥ	ⲁⲁ|ϥ
ⲉⲛⲣⲓⲣ	ⲉ|ⲛ|ⲣⲓⲣ
ϫⲓⲛⲧⲁⲓⲣⲙⲟⲛⲁⲭⲟⲥ	ϫⲓ|ⲛⲧ|ⲁ|ⲓ|ⲣⲙⲟⲛⲁⲭⲟⲥ
ⲛϭⲓⲧⲉⲭⲱⲣⲁ	ⲛϭⲓ|ⲧⲉ|ⲭⲱⲣⲁ
ⲙⲛⲡⲁⲧⲁϣⲉⲟⲉⲓϣ	ⲙⲛ|ⲡⲁ|ⲧⲁϣⲉⲟⲉⲓϣ
ⲛⲉ	ⲛⲉ
ⲥⲟⲩⲧⲱⲛⲥ	ⲥⲟⲩⲧⲱⲛ|ⲥ
ⲉⲓⲛⲁⲣⲟⲉⲓⲥ	ⲉ|ⲓ|ⲛⲁ|ⲣⲟⲉⲓⲥ
ⲛϭⲓϩⲉⲛⲭⲣⲓⲥⲧⲟⲥ	ⲛϭⲓ|ϩⲉⲛ|ⲭⲣⲓⲥⲧⲟⲥ
ⲛⲧⲉⲧⲛϣⲛϩⲧⲏⲧⲛ	ⲛⲧⲉⲧⲛ|ϣⲛ|ϩⲧⲏ|ⲧⲛ
ⲁⲡⲉϥⲣⲁⲛ	ⲁ|ⲡⲉϥ|ⲣⲁⲛ
ϣⲁⲛⲧⲓϣⲗⲏⲗ	ϣⲁⲛⲧ|ⲓ|ϣⲗⲏⲗ
ⲕⲁⲧⲁⲡⲛⲟⲩⲧⲉ	ⲕⲁⲧⲁ|ⲡ|ⲛⲟⲩⲧⲉ
ⲉⲧϥⲛⲁⲃⲱⲕ	ⲉⲧ|ϥ|ⲛⲁ|ⲃⲱⲕ
ⲉⲣⲡⲁⲓ	ⲉ|ⲣ|ⲡⲁⲓ
ⲛⲛⲉⲕϫⲁϫⲉⲉⲩ	ⲛ|ⲛⲉⲕ|ϫⲁϫⲉⲉⲩ
ⲉⲩⲛⲟϭ	ⲉ|ⲩ|ⲛⲟϭ
ⲛϣⲁⲛϩⲧⲏϥ	ⲛ|ϣⲁ|ⲛ|ϩⲧⲏ|ϥ
ⲧⲉⲛⲟⲩ	ⲧⲉⲛⲟⲩ
ⲉⲡⲁⲣⲁⲅⲉ	ⲉ|ⲡⲁⲣⲁⲅⲉ
ⲥⲉⲛⲁϥⲓⲧϥ	ⲥⲉ|ⲛⲁ|ϥⲓⲧ|ϥ
ⲁⲣⲏⲩ	ⲁⲣⲏⲩ
ⲧⲙⲛⲧⲙⲟⲛⲁⲭⲟⲥ	ⲧ|ⲙⲛⲧⲙⲟⲛⲁⲭⲟⲥ
ⲉⲓϯⲥⲃⲱ	ⲉ|ⲓ|ϯ|ⲥⲃⲱ
ϭⲛⲁⲧ	ϭⲛⲁⲧ
ⲥⲱⲧⲙⲡⲓⲥⲣⲁⲏⲗ	ⲥⲱⲧⲙ|ⲡ|ⲓⲥⲣⲁⲏⲗ
ⲉⲡⲏⲓ	ⲉ|ⲡ|ⲏⲓ
ⲡⲱϩ	ⲡⲱϩ
ⲁⲧⲉⲧⲛϯϩⲉ	ⲁ|ⲧⲉⲧⲛ|ϯ|ϩⲉ
ⲉⲧϩⲏ	ⲉ|ⲧ|ϩⲏ
ⲉⲩⲛϩⲉⲛⲣⲱⲙⲉ	ⲉ|ⲩ|ⲛ|ϩⲉⲛ|ⲣⲱⲙⲉ
ⲉⲧⲣⲉⲛϣⲱⲡⲉ	ⲉ|ⲧⲣⲉ|ⲛ|ϣⲱⲡⲉ
ⲉⲡⲕⲉⲛⲧⲩⲣⲓⲱⲛ	ⲉ|ⲡ|ⲕⲉⲛⲧⲩⲣⲓⲱⲛ
ⲉⲁⲧⲉⲧⲛⲡⲓⲥⲧⲉⲩⲉ	ⲉ|ⲁ|ⲧⲉⲧⲛ|ⲡⲓⲥⲧⲉⲩⲉ
ⲉⲩⲉⲥⲱⲧⲙ	ⲉ|ⲩ|ⲉ|ⲥⲱⲧⲙ
ⲙⲛⲟⲩⲙⲕⲁϩ	ⲙⲛ|ⲟⲩ|ⲙⲕⲁϩ
ⲛⲁⲛϫⲱϫ	ⲛ|ⲁⲛϫⲱϫ
ⲛⲃⲁⲥⲕⲁⲛⲟⲥ	ⲛ|ⲃⲁⲥⲕⲁⲛⲟⲥ
ⲉⲧⲛⲁϣⲱⲡⲉ	ⲉⲧ|ⲛⲁ|ϣⲱⲡⲉ
ⲁϥⲕⲗⲏⲣⲟⲛⲟⲙⲉⲓ	ⲁ|ϥ|ⲕⲗⲏⲣⲟⲛⲟⲙⲉⲓ
ⲛⲧⲁⲧⲉⲧⲛϫⲓⲃⲁⲡⲧⲓⲥⲙⲁ	ⲛⲧ|ⲁ|ⲧⲉⲧⲛ|ϫⲓ|ⲃⲁⲡⲧⲓⲥⲙⲁ
ϩⲛⲧⲡⲉ	ϩⲛ|ⲧ|ⲡⲉ
ϫⲱⲕ	ϫⲱⲕ
ⲉⲡϣⲙⲙⲟ	ⲉ|ⲡ|ϣⲙⲙⲟ
ⲛⲟⲩϭⲣⲟⲟⲙⲡⲉ	ⲛ|ⲟⲩ|ϭⲣⲟⲟⲙⲡⲉ
ⲛϭⲓⲛϣⲏⲣⲉ	ⲛϭⲓ|ⲛ|ϣⲏⲣⲉ
ϫⲉⲁⲗⲏⲑⲱⲥ	ϫⲉ|ⲁⲗⲏⲑⲱⲥ
ϩⲓⲧⲛⲧⲏⲩⲧⲛ	ϩⲓⲧⲛ|ⲧⲏⲩⲧⲛ
ⲉⲛϥⲛⲁⲟⲩⲱⲛϩ	ⲉ|ⲛ|ϥ|ⲛⲁ|ⲟⲩⲱⲛϩ
ⲥⲉⲛⲁϥⲓ	ⲥⲉ|ⲛⲁ|ϥⲓ
ⲁⲥϫⲟ	ⲁ|ⲥ|ϫⲟ
ⲁⲩⲕⲗϫⲛⲉⲩⲡⲁⲧ	ⲁ|ⲩ|ⲕⲗϫ|ⲛⲉⲩ|ⲡⲁⲧ
ⲉⲩⲉⲝⲟⲙⲟⲗⲟⲅⲓ	ⲉ|ⲩ|ⲉⲝⲟⲙⲟⲗⲟⲅⲓ
ⲉⲩⲧⲁⲕⲟ	ⲉ|ⲩ|ⲧⲁⲕⲟ
ⲙⲙⲛⲕⲉⲉⲛⲧⲟⲗⲏ	ⲙⲙⲛ|ⲕⲉ|ⲉⲛⲧⲟⲗⲏ
ⲛⲅⲟ	ⲛ|ⲅ|ⲟ
ⲉϥⲟ	ⲉ|ϥⲟ
ⲉⲩⲛⲁⲩ	ⲉ|ⲩ|ⲛⲁⲩ
ⲛⲉⲩⲛⲏⲩ	ⲛⲉ|ⲩ|ⲛⲏⲩ
ⲛⲅϭⲱ	ⲛ|ⲅ|ϭⲱ
ⲛⲉⲣⲉⲧⲉϥⲁⲓⲧⲓⲁ	ⲛⲉⲣⲉ|ⲧⲉϥ|ⲁⲓⲧⲓⲁ
ϩⲉⲛⲧⲉⲓⲙⲓⲛⲉ	ϩⲉⲛ|ⲧⲉⲓ|ⲙⲓⲛⲉ
ⲛⲧⲁ	ⲛⲧⲁ
ⲛⲧⲁⲓⲥϩⲁⲓ	ⲛⲧ|ⲁ|ⲓ|ⲥϩⲁⲓ
ⲉⲧⲣⲉⲛⲉⲓⲟⲧⲉ	ⲉ|ⲧⲣⲉ|ⲛ|ⲉⲓⲟⲧⲉ
ⲛⲙϩⲉⲛⲡⲣⲟⲫⲏⲧⲏⲥ	ⲛⲙ|ϩⲉⲛ|ⲡⲣⲟⲫⲏⲧⲏⲥ
ⲧⲉⲧⲛ	ⲧⲉⲧⲛ
ϫⲉⲛⲧⲁⲇⲁⲩⲉⲓⲇ	ϫⲉ|ⲛⲧ|ⲁ|ⲇⲁⲩⲉⲓⲇ
ⲛⲧⲉⲧⲛⲕⲉⲧⲧⲏⲩⲧⲛ	ⲛ|ⲧⲉⲧⲛ|ⲕⲉⲧ|ⲧⲏⲩⲧⲛ
ϫⲉⲧⲱⲟⲩⲛ	ϫⲉ|ⲧⲱⲟⲩⲛ
ϫⲉⲁⲓⲛⲁⲩ	ϫⲉ|ⲁ|ⲓ|ⲛⲁⲩ
ⲛⲁϯ	ⲛⲁ|ϯ
ⲛⲥⲉⲛⲁϫⲓϩⲓⲙⲉ	ⲛ|ⲥⲉ|ⲛⲁ|ϫⲓϩⲓⲙⲉ
ⲛⲙⲧⲁⲡⲁⲧⲏ	ⲛⲙ|ⲧ|ⲁⲡⲁⲧⲏ
ⲛⲉⲕϣⲁϫⲉ	ⲛⲉⲕ|ϣⲁϫⲉ
ⲁⲩϣⲛⲧⲟⲩⲕⲗⲟⲙ	ⲁ|ⲩ|ϣⲛⲧ|ⲟⲩ|ⲕⲗⲟⲙ
ⲉⲧⲉⲓⲣⲉⲛϩⲉⲛⲕⲣⲟϥ	ⲉⲧ|ⲉⲓⲣⲉ|ⲛ|ϩⲉⲛ|ⲕⲣⲟϥ
ⲉⲧⲉⲧⲛⲛⲁⲃⲱⲕ	ⲉ|ⲧⲉⲧⲛ|ⲛⲁ|ⲃⲱⲕ
ⲟⲛ	ⲟⲛ
ⲙⲙⲛⲛⲥⲁⲕⲉⲕⲟⲩⲓ	ⲙⲙⲛⲛⲥⲁ|ⲕⲉ|ⲕⲟⲩⲓ
ⲁⲩϥⲓⲙⲛⲧⲥⲛⲟⲟⲩⲥ	ⲁ|ⲩ|ϥⲓ|ⲙⲛⲧⲥⲛⲟⲟⲩⲥ
ⲙⲛⲛⲥⲁϩ	ⲙⲛ|ⲛ|ⲥⲁϩ
ⲉⲃⲱⲗ	ⲉ|ⲃⲱⲗ
ⲧⲁⲁⲩⲝⲁⲛⲉ	ⲧⲁ|ⲁⲩⲝⲁⲛⲉ
ⲛⲟⲩⲥⲙⲟⲧ	ⲛ|ⲟⲩ|ⲥⲙⲟⲧ
ⲉϥⲛⲕⲟⲧⲕ	ⲉ|ϥ|ⲛⲕⲟⲧⲕ
ⲛⲥⲁⲃⲉ	ⲛ|ⲥⲁⲃⲉ
ⲛⲕⲉⲇⲁⲓⲙⲱⲛⲓⲟⲛ	ⲛ|ⲕⲉ|ⲇⲁⲓⲙⲱⲛⲓⲟⲛ
ⲛⲙⲙⲁ	ⲛ|ⲙ|ⲙⲁ
ⲓⲁⲕⲱⲃⲟⲥ	ⲓⲁⲕⲱⲃⲟⲥ
ⲙⲡⲙⲉϩⲥⲉⲡⲥⲛⲁⲩ	ⲙ|ⲡ|ⲙⲉϩⲥⲉⲡⲥⲛⲁⲩ
ⲉⲙⲛϭⲟⲙ	ⲉ|ⲙⲛ|ϭⲟⲙ
ϩⲛⲧⲙⲛⲧⲣⲣⲟ	ϩⲛ|ⲧ|ⲙⲛⲧⲣⲣⲟ
ϫⲓⲧⲟⲩ	ϫⲓⲧ|ⲟⲩ
ⲉϩⲟⲩⲉⲛⲉⲧⲛⲟⲩϫⲉ	ⲉ|ϩⲟⲩⲉ|ⲛ|ⲉⲧ|ⲛⲟⲩϫⲉ
ϩⲙⲡⲉϥϩⲟⲩⲙⲓⲥⲉ	ϩⲙ|ⲡⲉϥ|ϩⲟⲩⲙⲓⲥⲉ
ϩⲉⲛϭⲉⲣⲟⲟⲃ	ϩⲉⲛ|ϭⲉⲣⲟⲟⲃ
ⲙⲁⲓ	ⲙⲁⲓ
ⲉⲧⲣⲉⲩⲛⲁϩⲙⲟⲩ	ⲉ|ⲧⲣⲉ|ⲩ|ⲛⲁϩⲙ|ⲟⲩ
ⲉϫⲙⲡⲧⲱⲙ	ⲉϫⲙ|ⲡ|ⲧⲱⲙ
ⲉⲩϯⲕⲗⲯ	ⲉ|ⲩ|ϯⲕⲗⲯ
ⲁⲓⲥⲱ	ⲁ|ⲓ|ⲥⲱ
ⲛϯϭⲛ	ⲛ|ϯ|ϭⲛ
ⲉⲡⲧⲟⲟⲩ	ⲉ|ⲡ|ⲧⲟⲟⲩ
ⲛⲕⲉⲙⲁⲑⲏⲧⲏⲥ	ⲛ|ⲕⲉ|ⲙⲁⲑⲏⲧⲏⲥ
ⲙⲙⲓⲛⲙⲙⲱⲧⲛ	ⲙⲙⲓⲛⲙⲙⲱ|ⲧⲛ
ⲡⲉⲥⲕⲁⲣⲡⲟⲥ	ⲡⲉⲥ|ⲕⲁⲣⲡⲟⲥ
ϫⲉⲛⲧⲱⲧⲛ	ϫⲉ|ⲛⲧⲱⲧⲛ
ϫⲓⲛⲡⲉⲓⲛⲁⲩ	ϫⲓⲛ|ⲡⲉⲓ|ⲛⲁⲩ
ⲛϥⲕⲱⲧⲉ	ⲛ|ϥ|ⲕⲱⲧⲉ
ϫⲉⲛⲕⲟⲧⲕ	ϫⲉ|ⲛⲕⲟⲧⲕ
ⲧⲥⲏϥⲉⲡⲉ	ⲧ|ⲥⲏϥⲉ|ⲡⲉ
ⲛⲁⲡⲁⲣⲁⲇⲓⲇⲟⲩ	ⲛⲁ|ⲡⲁⲣⲁⲇⲓⲇⲟⲩ
ϫⲉⲟⲩⲁϣ	ϫⲉ|ⲟⲩⲁϣ
ⲙⲡⲉϥⲟⲩⲱϣ	ⲙⲡⲉ|ϥ|ⲟⲩⲱϣ
ⲙⲛⲛϣⲙⲙⲟ	ⲙⲛ|ⲛ|ϣⲙⲙⲟ
ϩⲓⲧⲛ	ϩⲓⲧⲛ
ⲟⲩⲭⲟⲣⲧⲟⲥ	ⲟⲩ|ⲭⲟⲣⲧⲟⲥ
ⲙⲡϣⲱϥ	ⲙ|ⲡ|ϣⲱϥ
ⲟⲩ	ⲟⲩ
ⲙⲡⲙⲩⲥⲧⲏⲣⲓⲟⲛ	ⲙ|ⲡ|ⲙⲩⲥⲧⲏⲣⲓⲟⲛ
ⲁⲛⲓⲟⲩⲥⲁⲧⲉⲉⲣⲉ	ⲁⲛⲓ|ⲟⲩ|ⲥⲁⲧⲉⲉⲣⲉ
ⲙ[ ]	ⲙ[ ]
ⲛⲛⲉⲩⲥⲛⲏⲩ	ⲛ|ⲛⲉⲩ|ⲥⲛⲏⲩ
ⲉⲣϣⲁⲛⲡⲉⲕϫⲁϫⲉ	ⲉⲣϣⲁⲛ|ⲡⲉ|ⲕ|ϫⲁϫⲉ
ⲧⲥⲁⲣⲝ	ⲧ|ⲥⲁⲣⲝ
ⲙⲛⲟⲩⲥⲱϣϥ	ⲙⲛ|ⲟⲩ|ⲥⲱϣϥ
ⲟⲩⲡⲣⲟⲥⲫⲟⲣⲁ	ⲟⲩ|ⲡⲣⲟⲥⲫⲟⲣⲁ
ⲁⲥϩⲱⲛ	ⲁ|ⲥ|ϩⲱⲛ
ⲛⲧⲉⲣⲉϥϫⲟ	ⲛⲧⲉⲣⲉ|ϥ|ϫⲟ
ⲛⲛⲉϥⲥⲱⲧⲡ	ⲛ|ⲛⲉϥ|ⲥⲱⲧⲡ
ϩⲛⲛⲟⲩⲕⲁϩ	ϩⲛ|ⲛⲟⲩ|ⲕⲁϩ
ⲛⲛⲉⲧⲛⲧⲃⲛⲟⲟⲩⲉ	ⲛ|ⲛⲉⲧⲛ|ⲧⲃⲛⲟⲟⲩⲉ
ⲛⲟⲩⲏⲣ	ⲛ|ⲟⲩⲏⲣ
ⲛⲉϩⲃⲏⲩⲉ	ⲛⲉ|ϩⲃⲏⲩⲉ
ⲙⲛⲛⲉⲡⲣⲉⲥⲃⲩⲧⲉⲣⲟⲥ	ⲙⲛ|ⲛⲉ|ⲡⲣⲉⲥⲃⲩⲧⲉⲣⲟⲥ
ⲛⲉⲛⲥⲩⲛⲕⲗⲏⲧⲓⲕⲟⲥ	ⲛ|ⲛ|ⲥⲩⲛⲕⲗⲏⲧⲓⲕⲟⲥ
ⲛϫⲡⲥⲟ	ⲛ|ϫⲡ|ⲥⲟ
ⲛϣⲁⲁⲣ	ⲛ|ϣⲁⲁⲣ
ⲛϭⲓⲛⲉⲅⲣⲁⲫⲏ	ⲛϭⲓ|ⲛⲉ|ⲅⲣⲁⲫⲏ
ϫⲉⲛⲉⲧⲉⲙⲡⲉⲃⲁⲗ	ϫⲉ|ⲛ|ⲉⲧⲉ|ⲙⲡⲉ|ⲃⲁⲗ
ⲁϥⲧⲁⲗⲉⲡⲉϥϭⲗⲟϭ	ⲁ|ϥ|ⲧⲁⲗⲉ|ⲡⲉϥ|ϭⲗⲟϭ
ⲉⲩϣⲱⲛⲉ	ⲉ|ⲩ|ϣⲱⲛⲉ
:	:
ϫⲉϥⲥⲁϣⲉ	ϫⲉ|ϥ|ⲥⲁϣⲉ
ϩⲓⲧⲛⲙⲙⲁⲉⲓⲛ	ϩⲓⲧⲛ|ⲙ|ⲙⲁⲉⲓⲛ
ⲁⲩⲃⲱⲕ	ⲁ|ⲩ|ⲃⲱⲕ
ⲛⲥⲟⲛ	ⲛ|ⲥⲟⲛ
ⲛⲧⲃⲟⲏⲑⲓⲁ	ⲛ|ⲧ|ⲃⲟⲏⲑⲓⲁ
ⲙⲛⲛⲉϥϩⲃⲏⲩⲉ	ⲙⲛ|ⲛⲉϥ|ϩⲃⲏⲩⲉ
ⲉϫⲙⲡⲕⲁϩ	ⲉϫⲙ|ⲡ|ⲕⲁϩ
ⲥⲁϣϥ	ⲥⲁϣϥ
ⲉⲩⲉϩⲟⲟⲩⲧ	ⲉ|ⲩ|ⲉ|ϩⲟⲟⲩⲧ
ⲛⲥⲁϩⲃⲟⲩⲣ	ⲛⲥⲁ|ϩⲃⲟⲩⲣ
ⲛⲙⲕⲁϩ	ⲛ|ⲙⲕⲁϩ
ⲕⲁⲛ	ⲕⲁⲛ
ⲛⲥⲉⲛⲁϣⲛⲏⲥⲧⲉⲩⲉ	ⲛ|ⲥⲉ|ⲛⲁ|ϣ|ⲛⲏⲥⲧⲉⲩⲉ
ϩⲛⲧⲙⲛⲧⲣⲙⲛⲧϩⲏⲧ	ϩⲛ|ⲧ|ⲙⲛⲧⲣⲙⲛⲧϩⲏⲧ
ϫⲉⲙⲡⲓⲃⲁⲡⲧⲓⲍⲉ	ϫⲉ|ⲙⲡ|ⲓ|ⲃⲁⲡⲧⲓⲍⲉ
ⲉⲛⲁϣⲱϥ	ⲉ|ⲛⲁϣⲱ|ϥ
ⲁϩⲉⲛⲕⲉⲉϫⲏⲩⲥϭⲏⲣ	ⲁ|ϩⲉⲛ|ⲕⲉ|ⲉϫⲏⲩ|ⲥϭⲏⲣ
ⲛⲛⲁϩⲙϩⲁⲗ	ⲛ|ⲛ|ⲁ|ϩⲙϩⲁⲗ
ⲉⲛⲛⲉⲗⲁⲁⲩ	ⲉ|ⲛⲛⲉ|ⲗⲁⲁⲩ
ⲉϫⲛⲧⲉⲓⲥⲛⲧⲉ	ⲉϫⲛ|ⲧⲉⲓ|ⲥⲛⲧⲉ
ⲁⲓⲧⲛⲛⲟⲟⲩⲥⲉ	ⲁ|ⲓ|ⲧⲛⲛⲟⲟⲩ|ⲥⲉ
ϣⲗⲏⲗ	ϣⲗⲏⲗ
ⲛⲉⲛⲁⲛⲟⲩⲥ	ⲛⲉ|ⲛⲁⲛⲟⲩ|ⲥ
ⲉϥⲡⲟⲣϣ	ⲉ|ϥ|ⲡⲟⲣϣ
ϩⲛⲧⲉϥⲥⲃⲱ	ϩⲛ|ⲧⲉϥ|ⲥⲃⲱ
ⲙⲙⲉⲣⲓⲧ	ⲙ|ⲙⲉⲣⲓⲧ
ϩⲉⲛⲙⲁⲥⲉ	ϩⲉⲛ|ⲙⲁⲥⲉ
ⲛⲉϥⲥⲱⲧⲙ	ⲛⲉ|ϥ|ⲥⲱⲧⲙ
ⲉⲣϣⲁⲛⲡⲉⲥⲕⲗⲁⲇⲟⲥ	ⲉⲣϣⲁⲛ|ⲡⲉ|ⲥⲕⲗⲁⲇⲟⲥ
ϣⲃⲣ	ϣⲃⲣ
ϩⲙⲡⲓϩⲏⲧ	ϩⲙ|ⲡⲓ|ϩⲏⲧ
ϯϫⲱⲙⲙⲟⲥ	ϯ|ϫⲱ|ⲙⲙⲟ|ⲥ
ϯⲛⲁⲥⲙⲟⲩ	ϯ|ⲛⲁ|ⲥⲙⲟⲩ
ⲁⲩⲧⲁⲙⲉ	ⲁ|ⲩ|ⲧⲁⲙⲉ
ⲡⲉⲧⲉⲧⲛⲥⲱⲧⲙ	ⲡ|ⲉⲧⲉ|ⲧⲛ|ⲥⲱⲧⲙ
ϩⲛ	ϩⲛ
ⲙⲡϫⲡⲉϩⲟⲟⲩ	ⲙ|ⲡ|ϫⲡⲉ|ϩⲟⲟⲩ
ⲛⲧⲉⲧⲙⲏ	ⲛ|ⲧⲉ|ⲧⲙⲏ
ⲡϩⲏⲧ	ⲡ|ϩⲏⲧ
ⲛⲛⲉϥⲡⲉⲧⲟⲩⲁⲁⲃ	ⲛ|ⲛⲉϥ|ⲡ|ⲉⲧ|ⲟⲩⲁⲁⲃ
ⲁⲩϥⲓⲧϥ	ⲁ|ⲩ|ϥⲓⲧ|ϥ
ⲕⲁⲧⲁⲡⲉϩⲙⲟⲧ	ⲕⲁⲧⲁ|ⲡⲉ|ϩⲙⲟⲧ
ⲛⲟⲩⲧⲉ	ⲛⲟⲩⲧⲉ
ⲉⲕⲛⲕⲟⲧⲕ	ⲉ|ⲕ|ⲛⲕⲟⲧⲕ
ϣⲁⲡⲉⲟⲩⲟⲓⲉϣ	ϣⲁ|ⲡⲉ|ⲟⲩⲟⲓⲉϣ
ⲁϥⲛⲟϭⲛⲉϭ	ⲁ|ϥ|ⲛⲟϭⲛⲉϭ
ⲙⲛⲟⲩϭⲟⲗ	ⲙⲛ|ⲟⲩ|ϭⲟⲗ
ⲛⲧⲉⲣⲉϥⲧⲱⲟⲩⲛ	ⲛⲧⲉⲣⲉ|ϥ|ⲧⲱⲟⲩⲛ
ϫⲉⲃⲟⲁⲛⲏⲣⲅⲉⲥ	ϫⲉ|ⲃⲟⲁⲛⲏⲣⲅⲉⲥ
ϫⲉⲡⲉϯⲛⲁϯⲡⲓ	ϫⲉ|ⲡⲉ|ϯ|ⲛⲁ|ϯⲡⲓ
ⲡⲉⲩⲙⲧⲟⲛ	ⲡⲉⲩ|ⲙⲧⲟⲛ
ⲙⲛϩⲉⲛⲕⲟⲟⲩⲉ	ⲙⲛ|ϩⲉⲛ|ⲕⲟⲟⲩⲉ
ⲛⲁϩⲱⲧⲡ	ⲛⲁ|ϩⲱⲧⲡ
ⲉⲁⲩⲁⲡⲟⲧⲁⲥⲥⲉ	ⲉ|ⲁ|ⲩ|ⲁⲡⲟⲧⲁⲥⲥⲉ
ⲥⲉⲛⲁⲧⲱⲟⲩⲛⲟⲩ	ⲥⲉ|ⲛⲁ|ⲧⲱⲟⲩⲛ|ⲟⲩ
·ⲻ	·ⲻ
ⲛϯⲛⲁⲁⲣⲛⲁ	ⲛ|ϯ|ⲛⲁ|ⲁⲣⲛⲁ
ⲉⲛⲉϭⲣⲱϭ	ⲉ|ⲛⲉ|ϭⲣⲱϭ
ⲛⲉϥⲧⲱⲃϩ	ⲛⲉ|ϥ|ⲧⲱⲃϩ
ⲛⲣⲙⲛϩⲏⲧ	ⲛ|ⲣⲙⲛ|ϩⲏⲧ
ϩⲓϫⲛⲙⲙⲟⲟⲩ	ϩⲓϫⲛ|ⲙ|ⲙⲟⲟⲩ
ⲟⲩϩⲙⲥ	ⲟⲩ|ϩⲙⲥ
ⲥⲃⲧⲱⲧⲟⲩ	ⲥⲃⲧⲱⲧ|ⲟⲩ
ⲙⲡⲁⲧⲉⲧϩⲁⲏⲛⲟⲩⲉ	ⲙⲡⲁⲧⲉ|ⲧ|ϩⲁⲏ|ⲛ|ⲟⲩⲉ
ⲉⲛⲡⲏϣ	ⲉ|ⲛ|ⲡⲏϣ
ⲛⲛⲉϥⲉⲓⲟⲧⲉ	ⲛ|ⲛⲉϥ|ⲉⲓⲟⲧⲉ
ⲟⲩⲙⲛⲧⲁⲑⲏⲧ	ⲟⲩ|ⲙⲛⲧⲁⲑⲏⲧ
ⲉⲧⲉⲧⲛϥⲓ	ⲉ|ⲧⲉⲧⲛ|ϥⲓ
ⲅⲁⲣ	ⲅⲁⲣ
ⲛⲛⲅⲉⲣⲁⲥⲏⲛⲟⲥ	ⲛ|ⲛ|ⲅⲉⲣⲁⲥⲏⲛⲟⲥ
ⲉⲛϣⲁⲛϣⲱϥⲧ	ⲉⲛϣⲁⲛ|ϣⲱϥⲧ
ϩⲓⲧⲙⲡⲉⲩⲁⲅⲅⲉⲗⲓⲟⲛ	ϩⲓⲧⲙ|ⲡ|ⲉⲩⲁⲅⲅⲉⲗⲓⲟⲛ
ⲙⲡϣⲓⲡⲉ	ⲙ|ⲡ|ϣⲓⲡⲉ
ⲙⲡⲉⲧⲛⲥⲱⲧⲙ	ⲙⲡⲉ|ⲧⲛ|ⲥⲱⲧⲙ
ⲉϥⲙⲟⲕϩ	ⲉ|ϥ|ⲙⲟⲕϩ
ⲥϩⲓⲙⲉ	ⲥϩⲓⲙⲉ
ⲧⲁⲉⲓ	ⲧⲁ|ⲉⲓ
ϫⲓⲛϫⲱϥ	ϫⲓⲛ|ϫⲱϥ
ⲡⲉⲟⲟⲩ	ⲡ|ⲉⲟⲟⲩ
ⲙⲡⲉⲧⲱϣ	ⲙ|ⲡ|ⲉⲧ|ⲱϣ
ⲉⲕⲉⲙⲁ	ⲉ|ⲕⲉ|ⲙⲁ
ϫⲉⲙⲡⲣⲧⲱϩ	ϫⲉ|ⲙⲡⲣ|ⲧⲱϩ
ⲁϥⲁⲡⲟⲇⲏⲙⲉⲓ	ⲁ|ϥ|ⲁⲡⲟⲇⲏⲙⲉⲓ
ⲁϥⲡⲱϩ	ⲁ|ϥ|ⲡⲱϩ
ϫⲉⲙⲉϥϭⲉⲡⲏ	ϫⲉ|ⲙⲉ|ϥ|ϭⲉⲡⲏ
ⲙⲉⲛ	ⲙⲉⲛ
ⲙⲡⲓⲥⲣⲁⲏⲗ	ⲙ|ⲡ|ⲓⲥⲣⲁⲏⲗ
ⲛⲧⲛϣϭⲙϭⲟⲙ	ⲛ|ⲧⲛ|ϣϭⲙϭⲟⲙ
ⲉⲡⲕⲱ	ⲉ|ⲡ|ⲕⲱ
ⲛϭⲓⲓⲏⲥⲟⲩⲥ	ⲛϭⲓ|ⲓⲏⲥⲟⲩⲥ
ⲁϥϩⲟⲙⲟⲗⲟⲅⲉⲓ	ⲁ|ϥ|ϩⲟⲙⲟⲗⲟⲅⲉⲓ
ⲛⲥⲉⲧⲁⲕⲟ	ⲛ|ⲥⲉ|ⲧⲁⲕⲟ
ϫⲉⲥⲉⲁⲛⲁⲅⲕⲁⲍⲉ	ϫⲉ|ⲥⲉ|ⲁⲛⲁⲅⲕⲁⲍⲉ
ϩⲁϩⲉⲛⲉⲗⲁⲭⲓⲥⲧⲟⲛ	ϩⲁ|ϩⲉⲛ|ⲉⲗⲁⲭⲓⲥⲧⲟⲛ
ⲉⲥⲉ	ⲉ|ⲥⲉ
ⲛⲉⲩⲙⲛⲧⲙⲛⲧⲣⲉ	ⲛⲉⲩ|ⲙⲛⲧⲙⲛⲧⲣⲉ
ⲛⲓⲙⲛⲉ	ⲛⲓⲙ|ⲛⲉ
ⲛⲉⲧⲛⲁⲉⲡⲓⲑⲩⲙⲉⲓ	ⲛ|ⲉⲧ|ⲛⲁ|ⲉⲡⲓⲑⲩⲙⲉⲓ
ⲁⲛⲣⲥⲟϭ	ⲁ|ⲛ|ⲣⲥⲟϭ
ⲉⲧⲣⲉⲩⲥⲁⲛⲟⲩϣⲟⲩ	ⲉ|ⲧⲣⲉ|ⲩ|ⲥⲁⲛⲟⲩϣ|ⲟⲩ
ϫⲉϩⲟⲧⲁⲛ	ϫⲉ|ϩⲟⲧⲁⲛ
[...]ⲛⲥⲟⲉⲓⲧ	[...]ⲛ|ⲥⲟⲉⲓⲧ
ϯϫⲟⲟⲩ	ϯ|ϫⲟⲟ|ⲩ
ⲁⲩⲡⲉϣ	ⲁ|ⲩ|ⲡⲉϣ
ⲛⲧⲁϣⲉⲟⲉⲓϣ	ⲛ|ⲧⲁϣⲉⲟⲉⲓϣ
ⲁⲥϣⲉⲡϩⲁϩ	ⲁ|ⲥ|ϣⲉⲡ|ϩⲁϩ
ⲁⲡⲛⲟⲩⲧⲉ	ⲁ|ⲡ|ⲛⲟⲩⲧⲉ
ⲛⲥⲁⲓⲏⲥⲟⲩⲥ	ⲛⲥⲁ|ⲓⲏⲥⲟⲩⲥ
ⲉⲛⲉⲧϥⲉⲓⲣⲉ	ⲉ|ⲛ|ⲉⲧ|ϥ|ⲉⲓⲣⲉ
ⲁⲓⲧⲥⲉⲧⲛⲉⲣⲱⲧⲉ	ⲁ|ⲓ|ⲧⲥⲉ|ⲧⲛ|ⲉⲣⲱⲧⲉ
ⲙⲁⲣⲛⲣ	ⲙⲁⲣⲛ|ⲣ
ⲛϩⲛⲟ	ⲛ|ϩⲛⲟ
ⲛⲁⲥ	ⲛⲁ|ⲥ
ϩⲁⲧⲛⲧⲏⲩⲧⲛ	ϩⲁⲧⲛ|ⲧⲏⲩⲧⲛ
ⲙⲡⲉⲧⲛⲁⲙⲁϩⲧⲉ	ⲙⲡⲉ|ⲧⲛ|ⲁⲙⲁϩⲧⲉ
ⲙⲛⲧϩⲉ	ⲙⲛ|ⲧ|ϩⲉ
ⲡⲉⲧⲛⲁⲧⲁⲕⲟ	ⲡ|ⲉⲧ|ⲛⲁ|ⲧⲁⲕⲟ
ⲙⲡϭⲟⲗ	ⲙ|ⲡ|ϭⲟⲗ
ⲁϥⲟⲩⲱϣⲃ	ⲁ|ϥ|ⲟⲩⲱϣⲃ
ϩⲛⲛⲧⲉⲗⲉⲓⲟⲥ	ϩⲛ|ⲛ|ⲧⲉⲗⲉⲓⲟⲥ
ⲛ̅ⲧⲉⲣⲉϥⲛⲁⲩ	ⲛⲧⲉⲣⲉ|ϥ|ⲛⲁⲩ
ⲛⲛⲕⲁⲣⲡⲟⲥ	ⲛ|ⲛ|ⲕⲁⲣⲡⲟⲥ
ⲛⲟⲩⲱⲛϩ	ⲛ|ⲟⲩⲱⲛϩ
ⲛⲧⲉⲣⲉϥⲛⲟϫⲟⲩ	ⲛⲧⲉⲣⲉ|ϥ|ⲛⲟϫ|ⲟⲩ
ⲛⲥⲉⲧⲙⲧⲁⲙⲟⲓ	ⲛ|ⲥⲉ|ⲧⲙ|ⲧⲁⲙⲟⲓ
ⲁϥⲡⲱⲧ	ⲁ|ϥ|ⲡⲱⲧ
ⲧⲉⲥϩⲓⲙⲉ	ⲧⲉ|ⲥϩⲓⲙⲉ
ⲙⲛⲛⲉⲧⲛⲏϫ	ⲙⲛ|ⲛ|ⲉⲧ|ⲛⲏϫ
ⲁⲛⲅⲡϫⲟⲉⲓⲥ	ⲁⲛⲅ|ⲡ|ϫⲟⲉⲓⲥ
ⲟⲩⲛϩⲉⲛϩⲟⲟⲩ	ⲟⲩⲛ|ϩⲉⲛ|ϩⲟⲟⲩ
ⲙⲙⲁⲁⲩ	ⲙⲙⲁⲁⲩ
ⲁⲥⲇⲓⲁⲕⲟⲛⲓ	ⲁ|ⲥ|ⲇⲓⲁⲕⲟⲛⲓ
ϯⲛⲁⲧⲁⲁϥ	ϯ|ⲛⲁ|ⲧⲁⲁ|ϥ
ⲛⲧⲁⲕⲉⲓ	ⲛⲧ|ⲁ|ⲕ|ⲉⲓ
ⲉϫⲱ	ⲉϫⲱ
ⲛⲟϭ	ⲛⲟϭ
ⲛⲥⲁⲃⲃⲁⲧⲟⲛ	ⲛ|ⲥⲁⲃⲃⲁⲧⲟⲛ
ⲛⲟⲩⲏⲣⲡ	ⲛ|ⲟⲩ|ⲏⲣⲡ
ⲟⲩⲱⲙ	ⲟⲩⲱⲙ
ⲉⲡⲙⲟⲛⲁⲭⲟⲥ	ⲉ|ⲡ|ⲙⲟⲛⲁⲭⲟⲥ
ⲙⲡⲉⲩⲥⲟⲟⲩⲛ	ⲙ|ⲡⲉ|ⲩ|ⲥⲟⲟⲩⲛ
ⲛϥⲧⲙⲕⲁϣⲏⲣⲉ	ⲛ|ϥ|ⲧⲙ|ⲕⲁ|ϣⲏⲣⲉ
ϩⲙⲡϫⲟⲉⲓⲥ	ϩⲙ|ⲡ|ϫⲟⲉⲓⲥ
ⲁϫⲛⲡⲁⲣⲁⲃⲟⲗⲏ	ⲁϫⲛ|ⲡⲁⲣⲁⲃⲟⲗⲏ
ⲛϥϭⲱⲗⲡ	ⲛ|ϥ|ϭⲱⲗⲡ
ⲡⲱⲧⲛ	ⲡⲱ|ⲧⲛ
ⲙⲛϩⲉⲛϩⲩⲡⲁⲣⲭⲟⲛⲧⲁ	ⲙⲛ|ϩⲉⲛ|ϩⲩⲡⲁⲣⲭⲟⲛⲧⲁ
ⲁϥϯϩⲧⲏϥ	ⲁ|ϥ|ϯ|ϩⲧⲏ|ϥ
ⲙⲡⲟⲩⲡⲓⲥⲧⲉⲩⲉ	ⲙⲡ|ⲟⲩ|ⲡⲓⲥⲧⲉⲩⲉ
ⲙⲡⲙⲁⲙⲙⲱⲛⲁⲥ	ⲙ|ⲡ|ⲙⲁⲙⲙⲱⲛⲁⲥ
ⲉⲛⲁϣⲱⲥ	ⲉ|ⲛⲁϣⲱ|ⲥ
ⲧⲏⲣ	ⲧⲏⲣ
ⲙⲙⲩⲥⲧⲏⲣⲓⲟⲛ	ⲙ|ⲙⲩⲥⲧⲏⲣⲓⲟⲛ
ϩⲛⲛⲥⲩⲛⲁⲅⲱⲅⲏ	ϩⲛ|ⲛ|ⲥⲩⲛⲁⲅⲱⲅⲏ
ⲉϥⲟⲩⲉⲙϣϫⲉ	ⲉ|ϥ|ⲟⲩⲉⲙ|ϣϫⲉ
ⲛϩⲉⲛⲡⲁⲓⲇⲉⲥ	ⲛ|ϩⲉⲛ|ⲡⲁⲓⲇⲉⲥ
ⲁⲡⲧⲏⲩ	ⲁ|ⲡ|ⲧⲏⲩ
ⲛⲉⲩⲕⲟⲧⲥ	ⲛⲉⲩ|ⲕⲟⲧⲥ
ⲉϫⲛⲧⲉⲭⲁⲣⲓⲥ	ⲉϫⲛ|ⲧⲉ|ⲭⲁⲣⲓⲥ
ⲙⲡⲟⲗⲉⲙⲟⲥ	ⲙ|ⲡⲟⲗⲉⲙⲟⲥ
ⲉⲡⲉⲧϩⲓⲧⲟⲩⲱϥ	ⲉ|ⲡ|ⲉⲧ|ϩⲓⲧⲟⲩⲱ|ϥ
ⲉⲧⲃⲉⲛϣⲉⲉⲣⲉ	ⲉⲧⲃⲉ|ⲛ|ϣⲉⲉⲣⲉ
ⲙⲁⲣⲉϥⲥⲱⲧⲙ	ⲙⲁⲣⲉ|ϥ|ⲥⲱⲧⲙ
ⲛⲧⲉⲣⲉϥⲁⲙⲁϩⲧⲉ	ⲛⲧⲉⲣⲉ|ϥ|ⲁⲙⲁϩⲧⲉ
ⲉϥⲟⲩⲁⲁⲃ	ⲉ|ϥ|ⲟⲩⲁⲁⲃ
ⲉⲓⲁⲕⲱⲃⲟⲥ	ⲉ|ⲓⲁⲕⲱⲃⲟⲥ
ϩⲙⲡⲉⲭⲣⲓⲥⲧⲟⲥ	ϩⲙ|ⲡⲉ|ⲭⲣⲓⲥⲧⲟⲥ
ⲉⲧϣⲱⲛⲉ	ⲉⲧ|ϣⲱⲛⲉ
ⲁϥⲣⲥⲛⲁⲩ	ⲁ|ϥ|ⲣⲥⲛⲁⲩ
ⲁⲩⲟⲩⲱϣⲧ	ⲁ|ⲩ|ⲟⲩⲱϣⲧ
ⲙⲛⲛⲉⲛⲉⲣⲏⲩ	ⲙⲛ|ⲛⲉⲛ|ⲉⲣⲏⲩ
ⲛⲧⲁϥⲧⲁⲙⲓⲟ	ⲛⲧ|ⲁ|ϥ|ⲧⲁⲙⲓⲟ
ⲉⲧϩⲓϫⲙⲡⲕⲁϩ	ⲉⲧ|ϩⲓϫⲙ|ⲡ|ⲕⲁϩ
ϩⲟⲡⲟⲩ	ϩⲟⲡ|ⲟⲩ
ϫⲉⲉⲗⲱⲉⲓ	ϫⲉ|ⲉⲗⲱⲉⲓ
ϫⲉⲡⲙⲟⲟⲩ	ϫⲉ|ⲡ|ⲙⲟⲟⲩ
ⲛϭⲓϩⲟⲉⲓⲛⲉ	ⲛϭⲓ|ϩⲟⲉⲓⲛⲉ
ⲛⲛⲉϩⲟⲟⲩ	ⲛ|ⲛⲉ|ϩⲟⲟⲩ
ⲙⲡ̣[…]ⲡⲟⲥ	ⲙ|ⲡ̣[…]ⲡⲟⲥ
ϭⲟⲗⲡⲟⲩ	ϭⲟⲗⲡ|ⲟⲩ
ϩⲛⲧⲉⲥⲃⲱ	ϩⲛ|ⲧⲉ|ⲥⲃⲱ
ⲁϥⲟⲩⲱⲧⲃ	ⲁ|ϥ|ⲟⲩⲱⲧⲃ
ⲛⲛϣⲟϫⲛⲉ	ⲛ|ⲛ|ϣⲟϫⲛⲉ
ⲛϭⲓⲡϣⲏⲣⲉ	ⲛϭⲓ|ⲡ|ϣⲏⲣⲉ
ϩⲉⲛϩⲧⲟ	ϩⲉⲛ|ϩⲧⲟ
ⲛⲥⲉϫⲟⲟⲩⲥⲉ	ⲛ|ⲥⲉ|ϫⲟⲟⲩ|ⲥⲉ
ⲉⲕⲣⲏⲧ	ⲉ|ⲕ|ⲣⲏⲧ
ⲉϣⲁⲩⲥⲩⲣⲉ	ⲉ|ϣⲁ|ⲩ|ⲥⲩⲣⲉ
ⲁϥϭⲱϣⲧ	ⲁ|ϥ|ϭⲱϣⲧ
ⲙⲡⲉⲕϣⲟⲩϣⲟⲩ	ⲙ|ⲡⲉⲕ|ϣⲟⲩϣⲟⲩ
ⲉⲧⲉⲛⲁϣⲉⲡⲉϥⲛⲁ	ⲉⲧⲉ|ⲛⲁϣⲉ|ⲡⲉϥ|ⲛⲁ
ⲙⲡⲙⲁ	ⲙ|ⲡ|ⲙⲁ
ϩⲁⲣⲟⲥ	ϩⲁⲣⲟ|ⲥ
ϫⲉⲁⲩϩⲟⲟⲩϣ	ϫⲉ|ⲁ|ⲩ|ϩⲟⲟⲩϣ
ϣⲁⲁⲧ	ϣⲁⲁⲧ
ⲛⲥⲃⲱ	ⲛ|ⲥⲃⲱ
ⲛⲁⲡⲁ	ⲛ|ⲁⲡⲁ
ⲁⲡⲁⲧⲁ	ⲁⲡⲁⲧⲁ
ⲛⲉⲣⲁⲥⲱϣⲡⲙⲁ	ⲛⲉⲣ|ⲁ|ⲥⲱϣ|ⲡ|ⲙⲁ
ⲛⲧⲕⲟⲩⲅⲁⲗⲓⲗⲁⲓⲟⲥ	ⲛⲧ|ⲕ|ⲟⲩ|ⲅⲁⲗⲓⲗⲁⲓⲟⲥ
ϩⲛⲧⲙⲁⲥⲧⲓⲅⲝ	ϩⲛ|ⲧ|ⲙⲁⲥⲧⲓⲅⲝ
ⲛⲧⲡⲉ	ⲛ|ⲧ|ⲡⲉ
,	,
ⲛⲕⲁⲕⲉ	ⲛ|ⲕⲁⲕⲉ
ϫⲉⲧⲡⲁⲣⲁⲥⲕⲉⲩⲏ	ϫⲉ|ⲧ|ⲡⲁⲣⲁⲥⲕⲉⲩⲏ
ⲛⲛⲃⲁⲣⲃⲁⲣⲟⲥ	ⲛ|ⲛ|ⲃⲁⲣⲃⲁⲣⲟⲥ
ⲧⲉϩⲓⲏ	ⲧⲉ|ϩⲓⲏ
ⲉⲧⲣϩⲱⲃ	ⲉⲧ|ⲣϩⲱⲃ
ⲉⲩⲉϫⲱⲕ	ⲉ|ⲩ|ⲉ|ϫⲱⲕ
ⲉⲣⲛⲉⲕⲟⲩⲱϣ	ⲉ|ⲣ|ⲛⲉⲕ|ⲟⲩⲱϣ
ⲛⲧⲉⲣⲉϥϣⲛϩⲧⲏϥ	ⲛⲧⲉⲣⲉ|ϥ|ϣ|ⲛϩⲧⲏ|ϥ
ⲉⲥⲁϩⲟⲩ	ⲉ|ⲥⲁϩⲟⲩ
ϣⲁⲩⲟⲩⲁϩⲙⲉϥ	ϣⲁ|ⲩ|ⲟⲩⲁϩⲙⲉ|ϥ
ⲡⲉⲧϯⲃⲁⲡⲧⲓⲥⲙⲁ	ⲡ|ⲉⲧ|ϯ|ⲃⲁⲡⲧⲓⲥⲙⲁ
ϫⲉⲙⲡⲣⲡⲁⲣⲁⲃⲁ	ϫⲉ|ⲙⲡⲣ|ⲡⲁⲣⲁⲃⲁ
ⲡⲁⲓⲡⲉ	ⲡⲁⲓ|ⲡⲉ
ⲉⲧⲉⲣⲉⲡⲛⲟⲩⲧⲉⲕⲧⲟ	ⲉⲧⲉⲣⲉ|ⲡ|ⲛⲟⲩⲧⲉ|ⲕⲧⲟ
ⲉⲡⲉⲓⲇⲏ	ⲉⲡⲉⲓⲇⲏ
ⲛⲉⲧⲟ	ⲛ|ⲉⲧ|ⲟ
ⲟⲩⲙⲟⲛⲁⲭⲟⲥ	ⲟⲩ|ⲙⲟⲛⲁⲭⲟⲥ
ⲛⲛⲉⲩϣⲏⲣⲉ	ⲛ|ⲛⲉⲩ|ϣⲏⲣⲉ
ⲛⲁⲧϩⲏⲧ	ⲛ|ⲁⲧϩⲏⲧ
ⲧⲱⲛⲉ	ⲧⲱⲛⲉ
ⲉⲅⲉⲛⲛⲏⲥⲁⲣⲉⲧ	ⲉ|ⲅⲉⲛⲛⲏⲥⲁⲣⲉⲧ
ⲛⲟⲩⲙⲛⲧⲉⲣⲟ	ⲛ|ⲟⲩ|ⲙⲛⲧⲉⲣⲟ
ⲟⲩⲛⲧⲁⲩ	ⲟⲩⲛⲧⲁ|ⲩ
ⲉⲧⲉⲧⲛⲧⲟⲩⲛⲟⲥ	ⲉ|ⲧⲉⲧⲛ|ⲧⲟⲩⲛⲟⲥ
ⲛⲉⲓⲕⲉⲕⲱⲧ	ⲛⲉⲓ|ⲕⲉ|ⲕⲱⲧ
ⲱⲇⲏ	ⲱⲇⲏ
ϩⲛϩⲉⲛϯⲥⲃⲱ	ϩⲛ|ϩⲉⲛ|ϯⲥⲃⲱ
ϣⲁⲁⲩϩⲱϭⲃ	ϣⲁ|ⲁ|ⲩ|ϩⲱϭⲃ
ⲙⲛϩⲉⲛⲥⲏϥⲉ	ⲙⲛ|ϩⲉⲛ|ⲥⲏϥⲉ
ⲛϭⲟⲙⲙⲡⲙⲁ	ⲛ|ϭⲟⲙ|ⲙ|ⲡ|ⲙⲁ
ϣⲁⲣⲟⲟⲩ	ϣⲁⲣⲟ|ⲟⲩ
ϫⲉⲉⲝⲉⲥⲧⲓ	ϫⲉ|ⲉⲝⲉⲥⲧⲓ
ⲛⲧⲉⲣⲟⲩⲥⲙⲟⲩ	ⲛⲧⲉⲣ|ⲟⲩ|ⲥⲙⲟⲩ
ⲉⲣϫⲓϭⲟⲗ	ⲉⲣ|ϫⲓ|ϭⲟⲗ
ⲁⲩⲏⲧ	ⲁⲩⲏⲧ
ⲙⲛⲛⲉⲧⲛϩⲏⲧⲟⲩ	ⲙⲛ|ⲛ|ⲉⲧ|ⲛϩⲏⲧ|ⲟⲩ
ⲙⲛⲛⲕⲉϩⲉⲑⲛⲟⲥ	ⲙⲛ|ⲛ|ⲕⲉ|ϩⲉⲑⲛⲟⲥ
ⲉⲩⲣⲓⲙⲉ	ⲉ|ⲩ|ⲣⲓⲙⲉ
ϩⲛⲙⲛⲧⲁⲧⲥⲱⲧⲙ	ϩⲛ|ⲙⲛⲧⲁⲧⲥⲱⲧⲙ
ⲛⲉⲁⲡⲟⲥⲧⲟⲗⲟⲥ	ⲛⲉ|ⲁⲡⲟⲥⲧⲟⲗⲟⲥ
ⲉⲧⲟ	ⲉⲧ|ⲟ
ϫⲉⲙⲁⲁⲩ	ϫⲉ|ⲙⲁⲁⲩ
ⲧⲏⲣⲛ	ⲧⲏⲣ|ⲛ
ⲁϥⲟⲩⲉϩⲥⲁϩⲛⲉ	ⲁ|ϥ|ⲟⲩⲉϩ|ⲥⲁϩⲛⲉ
ϩⲙⲡϣⲟⲣⲡ	ϩⲙ|ⲡ|ϣⲟⲣⲡ
ϣⲁⲛⲉⲣⲣⲱⲟⲩ	ϣⲁ|ⲛⲉ|ⲣⲣⲱⲟⲩ
ⲛϭⲁⲃϩⲏⲧ	ⲛ|ϭⲁⲃ|ϩⲏⲧ
ⲉⲓⲉ	ⲉⲓⲉ
ⲙⲡⲕϣⲣⲟⲉⲓⲥ	ⲙⲡⲕ|ϣ|ⲣⲟⲉⲓⲥ
ⲉⲛⲉϫⲇⲁⲓⲙⲱⲛⲓⲟⲛ	ⲉ|ⲛⲉϫ|ⲇⲁⲓⲙⲱⲛⲓⲟⲛ
ⲧⲉⲛ	ⲧⲉⲛ
ⲛϩⲏⲧⲛ	ⲛϩⲏⲧ|ⲛ
ⲧⲁⲑⲏⲧ	ⲧ|ⲁⲑⲏⲧ
ⲙⲛⲡⲕⲁϩ	ⲙⲛ|ⲡ|ⲕⲁϩ
ⲛⲧⲉⲧⲛϩⲉⲛⲥⲁⲣⲕⲓⲕⲟⲥ	ⲛⲧⲉⲧⲛ|ϩⲉⲛ|ⲥⲁⲣⲕⲓⲕⲟⲥ
ⲛϩⲱⲧⲡ	ⲛ|ϩⲱⲧⲡ
ⲉⲣⲉⲛⲉϥϩⲟⲉⲓⲧⲉ	ⲉⲣⲉ|ⲛⲉϥ|ϩⲟⲉⲓⲧⲉ
ⲛⲉⲧⲛϣⲁϫⲉ	ⲛ|ⲉⲧ|ⲛ|ϣⲁϫⲉ
ϩⲉⲛⲉⲓⲱ	ϩⲉⲛ|ⲉⲓⲱ
ⲧⲁⲣⲭⲏ	ⲧ|ⲁⲣⲭⲏ
ⲛⲟⲓⲕⲟⲛⲟⲙⲟⲥ	ⲛ|ⲟⲓⲕⲟⲛⲟⲙⲟⲥ
ⲛ	ⲛ
ϩⲛⲟⲩⲱⲣϫ	ϩⲛ|ⲟⲩ|ⲱⲣϫ
ⲛⲧⲉⲣⲟⲩϣⲁⲁⲧ	ⲛⲧⲉⲣ|ⲟⲩ|ϣⲁⲁⲧ
ⲣⲕⲁⲕⲉ	ⲣⲕⲁⲕⲉ
ⲁϥⲧⲣⲉⲩϣⲱⲡⲉ	ⲁ|ϥ|ⲧⲣⲉ|ⲩ|ϣⲱⲡⲉ
ⲙⲛⲛϫⲓⲛϭⲟⲛⲥ	ⲙⲛ|ⲛ|ϫⲓ|ⲛ|ϭⲟⲛⲥ
ⲛⲧⲙⲛⲧⲥⲁⲃⲉ	ⲛ|ⲧ|ⲙⲛⲧⲥⲁⲃⲉ
ⲉⲧⲉϩⲉⲛⲡⲣⲟⲫⲏⲧⲏⲥ	ⲉⲧⲉ|ϩⲉⲛ|ⲡⲣⲟⲫⲏⲧⲏⲥ
ⲉⲛⲉⲛⲉⲣⲏⲩ	ⲉ|ⲛⲉⲛ|ⲉⲣⲏⲩ
ϫⲉϯⲟⲩⲱϣ	ϫⲉ|ϯ|ⲟⲩⲱϣ
ⲁⲓ‎ⲧⲛⲛⲉⲩⲧⲓⲙⲟⲑⲉⲟⲥ	ⲁ|ⲓ‎|ⲧⲛⲛⲉⲩ|ⲧⲓⲙⲟⲑⲉⲟⲥ
ⲛⲉⲩⲟϣ	ⲛⲉ|ⲩ|ⲟϣ
ⲛⲟⲩⲛⲉϩ	ⲛ|ⲟⲩ|ⲛⲉϩ
ⲁⲁⲩ	ⲁⲁ|ⲩ
ϫⲓⲧϩⲓⲙⲉ	ϫⲓ|ⲧ|ϩⲓⲙⲉ
ϩⲛϣⲉ	ϩⲛ|ϣⲉ
ⲛⲧⲉⲧⲛⲛⲁⲡⲉⲭⲣⲓⲥⲧⲟⲥ	ⲛⲧⲉⲧⲛ|ⲛⲁ|ⲡⲉ|ⲭⲣⲓⲥⲧⲟⲥ
ϣⲁϩⲣⲁⲓ	ϣⲁϩⲣⲁⲓ
ⲉⲧϩⲛⲙⲡⲏⲩⲉ	ⲉⲧ|ϩⲛ|ⲙ|ⲡⲏⲩⲉ
ⲑⲉ	ⲧ|ϩⲉ
ⲉⲧⲣⲉⲩⲁⲡⲟⲧⲁⲥⲥⲉ	ⲉ|ⲧⲣⲉ|ⲩ|ⲁⲡⲟⲧⲁⲥⲥⲉ
ⲁⲛⲅⲡⲁⲡⲉⲭⲣⲓⲥⲧⲟⲥ	ⲁⲛⲅ|ⲡⲁ|ⲡⲉ|ⲭⲣⲓⲥⲧⲟⲥ
ⲉⲧⲃⲉⲟⲩⲫⲑⲟⲛⲟⲥ	ⲉⲧⲃⲉ|ⲟⲩ|ⲫⲑⲟⲛⲟⲥ
ϫⲉϫⲓ	ϫⲉ|ϫⲓ
ⲉϥϣⲟⲩⲉⲓⲧ	ⲉ|ϥ|ϣⲟⲩⲉⲓⲧ
ϩⲓϫⲛⲟⲩϣⲟⲧ	ϩⲓϫⲛ|ⲟⲩ|ϣⲟⲧ
ⲁⲩⲕⲏⲣⲩⲥⲥⲉ	ⲁ|ⲩ|ⲕⲏⲣⲩⲥⲥⲉ
ⲙⲙⲉⲉⲣⲉ	ⲙ|ⲙⲉⲉⲣⲉ
ⲛⲙⲙⲁⲕ	ⲛⲙⲙⲁ|ⲕ
ϫⲉⲛⲉⲩⲟ	ϫⲉ|ⲛⲉ|ⲩ|ⲟ
ϩⲁⲙⲏⲛ	ϩⲁⲙⲏⲛ
ⲙⲡⲉⲧϩⲟⲟⲩ	ⲙ|ⲡ|ⲉⲧ|ϩⲟⲟⲩ
ⲛⲛⲥⲁⲃⲉⲉⲩ	ⲛ|ⲛ|ⲥⲁⲃⲉⲉⲩ
ϩⲛⲥⲓⲟⲟⲩⲛⲉ	ϩⲛ|ⲥⲓⲟⲟⲩⲛⲉ
ⲁⲟⲩⲕⲁⲕⲉ	ⲁ|ⲟⲩ|ⲕⲁⲕⲉ
ⲛⲁⲡⲉⲭⲣⲓⲥⲧⲟⲥ	ⲛⲁ|ⲡⲉ|ⲭⲣⲓⲥⲧⲟⲥ
ⲉϫⲛϩⲉⲛϣⲏⲣⲉ	ⲉϫⲛ|ϩⲉⲛ|ϣⲏⲣⲉ
ⲡⲉⲛⲣⲣⲟ	ⲡⲉⲛ|ⲣⲣⲟ
ⲉⲥⲛϩⲏⲧⲟⲩ	ⲉ|ⲥ|ⲛϩⲏⲧ|ⲟⲩ
ⲉⲧⲉⲙⲛⲗⲁⲁⲩ	ⲉⲧⲉ|ⲙⲛ|ⲗⲁⲁⲩ
ⲭⲏⲣⲁ	ⲭⲏⲣⲁ
ⲉⲕⲣⲓⲛⲉ	ⲉ|ⲕⲣⲓⲛⲉ
ⲙⲁⲣⲉϥϥⲓ	ⲙⲁⲣⲉ|ϥ|ϥⲓ
ⲙⲛⲛⲓϯⲧⲱⲛ	ⲙⲛ|ⲛⲓ|ϯⲧⲱⲛ
ⲉⲁϥⲧⲱⲧ	ⲉ|ⲁ|ϥ|ⲧⲱⲧ
ⲛⲥⲉⲛⲟϫⲟⲩ	ⲛ|ⲥⲉ|ⲛⲟϫ|ⲟⲩ
ⲭⲱⲣⲓⲥ	ⲭⲱⲣⲓⲥ
ⲉⲧⲉⲓⲉⲡⲓⲥⲧⲟⲗⲏ	ⲉ|ⲧⲉⲓ|ⲉⲡⲓⲥⲧⲟⲗⲏ
ⲉⲣⲉⲣⲭⲣⲉⲓⲁ	ⲉⲣⲉ|ⲣⲭⲣⲉⲓⲁ
ⲁⲩⲗⲩⲡⲉⲓ	ⲁ|ⲩ|ⲗⲩⲡⲉⲓ
ⲟ	ⲟ
ⲙⲛⲡⲟⲛⲏⲣⲟⲛ	ⲙⲛ|ⲡⲟⲛⲏⲣⲟⲛ
ⲉⲛⲧⲁⲡⲉⲓⲁⲓⲱⲛ	ⲉ|ⲛⲧⲁ|ⲡⲉⲓ|ⲁⲓⲱⲛ
ϩⲁⲧⲉⲧⲉϩⲓⲏ	ϩⲁⲧⲉ|ⲧⲉ|ϩⲓⲏ
ⲛⲧⲉⲡⲣⲟⲑⲉⲥⲓⲥ	ⲛ|ⲧⲉ|ⲡⲣⲟⲑⲉⲥⲓⲥ
ⲙⲛⲛⲥⲓⲟⲩ	ⲙⲛ|ⲛ|ⲥⲓⲟⲩ
ⲉⲩⲉϩⲉ	ⲉ|ⲩ|ⲉ|ϩⲉ
ⲛϭⲓⲟⲩⲭⲏⲣⲁ	ⲛϭⲓ|ⲟⲩ|ⲭⲏⲣⲁ
ϩⲛⲑⲗⲓⲯⲓⲥ	ϩⲛ|ⲑⲗⲓⲯⲓⲥ
ⲛⲧⲛϫⲡⲓⲟ	ⲛ|ⲧⲛ|ϫⲡⲓⲟ
ⲛⲉⲧϣⲟⲟⲡ	ⲛ|ⲉⲧ|ϣⲟⲟⲡ
ⲙⲡⲉⲩⲥⲧⲁⲩⲣⲟⲥ	ⲙ|ⲡⲉⲩ|ⲥⲧⲁⲩⲣⲟⲥ
ⲙⲁⲁⲩ	ⲙⲁⲁⲩ
ⲉⲛⲧⲁϣⲉⲟⲉⲓϣ	ⲉ|ⲛ|ⲧⲁϣⲉⲟⲉⲓϣ
ⲙⲛⲡⲉⲓⲥϭⲣⲁϩⲧ	ⲙⲛ|ⲡⲉⲓ|ⲥϭⲣⲁϩⲧ
ϩⲛⲧⲉⲡⲓⲥⲧⲟⲗⲏ	ϩⲛ|ⲧ|ⲉⲡⲓⲥⲧⲟⲗⲏ
ϩⲁⲧⲉⲥϩⲁⲉⲓⲃⲉⲥ	ϩⲁ|ⲧⲉⲥ|ϩⲁⲉⲓⲃⲉⲥ
ⲡⲉⲧⲇⲓⲁⲕⲣⲓⲛⲉ	ⲡ|ⲉⲧ|ⲇⲓⲁⲕⲣⲓⲛⲉ
ⲙⲛⲛⲣⲉϥⲣⲛⲟⲃⲉ	ⲙⲛ|ⲛ|ⲣⲉϥⲣⲛⲟⲃⲉ
ⲉⲧϩⲙⲡⲙⲁ	ⲉⲧ|ϩⲙ|ⲡ|ⲙⲁ
ϫⲉⲡⲧⲟⲡⲟⲥ	ϫⲉ|ⲡ|ⲧⲟⲡⲟⲥ
ϫⲉⲉⲣⲉⲡⲙⲏⲏϣⲉ	ϫⲉ|ⲉⲣⲉ|ⲡ|ⲙⲏⲏϣⲉ
ⲙⲡⲉϥⲉⲓⲱⲧ	ⲙ|ⲡⲉϥ|ⲉⲓⲱⲧ
ⲡⲉⲕⲏⲓ	ⲡⲉⲕ|ⲏⲓ
ϥⲱϭⲉ	ϥⲱϭⲉ
ϥⲛⲁϫⲟⲟⲥ	ϥ|ⲛⲁ|ϫⲟⲟ|ⲥ
ⲁⲥⲉⲓⲙⲉ	ⲁ|ⲥ|ⲉⲓⲙⲉ
ⲛⲧⲁⲓϫⲓⲧⲟⲩ	ⲛⲧ|ⲁ|ⲓ|ϫⲓⲧ|ⲟⲩ
ⲛⲁϣⲉ	ⲛⲁ|ϣⲉ
ⲁⲩϣⲉⲡϩⲉⲛϩⲏⲛⲉ	ⲁ|ⲩ|ϣⲉⲡ|ϩⲉⲛ|ϩⲏⲛⲉ
ⲁⲥⲥⲱⲟⲩϩ	ⲁ|ⲥ|ⲥⲱⲟⲩϩ
ϩⲓϫⲛⲛⲉⲧϭⲗⲱϭ	ϩⲓϫⲛ|ⲛ|ⲉⲧ|ϭⲗⲱϭ
ⲉⲧⲛⲁⲛⲁⲩ	ⲉⲧ|ⲛⲁ|ⲛⲁⲩ
ⲉⲛⲧⲁⲡϫⲟⲉⲓⲥ	ⲉⲛⲧ|ⲁ|ⲡ|ϫⲟⲉⲓⲥ
ⲧⲣⲉⲡⲟⲩⲱϣⲙ	ⲧⲣⲉ|ⲡ|ⲟⲩⲱϣⲙ
ⲗⲗⲉⲡⲧⲟⲛ	ⲗⲗⲉⲡⲧⲟⲛ
ⲙⲡⲃⲟⲗ	ⲙ|ⲡ|ⲃⲟⲗ
ⲛⲉⲟⲩⲛⲟϭ	ⲛⲉ|ⲟⲩ|ⲛⲟϭ
ⲉⲩⲃⲁⲩⲕⲁⲗⲓⲟⲛ	ⲉ|ⲩ|ⲃⲁⲩⲕⲁⲗⲓⲟⲛ
ⲁϫⲛⲧⲛ	ⲁϫⲛ|ⲧⲛ
ⲙⲡⲉⲥⲙⲟⲧ	ⲙ|ⲡⲉ|ⲥⲙⲟⲧ
ⲉⲧⲧⲃⲃⲏⲩ	ⲉⲧ|ⲧⲃⲃⲏⲩ
ϫⲉϯ	ϫⲉ|ϯ
ⲛⲛϩⲏⲧ	ⲛ|ⲛ|ϩⲏⲧ
ⲛϭⲓⲛⲉⲧⲛϩⲏⲧ	ⲛϭⲓ|ⲛⲉⲧⲛ|ϩⲏⲧ
ⲛⲥⲁϣϥ	ⲛ|ⲥⲁϣϥ
ⲥⲟⲟⲩⲛ	ⲥⲟⲟⲩⲛ
ϫⲉⲥⲉϫⲓϩⲛⲁⲩ	ϫⲉ|ⲥⲉ|ϫⲓ|ϩⲛⲁⲩ
ⲁⲓⲙⲉⲣⲓⲧϥ	ⲁ|ⲓ|ⲙⲉⲣⲓⲧ|ϥ
ϩⲛⲗⲁⲁⲩ	ϩⲛ|ⲗⲁⲁⲩ
ⲛⲛⲓⲡⲉⲣⲓⲕⲁⲑⲁⲣⲙⲁ	ⲛ|ⲛⲓ|ⲡⲉⲣⲓⲕⲁⲑⲁⲣⲙⲁ
ϩⲛⲛⲉⲩⲁϭⲟⲗⲧⲉ	ϩⲛ|ⲛⲉⲩ|ⲁϭⲟⲗⲧⲉ
ⲁϥⲉⲓ	ⲁ|ϥ|ⲉⲓ
ⲛⲧⲇⲓⲁⲕⲟⲛⲓⲁ	ⲛ|ⲧ|ⲇⲓⲁⲕⲟⲛⲓⲁ
ⲟⲩⲉⲓⲱⲧ	ⲟⲩ|ⲉⲓⲱⲧ
ⲉⲕⲉϩⲉⲛⲉⲉⲧⲏ	ⲉ|ⲕⲉ|ϩⲉⲛⲉⲉⲧⲏ
ⲉⲕⲉϯ	ⲉⲕⲉ|ϯ
ⲙⲡⲉϥⲥⲟⲛ	ⲙ|ⲡⲉϥ|ⲥⲟⲛ
ⲛⲟⲩϫⲟ	ⲛ|ⲟⲩ|ϫⲟ
ⲁⲩϩⲁⲣⲉϩ	ⲁ|ⲩ|ϩⲁⲣⲉϩ
ⲛⲛⲉϥϩⲃⲏⲩⲉ	ⲛ|ⲛⲉϥ|ϩⲃⲏⲩⲉ
ⲉⲛⲉϫ	ⲉ|ⲛⲉϫ
ⲛϭⲓⲙⲁⲣⲓⲁ	ⲛϭⲓ|ⲙⲁⲣⲓⲁ
ⲡⲉⲙⲛⲟⲩⲧ	ⲡⲉ|ⲙⲛⲟⲩⲧ
ⲉⲧⲃⲉⲛⲉⲛϩⲃⲏⲩⲉ	ⲉⲧⲃⲉ|ⲛⲉⲛ|ϩⲃⲏⲩⲉ
ⲧⲉⲧⲛⲕⲱ	ⲧⲉⲧⲛ|ⲕⲱ
ⲙⲛⲟⲩⲥϩⲓⲙⲉ	ⲙⲛ|ⲟⲩ|ⲥϩⲓⲙⲉ
ⲉϥϫⲱ	ⲉ|ϥ|ϫⲱ
ⲛϭⲓⲛⲁⲣⲭⲓⲉⲣⲉⲩⲥ	ⲛϭⲓ|ⲛ|ⲁⲣⲭⲓⲉⲣⲉⲩⲥ
ⲉⲧⲣⲉⲩϩⲟⲧⲡ	ⲉ|ⲧⲣⲉ|ⲩ|ϩⲟⲧⲡ
ⲁϥⲙⲡⲥⲱⲙⲁ	ⲁ|ϥ|ⲙ|ⲡ|ⲥⲱⲙⲁ
ⲉⲡⲉϥⲕⲁϩ	ⲉ|ⲡⲉϥ|ⲕⲁϩ
ⲙⲛⲡⲉⲕⲉⲓⲱⲧ	ⲙⲛ|ⲡⲉⲕ|ⲉⲓⲱⲧ
ⲉⲟⲙⲥϥ	ⲉ|ⲟⲙⲥ|ϥ
ⲧⲟⲩⲡⲓⲥⲧⲓⲥⲧⲉ	ⲧⲟⲩ|ⲡⲓⲥⲧⲓⲥ|ⲧⲉ
ⲉⲡⲓⲥⲧⲟⲗⲏ	ⲉⲡⲓⲥⲧⲟⲗⲏ
ⲉⲙⲡⲥⲙⲧⲟⲛ	ⲉ|ⲙⲡ|ⲥ|ⲙⲧⲟⲛ
ⲉⲧⲃⲟⲧⲉ	ⲉ|ⲧ|ⲃⲟⲧⲉ
ⲉⲣⲁⲧⲥ	ⲉⲣⲁⲧ|ⲥ
ⲉⲛⲧⲟⲗⲏ	ⲉⲛⲧⲟⲗⲏ
ⲛⲟⲩⲟⲃϣ	ⲛ|ⲟⲩⲟⲃϣ
ⲉϥⲧⲱⲛ	ⲉ|ϥ|ⲧⲱⲛ
ϫⲉⲛⲕⲛⲁϣⲁϫⲉ	ϫⲉ|ⲛ|ⲕ|ⲛⲁ|ϣⲁϫⲉ
ⲛⲥⲉϣⲁϫⲉ	ⲛ|ⲥⲉ|ϣⲁϫⲉ
ⲉⲡⲛⲟⲩⲧⲉ	ⲉ|ⲡ|ⲛⲟⲩⲧⲉ
ⲉⲧϩⲁⲧⲉⲧⲉϩⲓⲏ	ⲉⲧ|ϩⲁⲧⲉ|ⲧⲉ|ϩⲓⲏ
ⲛⲉⲓ	ⲛ|ⲉⲓ
ⲁⲩⲭⲁⲗⲁ	ⲁ|ⲩ|ⲭⲁⲗⲁ
ⲉⲙⲙⲛⲙⲛⲧⲣⲙϩⲉ	ⲉ|ⲙⲙⲛ|ⲙⲛⲧⲣⲙϩⲉ
ϩⲛⲥⲁⲣⲣⲁ	ϩⲛ|ⲥⲁⲣⲣⲁ
ⲉⲛϣⲁⲛϣⲱⲡⲉ	ⲉⲛϣⲁⲛ|ϣⲱⲡⲉ
ϩⲛⲟⲩϯⲥⲃⲱ	ϩⲛ|ⲟⲩ|ϯ|ⲥⲃⲱ
ⲛⲛⲉϥϩⲛⲁⲟⲩ	ⲛ|ⲛⲉϥ|ϩⲛⲁⲟⲩ
ⲥⲉⲛⲁϫⲱⲱⲣⲉ	ⲥⲉ|ⲛⲁ|ϫⲱⲱⲣⲉ
ⲙⲡⲉⲩⲱⲛϩ	ⲙ|ⲡⲉ|ⲩ|ⲱⲛϩ
ϩⲛⲛⲥⲩⲛϩⲉⲇⲣⲓⲟⲛ	ϩⲛ|ⲛ|ⲥⲩⲛϩⲉⲇⲣⲓⲟⲛ
ⲙⲛϩⲁϩ	ⲙⲛ|ϩⲁϩ
ϫⲓⲛⲙⲡⲉⲓⲛⲁⲩ	ϫⲓⲛ|ⲙ|ⲡⲉⲓ|ⲛⲁⲩ
ⲉϥⲥⲃⲧⲱⲧ	ⲉ|ϥ|ⲥⲃⲧⲱⲧ
ϩⲙⲡⲕⲁⲕⲉ	ϩⲙ|ⲡ|ⲕⲁⲕⲉ
ⲛⲧⲁⲛⲥⲱⲧⲙ	ⲛⲧ|ⲁ|ⲛ|ⲥⲱⲧⲙ
ⲉⲉⲃⲟⲗ	ⲉ|ⲉⲃⲟⲗ
ⲡⲁⲙⲃⲱ	ⲡⲁⲙⲃⲱ
ⲛⲇⲉⲃⲃⲱⲣⲁ	ⲛ|ⲇⲉⲃⲃⲱⲣⲁ
ⲙⲡⲕⲉⲥⲁⲃⲃⲁⲧⲟⲛ	ⲙ|ⲡ|ⲕⲉ|ⲥⲁⲃⲃⲁⲧⲟⲛ
ⲛⲓϥⲉ	ⲛⲓϥⲉ
ⲙⲡⲉⲕⲙⲧⲟ	ⲙ|ⲡⲉⲕ|ⲙⲧⲟ
ϥ	ϥ
ϩⲛⲟⲩⲙⲩⲥⲧⲏⲣⲓⲟⲛ	ϩⲛ|ⲟⲩ|ⲙⲩⲥⲧⲏⲣⲓⲟⲛ
ⲉⲧⲉⲟⲩⲕⲟⲇⲣⲁⲛⲧⲏⲥ	ⲉⲧⲉ|ⲟⲩ|ⲕⲟⲇⲣⲁⲛⲧⲏⲥ
ⲛⲕⲁⲉⲩⲱ	ⲛ|ⲕⲁⲉⲩⲱ
ⲛϩⲱⲃ	ⲛ|ϩⲱⲃ
ϫⲉⲁⲣϯϣⲟⲟⲩ	ϫⲉ|ⲁⲣ|ϯ|ϣⲟⲟⲩ
ϩⲛⲟⲩϭⲱⲛⲧ	ϩⲛ|ⲟⲩ|ϭⲱⲛⲧ
ⲕⲉⲛⲟϭ	ⲕⲉ|ⲛⲟϭ
ⲡϩⲁⲣϣϩⲏⲧ	ⲡ|ϩⲁⲣϣϩⲏⲧ
ⲉⲧⲉⲧⲛϫⲓ	ⲉ|ⲧⲉⲧⲛ|ϫⲓ
ⲥⲉⲛⲁⲛⲉϫ	ⲥⲉ|ⲛⲁ|ⲛⲉϫ
ⲉϥⲉⲫⲟⲣⲉⲓ	ⲉ|ϥ|ⲉ|ⲫⲟⲣⲉⲓ
ⲙⲡⲁⲣⲁⲃⲟⲗⲏ	ⲙ|ⲡⲁⲣⲁⲃⲟⲗⲏ
ϣⲟⲩⲟ	ϣⲟⲩⲟ
ⲧⲉⲧⲛⲛⲁⲥⲕⲁⲛⲇⲁⲗⲓⲍⲉ	ⲧⲉⲧⲛ|ⲛⲁ|ⲥⲕⲁⲛⲇⲁⲗⲓⲍⲉ
ⲉϩⲉⲛⲡⲛⲉⲩⲙⲁⲧⲓⲕⲟⲥ	ⲉ|ϩⲉⲛ|ⲡⲛⲉⲩⲙⲁⲧⲓⲕⲟⲥ
ⲛⲙⲓⲁⲕⲱⲃⲟⲥ	ⲛⲙ|ⲓⲁⲕⲱⲃⲟⲥ
ⲙⲡⲉⲓϩⲱⲃ	ⲙ|ⲡⲉⲓ|ϩⲱⲃ
ϭⲉ	ϭⲉ
ⲥⲉϣⲱⲡ	ⲥⲉ|ϣⲱⲡ
ⲉⲧⲉⲡⲉⲡⲣⲁⲓⲧⲱⲣⲓⲟⲛ	ⲉⲧⲉ|ⲡⲉ|ⲡⲣⲁⲓⲧⲱⲣⲓⲟⲛ
ϩⲓⲣⲉϥⲣⲛⲟⲃⲉ	ϩⲓ|ⲣⲉϥⲣⲛⲟⲃⲉ
ⲛⲣⲉϥϣⲡϩⲓⲥⲉ	ⲛ|ⲣⲉϥϣⲡϩⲓⲥⲉ
ⲙⲡⲉϥϩⲟ	ⲙ|ⲡⲉϥ|ϩⲟ
ⲉϩⲉⲛⲙⲁ	ⲉ|ϩⲉⲛ|ⲙⲁ
ⲉⲧⲛⲁⲛⲟⲩϥ	ⲉⲧ|ⲛⲁⲛⲟⲩ|ϥ
ⲛⲥⲟⲫⲟⲥ	ⲛ|ⲥⲟⲫⲟⲥ
ⲛϩⲧⲏⲩ	ⲛ|ϩⲧⲏ|ⲩ
ⲧϭⲟⲙ	ⲧ|ϭⲟⲙ
ⲛϩⲧⲏⲛ	ⲛ|ϩⲧⲏ|ⲛ
ϩⲟⲣϣ	ϩⲟⲣϣ
ⲛⲗⲁⲕⲙ	ⲛ|ⲗⲁⲕⲙ
ⲛⲟⲩⲟⲉⲓϣ	ⲛ|ⲟⲩⲟⲉⲓϣ
ⲁⲧⲉⲧⲛⲧⲛⲛⲟⲟⲩ	ⲁ|ⲧⲉⲧⲛ|ⲧⲛⲛⲟ|ⲟⲩ
ⲡⲁⲛⲧⲱⲥ	ⲡⲁⲛⲧⲱⲥ
ⲁⲥⲙⲟⲩ	ⲁ|ⲥ|ⲙⲟⲩ
ⲧⲁⲣⲛⲉⲓⲙⲉ	ⲧⲁⲣ|ⲛ|ⲉⲓⲙⲉ
ⲛⲧⲉⲣⲉⲟⲩϩⲉ	ⲛⲧⲉⲣⲉ|ⲟⲩ|ϩⲉ
ⲉϥⲡⲁⲣⲁⲕⲁⲗⲉⲓ	ⲉ|ϥ|ⲡⲁⲣⲁⲕⲁⲗⲉⲓ
ⲁⲩⲑⲙⲕⲟ	ⲁ|ⲩ|ⲑⲙⲕⲟ
ⲕⲱ	ⲕⲱ
ⲛⲣⲁⲧ	ⲛ|ⲣⲁⲧ
ⲙⲛⲛⲉⲧⲧⲥⲛⲕⲟ	ⲙⲛ|ⲛ|ⲉⲧ|ⲧⲥⲛⲕⲟ
ⲛⲁⲣⲭⲁⲓⲟⲥ	ⲛ|ⲁⲣⲭⲁⲓⲟⲥ
ⲟⲩⲉⲡⲓⲥⲧⲏⲙⲏ	ⲟⲩ|ⲉⲡⲓⲥⲧⲏⲙⲏ
ⲉⲧⲉⲅⲕⲣⲁⲧⲉⲩⲉ	ⲉⲧ|ⲉⲅⲕⲣⲁⲧⲉⲩⲉ
ⲉⲧⲉⲧⲛⲡⲗⲁⲛⲁ	ⲉ|ⲧⲉⲧⲛ|ⲡⲗⲁⲛⲁ
ϣϣⲉ	ϣϣⲉ
ⲉⲩⲥⲁⲉⲓⲛ	ⲉ|ⲟⲩ|ⲥⲁⲉⲓⲛ
ⲙⲡϣⲟⲉⲓϣ	ⲙ|ⲡ|ϣⲟⲉⲓϣ
ⲉⲡⲉⲧⲟ	ⲉ|ⲡ|ⲉⲧ|ⲟ
ⲛⲛⲉⲓϩⲙϩⲁⲗ	ⲛ|ⲛⲉⲓ|ϩⲙϩⲁⲗ
ϫⲉⲁⲩⲥⲟⲧⲡⲥ	ϫⲉ|ⲁ|ⲩ|ⲥⲟⲧⲡ|ⲥ
ⲛϭⲓ	ⲛϭⲓ
ϣⲁϥϣⲁϫⲉ	ϣⲁ|ϥ|ϣⲁϫⲉ
ⲟⲩⲃⲏⲩ	ⲟⲩⲃⲏ|ⲩ
ⲡⲁⲣⲭⲓⲉⲣⲉⲩⲥ	ⲡ|ⲁⲣⲭⲓⲉⲣⲉⲩⲥ
ϩⲙⲡϣⲁϫⲉ	ϩⲙ|ⲡ|ϣⲁϫⲉ
ⲁⲥⲥⲧⲱⲧ	ⲁ|ⲥ|ⲥⲧⲱⲧ
ⲡⲉⲓⲥⲟϭⲛ	ⲡⲉⲓ|ⲥⲟϭⲛ
ⲟⲩⲙⲏⲏϣⲉ	ⲟⲩ|ⲙⲏⲏϣⲉ
ϣⲁⲛⲧⲉⲛⲁⲓ	ϣⲁⲛⲧⲉ|ⲛⲁⲓ
ⲡⲓⲥⲧⲉⲩⲉ	ⲡⲓⲥⲧⲉⲩⲉ
ϫⲉϥⲥϩⲟⲩⲟⲣⲧ	ϫⲉ|ϥ|ⲥϩⲟⲩⲟⲣⲧ
ⲛⲧⲉⲣⲟⲩⲥⲱⲧⲙ	ⲛⲧⲉⲣ|ⲟⲩ|ⲥⲱⲧⲙ
ⲛⲉϥϩⲛϩⲉⲛⲙⲁ	ⲛⲉ|ϥ|ϩⲛ|ϩⲉⲛ|ⲙⲁ
ⲛⲅϩⲏϭⲉ	ⲛ|ⲅ|ϩⲏϭⲉ
ⲉⲛⲁⲛⲟⲩϥ	ⲉ|ⲛⲁⲛⲟⲩ|ϥ
ⲛⲧⲉ	ⲛⲧⲉ
ϩⲛⲧϫⲏⲏⲥ	ϩⲛ|ⲧ|ϫⲏⲏⲥ
ⲛⲉϥⲛⲁⲣϣⲟⲙⲧ	ⲛⲉ|ϥ|ⲛⲁ|ⲣ|ϣⲟⲙⲧ
ⲙⲡϥⲕⲁⲥⲡⲉⲣⲙⲁ	ⲙⲡ|ϥ|ⲕⲁ|ⲥⲡⲉⲣⲙⲁ
ϩⲛⲛⲉⲩⲧⲃⲛⲟⲟⲩⲉ	ϩⲛ|ⲛⲉⲩ|ⲧⲃⲛⲟⲟⲩⲉ
ⲁϥⲧⲱⲟⲩⲛ	ⲁ|ϥ|ⲧⲱⲟⲩⲛ
ϫⲉⲧⲙⲛⲧⲥⲟϭ	ϫⲉ|ⲧ|ⲙⲛⲧⲥⲟϭ
ⲛⲧⲟϥⲡⲉ	ⲛⲧⲟϥ|ⲡⲉ
ⲛⲉⲩⲛϩⲟⲉⲓⲛⲉ	ⲛⲉ|ⲩⲛ|ϩⲟⲉⲓⲛⲉ
ⲛϣⲁϫⲉ	ⲛ|ϣⲁϫⲉ
ⲛⲛⲉⲛⲯⲩⲭⲏ	ⲛ|ⲛⲉⲛ|ⲯⲩⲭⲏ
ⲧⲛⲁⲩ	ⲧ|ⲛⲁⲩ
ϩⲛⲧⲁⲩⲗⲏ	ϩⲛ|ⲧ|ⲁⲩⲗⲏ
ϩⲙⲡϩⲙⲥ	ϩⲙ|ⲡ|ϩⲙⲥ
ⲛⲧⲉⲡⲉⲛϫⲟⲉⲓⲥ	ⲛⲧⲉ|ⲡⲉⲛ|ϫⲟⲉⲓⲥ
ⲧⲉⲧⲓⲙⲏ	ⲧⲉ|ⲧⲓⲙⲏ
ⲛⲉⲓⲙⲁⲉⲓⲛ	ⲛⲉⲓ|ⲙⲁⲉⲓⲛ
ⲙⲡⲟⲩⲧⲱⲧ	ⲙ|ⲡⲟⲩ|ⲧⲱⲧ
ϩⲛⲙⲙⲛⲧⲁⲡⲓⲥⲧⲟⲥ	ϩⲛ|ⲙ|ⲙⲛⲧⲁⲡⲓⲥⲧⲟⲥ
ϩⲛⲧⲉⲩⲙⲛⲧϣⲁϥⲧⲉ	ϩⲛ|ⲧⲉⲩ|ⲙⲛⲧϣⲁϥⲧⲉ
ⲛⲧⲉⲝⲟⲩⲥⲓⲁ	ⲛ|ⲧ|ⲉⲝⲟⲩⲥⲓⲁ
ϩⲛⲥⲩⲛⲁⲅⲱⲅⲏ	ϩⲛ|ⲥⲩⲛⲁⲅⲱⲅⲏ
ϩⲱⲥ	ϩⲱⲥ
ⲁϥⲕⲁⲧⲥⲓⲛⲇⲱⲛ	ⲁ|ϥ|ⲕⲁ|ⲧ|ⲥⲓⲛⲇⲱⲛ
ⲧⲉⲛⲧⲁⲡⲛⲟⲩⲧⲉ	ⲧ|ⲉⲛⲧ|ⲁ|ⲡ|ⲛⲟⲩⲧⲉ
ϫⲉⲧⲙⲣⲱⲕ	ϫⲉ|ⲧⲙ|ⲣⲱ|ⲕ
ⲙⲡⲉⲧⲛⲱϣ	ⲙⲡⲉ|ⲧⲛ|ⲱϣ
ⲙⲛⲧⲧⲉⲗⲓⲟⲥ	ⲙⲛⲧⲧⲉⲗⲓⲟⲥ
ⲥⲉⲛⲟⲩⲑⲓⲟⲩ	ⲥⲉⲛⲟⲩⲑⲓⲟⲩ
ⲁⲣⲁ	ⲁⲣⲁ
ⲁⲛⲉⲡⲣⲟⲫⲏⲧⲏⲥ	ⲁ|ⲛⲉ|ⲡⲣⲟⲫⲏⲧⲏⲥ
ⲛⲛⲉⲧϩⲓϩⲟⲩⲛ	ⲛ|ⲛ|ⲉⲧ|ϩⲓϩⲟⲩⲛ
ϫⲉⲧⲙⲉ	ϫⲉ|ⲧ|ⲙⲉ
ⲛⲧⲉⲧⲛⲣⲟⲉⲓⲥ	ⲛ|ⲧⲉⲧⲛ|ⲣⲟⲉⲓⲥ
ⲉⲩϩⲣϣⲓⲣⲉ	ⲉ|ⲩ|ϩⲣϣⲓⲣⲉ
ⲁⲩⲥⲟⲃⲧⲉ	ⲁ|ⲩ|ⲥⲟⲃⲧⲉ
ⲥⲉⲛⲁⲡⲱⲧ	ⲥⲉ|ⲛⲁ|ⲡⲱⲧ
ⲛϩⲉⲛⲟⲩⲱⲛϣ	ⲛ|ϩⲉⲛ|ⲟⲩⲱⲛϣ
ⲉⲣⲉϫⲱ	ⲉⲣⲉ|ϫⲱ
ⲙⲛⲟⲩⲥⲧⲱⲧ	ⲙⲛ|ⲟⲩ|ⲥⲧⲱⲧ
ⲙⲡⲉⲧⲉⲛϣⲟⲟⲡ	ⲙ|ⲡ|ⲉⲧⲉ|ⲛ|ϣⲟⲟⲡ
ⲁⲕⲥⲙ	ⲁ|ⲕ|ⲥⲙ
ⲙ.	ⲙ|.
ⲛⲥⲟⲫⲓⲁ	ⲛ|ⲥⲟⲫⲓⲁ
ⲛⲑⲛⲟⲛ	ⲛ|ⲑⲛⲟⲛ
ⲛϩⲏⲧⲧⲏⲩⲧⲛ	ⲛϩⲏⲧ|ⲧⲏⲩⲧⲛ
ⲛϣⲏⲣⲉ	ⲛ|ϣⲏⲣⲉ
ⲡⲱⲧ	ⲡⲱⲧ
ⲉⲩⲡⲗⲁⲛⲁ	ⲉ|ⲩ|ⲡⲗⲁⲛⲁ
ϩⲙⲥ	ϩⲙⲥ
ϫⲉⲡⲟⲩⲁ	ϫⲉ|ⲡ|ⲟⲩⲁ
ⲉⲛϩⲏⲅⲉⲙⲱⲛ	ⲉ|ⲛ|ϩⲏⲅⲉⲙⲱⲛ
ⲉⲙⲡⲟⲩⲧⲁⲁϥ	ⲉ|ⲙⲡ|ⲟⲩ|ⲧⲁⲁ|ϥ
ϩⲓⲡⲉϥⲧⲉⲗⲱⲛⲓⲟⲛ	ϩⲓ|ⲡⲉϥ|ⲧⲉⲗⲱⲛⲓⲟⲛ
ⲉⲥⲟ	ⲉ|ⲥ|ⲟ
ⲛⲧⲟⲟⲩ	ⲛⲧⲟⲟⲩ
ⲛⲕⲛⲧⲉ	ⲛ|ⲕⲛⲧⲉ
ⲛⲛⲉⲧⲛⲉⲣⲏⲩ	ⲛ|ⲛⲉⲧⲛ|ⲉⲣⲏⲩ
ⲙⲛⲡⲉⲩⲙⲧⲟⲛ	ⲙⲛ|ⲡⲉⲩ|ⲙⲧⲟⲛ
ⲙⲡⲉⲅⲣⲁⲙⲙⲁⲧⲉⲩⲥ	ⲙ|ⲡⲉ|ⲅⲣⲁⲙⲙⲁⲧⲉⲩⲥ
ⲙⲁⲣⲟⲛ	ⲙⲁⲣⲟ|ⲛ
ⲉϩⲉⲛϩⲏⲃⲥ	ⲉ|ϩⲉⲛ|ϩⲏⲃⲥ
ⲙⲡ	ⲙⲡ
ⲙⲡⲉϥϣⲏⲣⲉ	ⲙ|ⲡⲉϥ|ϣⲏⲣⲉ
ⲛⲛⲉⲩϣⲛⲏⲩ	ⲛ|ⲛⲉⲩ|ϣⲛⲏⲩ
ⲙⲛⲛⲥⲁϩⲉⲛⲟⲩⲟⲉⲓϣ	ⲙⲛ|ⲛ|ⲥⲁ|ϩⲉⲛ|ⲟⲩⲟⲉⲓϣ
ⲉⲧⲣⲉϥⲙⲟⲟϣⲉ	ⲉ|ⲧⲣⲉ|ϥ|ⲙⲟⲟϣⲉ
ⲙⲉⲣⲟⲥ	ⲙⲉⲣⲟⲥ
ϫⲉⲃⲱⲕ	ϫⲉ|ⲃⲱⲕ
ⲉⲣⲟⲉⲓ	ⲉⲣⲟ|ⲉⲓ
ⲉⲩⲉⲓⲛⲉ	ⲉ|ⲩ|ⲉⲓⲛⲉ
ϩⲛⲟⲩⲙⲉ	ϩⲛ|ⲟⲩ|ⲙⲉ
ⲉϥⲙⲟⲟϣⲉ	ⲉ|ϥ|ⲙⲟⲟϣⲉ
ⲉⲧⲣⲏⲧ	ⲉⲧ|ⲣⲏⲧ
ⲁϥⲱϣ	ⲁ|ϥ|ⲱϣ
ⲉⲧⲉⲧⲥⲩⲛⲁⲅⲱⲅⲏⲧⲉ	ⲉⲧⲉ|ⲧ|ⲥⲩⲛⲁⲅⲱⲅⲏ|ⲧⲉ
ⲛⲧⲡⲏⲅⲏ	ⲛ|ⲧ|ⲡⲏⲅⲏ
ⲁⲃⲣⲁϩⲁⲙ	ⲁⲃⲣⲁϩⲁⲙ
ⲉⲕⲁⲕⲉⲥⲛⲧⲉ	ⲉ|ⲕⲁ|ⲕⲉ|ⲥⲛⲧⲉ
ⲛⲉⲣⲁⲧϭⲁⲓⲉⲛⲉⲥⲛⲏⲩ	ⲛⲉⲣ|ⲁ|ⲧϭⲁⲓⲉ|ⲛⲉ|ⲥⲛⲏⲩ
ⲁⲩⲥⲱⲃⲉ	ⲁ|ⲩ|ⲥⲱⲃⲉ
ⲛⲁⲥⲟⲩⲱⲛⲧ	ⲛⲁ|ⲥⲟⲩⲱⲛ|ⲧ
ϩⲏⲏⲧⲉ	ϩⲏⲏⲧⲉ
ⲉⲥϭⲛ	ⲉ|ⲥ|ϭⲛ
ⲛⲧⲁⲕϯ	ⲛⲧⲁ|ⲕ|ϯ
ⲛⲅⲉⲓ	ⲛ|ⲅ|ⲉⲓ
ϭⲟⲗ	ϭⲟⲗ
ⲕⲧⲟ	ⲕⲧⲟ
ⲛⲟⲩⲕⲟⲩⲓ	ⲛ|ⲟⲩ|ⲕⲟⲩⲓ
ϫⲉⲙⲉϥⲥⲉ	ϫⲉ|ⲙⲉ|ϥ|ⲥⲉ
ⲉⲛϥⲓ	ⲉ|ⲛ|ϥⲓ
ⲁϫⲛⲛⲟⲃⲉ	ⲁϫⲛ|ⲛⲟⲃⲉ
ⲛⲑⲟⲧⲉ	ⲛ|ⲧ|ϩⲟⲧⲉ
ⲁⲡⲟⲗⲗⲱ	ⲁⲡⲟⲗⲗⲱ
ⲁⲡⲧⲏⲩⲗⲟ	ⲁ|ⲡ|ⲧⲏⲩⲗⲟ
ⲛϩⲩⲡⲟⲕⲣⲓⲧⲏⲥ	ⲛ|ϩⲩⲡⲟⲕⲣⲓⲧⲏⲥ
ϣⲙⲙⲟ	ϣⲙⲙⲟ
ⲛⲧⲉⲣⲟⲩⲕⲁⲁϥ	ⲛⲧⲉⲣ|ⲟⲩ|ⲕⲁⲁ|ϥ
ⲛⲟⲩⲥⲟⲛ	ⲛ|ⲟⲩ|ⲥⲟⲛ
ⲉⲛϩⲱⲃ	ⲉ|ⲛ|ϩⲱⲃ
ⲛⲛⲉⲛⲥⲛⲏⲩ	ⲛ|ⲛⲉⲛ|ⲥⲛⲏⲩ
ⲁϥⲧⲁⲗϭⲟⲟⲩ	ⲁ|ϥ|ⲧⲁⲗϭⲟ|ⲟⲩ
ⲛϭⲓⲛⲉϥⲙⲁⲑⲏⲧⲏⲥ	ⲛϭⲓ|ⲛⲉϥ|ⲙⲁⲑⲏⲧⲏⲥ
ⲥⲙⲟⲛⲧ	ⲥⲙⲟⲛⲧ
ⲙⲡⲉⲛⲉⲓⲱⲧ	ⲙ|ⲡⲉ|ⲛ|ⲉⲓⲱⲧ
ⲉⲧⲣⲉϥⲉⲓ	ⲉ|ⲧⲣⲉ|ϥ|ⲉⲓ
ⲛⲧⲛⲙⲉⲣⲉⲟⲩⲱϩ	ⲛ|ⲧⲛ|ⲙⲉⲣⲉ|ⲟⲩⲱϩ
ⲉⲧϯⲥⲃⲱ	ⲉⲧ|ϯ|ⲥⲃⲱ
ⲙⲛϣⲉⲉⲣⲉ	ⲙⲛ|ϣⲉⲉⲣⲉ
ⲙⲡⲱⲣ	ⲙⲡⲱⲣ
ϩⲛⲛⲥⲁⲃⲃⲁⲧⲟⲛ	ϩⲛ|ⲛ|ⲥⲁⲃⲃⲁⲧⲟⲛ
ⲟⲩⲕⲟⲩⲛ	ⲟⲩⲕ|ⲟⲩⲛ
ⲉⲧⲉϥϣⲧⲏⲛ	ⲉ|ⲧⲉϥ|ϣⲧⲏⲛ
ⲙⲁⲣⲟⲩⲡⲱⲧ	ⲙⲁⲣ|ⲟⲩ|ⲡⲱⲧ
ⲙⲡⲉⲟⲟⲩ	ⲙ|ⲡⲉ|ⲟⲟⲩ
ϩⲛⲟⲩⲧⲥⲁⲛⲟ	ϩⲛ|ⲟⲩ|ⲧⲥⲁⲛⲟ
ⲙⲉⲧⲁⲛⲟⲓ	ⲙⲉⲧⲁⲛⲟⲓ
ⲉⲁϥϣⲱⲡⲉ	ⲉ|ⲁ|ϥ|ϣⲱⲡⲉ
ⲛⲧⲉⲡⲉⲓⲁⲓⲱⲛ	ⲛⲧⲉ|ⲡⲉⲓ|ⲁⲓⲱⲛ
ϩⲛⲛⲉⲩϣⲱⲛⲉ	ϩⲛ|ⲛⲉ|ⲩ|ϣⲱⲛⲉ
ⲛϯⲛⲁⲣ	ⲛ|ϯ|ⲛⲁ|ⲣ
ⲙⲛⲛⲕⲉⲧⲃⲛⲟⲟⲩⲉ	ⲙⲛ|ⲛ|ⲕⲉ|ⲧⲃⲛⲟⲟⲩⲉ
ϫⲉⲧⲁⲓ	ϫⲉ|ⲧⲁⲓ
ⲙⲛϩⲉⲛⲉⲥⲟⲟⲩ	ⲙⲛ|ϩⲉⲛ|ⲉⲥⲟⲟⲩ
ⲛϫⲱⲕⲙ	ⲛ|ϫⲱⲕⲙ
ⲛⲉⲓϭⲟⲙ	ⲛⲉⲓ|ϭⲟⲙ
ⲧⲉⲧⲛⲟ	ⲧⲉⲧⲛ|ⲟ
ⲡⲓⲛⲟⲩ	ⲡⲓⲛⲟⲩ
ϫⲉⲥⲉⲙⲟⲕⲙⲉⲕ	ϫⲉ|ⲥⲉ|ⲙⲟⲕⲙⲉⲕ
ⲉⲕⲱⲧ	ⲉ|ⲕⲱⲧ
ⲁϩⲉⲣⲁⲧϥ	ⲁϩⲉⲣⲁⲧ|ϥ
ⲁⲧⲉⲧⲛϯⲙⲕⲁϩ	ⲁ|ⲧⲉⲧⲛ|ϯ|ⲙⲕⲁϩ
ⲉⲧⲃⲉⲧⲉⲛⲥⲱⲧⲏⲣⲓⲁ	ⲉⲧⲃⲉ|ⲧⲉⲛ|ⲥⲱⲧⲏⲣⲓⲁ
ⲛϭⲓⲓⲱⲥⲏⲫ	ⲛϭⲓ|ⲓⲱⲥⲏⲫ
ⲛⲧⲉⲗⲱⲛⲏⲥ	ⲛ|ⲧⲉⲗⲱⲛⲏⲥ
ⲛⲓⲡⲁⲣⲑⲉⲛⲟⲥ	ⲛⲓ|ⲡⲁⲣⲑⲉⲛⲟⲥ
ⲧⲁⲓⲥⲟⲫⲓⲁ	ⲧⲁⲓ|ⲥⲟⲫⲓⲁ
ϩⲟⲉⲓⲧⲉ	ϩⲟⲉⲓⲧⲉ
ⲉⲧⲉⲧⲛϣⲁⲛⲥⲱⲧⲙ	ⲉ|ⲧⲉⲧⲛ|ϣⲁⲛ|ⲥⲱⲧⲙ
ⲉⲡⲕⲁⲕⲉ	ⲉ|ⲡ|ⲕⲁⲕⲉ
ϫⲉϯⲥⲟⲟⲩⲛ	ϫⲉ|ϯ|ⲥⲟⲟⲩⲛ
ⲁⲛⲁⲩ	ⲁⲛⲁⲩ
ⲛⲟⲩⲟⲩϫⲁⲓ	ⲛ|ⲟⲩ|ⲟⲩϫⲁⲓ
ⲁϥⲁⲣⲛⲁ	ⲁ|ϥ|ⲁⲣⲛⲁ
ⲉⲧⲣⲉⲩⲕⲗⲏⲣⲟⲛⲟⲙⲉⲓ	ⲉ|ⲧⲣⲉ|ⲩ|ⲕⲗⲏⲣⲟⲛⲟⲙⲉⲓ
ⲙⲡⲁⲣⲭⲓⲉⲣⲉⲩⲥ	ⲙ|ⲡ|ⲁⲣⲭⲓⲉⲣⲉⲩⲥ
ⲕⲁⲧⲁⲡⲉⲧⲥⲏϩ	ⲕⲁⲧⲁ|ⲡ|ⲉⲧ|ⲥⲏϩ
ⲥⲟⲩⲱⲛⲟⲩ	ⲥⲟⲩⲱⲛ|ⲟⲩ
ⲛⲧⲁⲡⲣⲱⲙⲉ	ⲛⲧ|ⲁ|ⲡ|ⲣⲱⲙⲉ
ⲉⲧⲉⲧⲛⲥⲃⲧⲱⲧ	ⲉ|ⲧⲉⲧⲛ|ⲥⲃⲧⲱⲧ
ⲙⲛⲡⲉⲧⲧⲥⲟ	ⲙⲛ|ⲡ|ⲉⲧ|ⲧⲥⲟ
ⲧⲥⲃⲕⲉϩⲟⲟⲩ	ⲧⲥⲃ|ⲕⲉ|ϩⲟⲟⲩ
ϥϩⲛⲡⲉⲓⲙⲁ	ϥ|ϩⲛ|ⲡⲉⲓ|ⲙⲁ
ⲙⲛⲙⲁⲑⲁⲓⲟⲥ	ⲙⲛ|ⲙⲁⲑⲁⲓⲟⲥ
ϩⲛⲟⲩⲡⲓⲑⲉ	ϩⲛ|ⲟⲩ|ⲡⲓⲑⲉ
ⲉⲛⲉⲓⲛⲟϭ	ⲉ|ⲛⲉⲓ|ⲛⲟϭ
ⲡⲉⲧⲉⲣⲉⲡⲉⲧⲥⲏϭ	ⲡ|ⲉⲧⲉⲣⲉ|ⲡ|ⲉⲧ|ⲥⲏϭ
ⲉⲧϥⲛϩⲏⲧⲥ	ⲉⲧ|ϥ|ⲛϩⲏⲧ|ⲥ
ⲁⲩϯⲛⲉϥϩⲟⲉⲓⲧⲉ	ⲁ|ⲩ|ϯ|ⲛⲉϥ|ϩⲟⲉⲓⲧⲉ
ⲛⲧⲉϫⲓϩⲛⲟ	ⲛ|ⲧⲉ|ϫⲓ|ϩⲛⲟ
ⲡⲉⲃⲟⲗ	ⲡ|ⲉⲃⲟⲗ
ⲁϥⲭⲁⲣⲓⲍⲉ	ⲁ|ϥ|ⲭⲁⲣⲓⲍⲉ
ⲙⲡⲣⲏ	ⲙ|ⲡ|ⲣⲏ
ⲉⲩⲣⲟⲩ	ⲉ|ⲩ|ⲣ|ⲟⲩ
ⲛⲉⲡⲛⲁⲩ	ⲛⲉ|ⲡ|ⲛⲁⲩ
ⲁⲩⲥⲕⲁⲛⲇⲁⲗⲓⲍⲉ	ⲁ|ⲩ|ⲥⲕⲁⲛⲇⲁⲗⲓⲍⲉ
ϫⲉⲟⲩⲙⲉ	ϫⲉ|ⲟⲩ|ⲙⲉ
ⲛⲇⲓⲕⲁⲓⲟⲥⲡⲉ	ⲛ|ⲇⲓⲕⲁⲓⲟⲥ|ⲡⲉ
ⲛⲙⲓⲟⲩⲇⲁ	ⲛⲙ|ⲓⲟⲩⲇⲁ
ⲛⲛⲁϩⲣⲛⲛϣⲁϫⲉ	ⲛ|ⲛⲁϩⲣⲛ|ⲛ|ϣⲁϫⲉ
ϫⲉⲉⲥⲉⲓ	ϫⲉ|ⲉ|ⲥ|ⲉⲓ
ⲙⲛⲙⲛⲧⲁⲕⲁⲑⲁⲣⲧⲟⲥ	ⲙⲛ|ⲙⲛⲧⲁⲕⲁⲑⲁⲣⲧⲟⲥ
ⲛⲧⲉⲙⲡⲏⲩⲉ	ⲛⲧⲉ|ⲙ|ⲡⲏⲩⲉ
ⲁϩⲉⲣⲁⲧⲟⲩ	ⲁϩⲉ|ⲣⲁⲧ|ⲟⲩ
ⲛⲉⲧⲛⲕⲟⲧⲕ	ⲛ|ⲉⲧ|ⲛⲕⲟⲧⲕ
ⲡⲉⲣⲡⲉ	ⲡⲉ|ⲣⲡⲉ
ⲛⲉⲩⲛⲁⲩ	ⲛⲉ|ⲩ|ⲛⲁⲩ
ϫⲉⲧⲛⲧϭⲁⲓⲏⲩ	ϫⲉ|ⲧⲛ|ⲧϭⲁⲓⲏⲩ
ⲛϩⲏⲧϥ	ⲛϩⲏⲧ|ϥ
ⲛⲧⲉⲥϭⲓϫ	ⲛ|ⲧⲉⲥ|ϭⲓϫ
ⲁⲩϣⲱⲡⲉ	ⲁ|ⲩ|ϣⲱⲡⲉ
ⲛⲧⲉϣⲧⲏⲛ	ⲛ|ⲧⲉ|ϣⲧⲏⲛ
ϫⲉⲙⲁⲣⲟⲛ	ϫⲉ|ⲙⲁⲣⲟ|ⲛ
ⲉϥⲥⲟⲃϩ	ⲉ|ϥ|ⲥⲟⲃϩ
ⲙⲛⲛⲉϥⲁⲅⲅⲉⲗⲟⲥ	ⲙⲛ|ⲛⲉϥ|ⲁⲅⲅⲉⲗⲟⲥ
ⲁϥϥⲓⲧⲉϥⲁⲡⲉ	ⲁ|ϥ|ϥⲓ|ⲧⲉϥ|ⲁⲡⲉ
ⲛⲉϥⲟⲩⲏϩ	ⲛⲉ|ϥ|ⲟⲩⲏϩ
ϩⲙⲡⲉⲥⲙⲁ	ϩⲙ|ⲡⲉ|ⲥ|ⲙⲁ
ⲙⲡⲕⲁⲕⲉ	ⲙ|ⲡ|ⲕⲁⲕⲉ
ⲙⲡⲟⲩϩⲉ	ⲙⲡ|ⲟⲩ|ϩⲉ
ⲉⲧⲣⲁⲁⲕⲱ	ⲉ|ⲧⲣⲁ|ⲁ|ⲕⲱ
ⲛϩⲩⲡⲟⲧⲁⲅⲏ	ⲛ|ϩⲩⲡⲟⲧⲁⲅⲏ
ⲛⲓⲱⲥⲏ	ⲛ|ⲓⲱⲥⲏ
ⲙⲡⲕⲉⲏⲉⲓ	ⲙ|ⲡ|ⲕⲉ|ⲏⲉⲓ
ⲡⲕⲁⲧⲁⲡⲉⲧⲁⲥⲙⲁ	ⲡ|ⲕⲁⲧⲁⲡⲉⲧⲁⲥⲙⲁ
ϭⲛⲛⲁⲓ	ϭⲛ|ⲛⲁⲓ
ⲉⲧⲙⲧⲣⲉⲩϥⲓ	ⲉ|ⲧⲙ|ⲧⲣⲉ|ⲩ|ϥⲓ
ⲛⲧⲉⲩϩⲩⲡⲟⲕⲣⲓⲥⲓⲥ	ⲛ|ⲧⲉⲩ|ϩⲩⲡⲟⲕⲣⲓⲥⲓⲥ
ⲙⲙⲁⲩ	ⲙⲙⲁⲩ
ⲉϩⲉⲛϣⲏⲣⲉ	ⲉ|ϩⲉⲛ|ϣⲏⲣⲉ
ϩⲛⲟⲩⲱϣ	ϩⲛ|ⲟⲩⲱϣ
ⲛⲉϥϭⲏⲡ	ⲛⲉ|ϥ|ϭⲏⲡ
ⲙⲡⲉⲣⲟ	ⲙ|ⲡⲉ|ⲣⲟ
ⲱⲛϩ	ⲱⲛϩ
ⲁⲥⲧⲁⲁϥ	ⲁ|ⲥ|ⲧⲁⲁ|ϥ
ⲟⲡⲛ	ⲟⲡ|ⲛ
ⲙⲡⲉⲧⲛⲣⲡⲙⲉⲉⲩⲉ	ⲙⲡⲉ|ⲧⲛ|ⲣ|ⲡ|ⲙⲉⲉⲩⲉ
ϩⲛⲛⲥⲁ	ϩⲛ|ⲛ|ⲥⲁ
ⲉⲛⲟⲩⲉϭⲣⲟ	ⲉ|ⲛ|ⲟⲩⲉϭⲣⲟ
ⲉⲛⲉⲩⲡⲁⲑⲟⲥ	ⲉ|ⲛⲉⲩ|ⲡⲁⲑⲟⲥ
ⲉⲧⲟⲩⲛⲁⲡⲟⲛϥ	ⲉⲧ|ⲟⲩ|ⲛⲁ|ⲡⲟⲛ|ϥ
ⲛⲛⲉⲧⲣⲛⲟⲃⲉ	ⲛ|ⲛ|ⲉⲧ|ⲣ|ⲛⲟⲃⲉ
ⲙⲡⲛⲉⲩⲙⲁ	ⲙ|ⲡⲛⲉⲩⲙⲁ
ⲥⲏϣ	ⲥⲏϣ
ⲛⲧⲉϩⲓⲏ	ⲛ|ⲧⲉ|ϩⲓⲏ
ⲛϥⲥⲱⲟⲩϩ	ⲛ|ϥ|ⲥⲱⲟⲩϩ
ⲥⲁⲙⲯⲱⲛ	ⲥⲁⲙⲯⲱⲛ
ⲉⲣⲁⲧⲟⲩ	ⲉⲣⲁⲧ|ⲟⲩ
ⲛϩⲧⲟⲟⲩⲉ	ⲛ|ϩⲧⲟⲟⲩⲉ
ⲟⲩϣⲏⲣⲉ	ⲟⲩ|ϣⲏⲣⲉ
ⲙⲙⲁⲣⲓⲁ	ⲙ|ⲙⲁⲣⲓⲁ
ⲁⲩϫⲓϣⲕⲁⲕ	ⲁ|ⲩ|ϫⲓϣⲕⲁⲕ
ⲉϩⲟⲩⲛ	ⲉϩⲟⲩⲛ
ϩⲛⲛⲉⲭⲣⲉⲓⲥⲧⲓⲁⲛⲟⲥ	ϩⲛ|ⲛⲉ|ⲭⲣⲉⲓⲥⲧⲓⲁⲛⲟⲥ
ⲙⲡⲉⲡⲛⲟⲩⲧⲉ	ⲙⲡⲉ|ⲡ|ⲛⲟⲩⲧⲉ
ⲙⲁⲣⲉϥϣⲟⲩϣⲟⲩ	ⲙⲁⲣⲉ|ϥ|ϣⲟⲩϣⲟⲩ
ϫⲓⲛⲧⲁⲣⲭⲏ	ϫⲓⲛ|ⲧ|ⲁⲣⲭⲏ
ⲛⲑⲉ	ⲛ|ⲧ|ϩⲉ
ⲙⲛⲛⲉⲩϣⲉⲉⲣⲉ	ⲙⲛ|ⲛⲉⲩ|ϣⲉⲉⲣⲉ
ϩⲛϩⲉⲛⲡⲁⲣⲁⲃⲟⲗⲏ	ϩⲛ|ϩⲉⲛ|ⲡⲁⲣⲁⲃⲟⲗⲏ
ⲡⲉϥ	ⲡⲉϥ
ⲡⲁⲣⲁⲧⲉⲩϭⲟⲙ	ⲡⲁⲣⲁ|ⲧⲉⲩ|ϭⲟⲙ
ϩⲛⲁⲁⲩ	ϩⲛⲁⲁⲩ
ϫⲉⲡⲣⲟⲫⲏⲧⲉⲩⲉ	ϫⲉ|ⲡⲣⲟⲫⲏⲧⲉⲩⲉ
ⲉⲩⲉⲧⲁⲕⲟϥ	ⲉⲩⲉ|ⲧⲁⲕⲟ|ϥ
ⲙⲡⲉⲧⲣⲁ	ⲙ|ⲡⲉⲧⲣⲁ
ⲉⲩⲟⲩⲱϣ	ⲉ|ⲩ|ⲟⲩⲱϣ
ϭⲟⲗⲡ	ϭⲟⲗⲡ
ⲙⲙⲟⲩⲛⲅ	ⲙ|ⲙⲟⲩⲛⲅ
ⲛⲕⲁϩ	ⲛ|ⲕⲁϩ
ϫⲟⲉⲓⲥ	ϫⲟⲉⲓⲥ
ⲟⲩⲟⲉⲓ	ⲟⲩⲟⲉⲓ
ϫⲉⲛⲧⲟϥ	ϫⲉ|ⲛⲧⲟϥ
ⲧ	ⲧ
ⲡⲁⲛϫⲱϫ	ⲡ|ⲁⲛϫⲱϫ
ⲛⲟⲩⲥⲡⲉⲕⲟⲩⲗⲁⲧⲱⲣ	ⲛ|ⲟⲩ|ⲥⲡⲉⲕⲟⲩⲗⲁⲧⲱⲣ
ⲉⲧⲣⲉⲟⲩⲁ	ⲉ|ⲧⲣⲉ|ⲟⲩⲁ
ⲛⲏϫ	ⲛⲏϫ
ⲛⲉⲡⲉⲧⲉϣϣⲉ	ⲛⲉ|ⲡ|ⲉⲧ|ⲉϣ|ϣⲉ
ⲁϥⲁⲙⲁϩⲧⲉ	ⲁ|ϥ|ⲁⲙⲁϩⲧⲉ
ⲥⲉⲛⲁⲕⲁⲛⲉⲕⲛⲟⲃⲉ	ⲥⲉ|ⲛⲁ|ⲕⲁ|ⲛⲉⲕ|ⲛⲟⲃⲉ
ⲉⲧⲉⲧⲛⲁϣⲱⲡⲉ	ⲉ|ⲧⲉⲧⲛ|ⲛⲁ|ϣⲱⲡⲉ
ⲉⲕϣⲁⲛϭⲛ	ⲉⲕϣⲁⲛ|ϭⲛ
ⲛⲧⲁⲥϣⲱⲡⲉ	ⲛⲧ|ⲁ|ⲥ|ϣⲱⲡⲉ
ϫⲉⲉⲧⲉⲧⲛⲉϣⲱⲡⲉ	ϫⲉ|ⲉⲧⲉⲧⲛⲉ|ϣⲱⲡⲉ
ⲡⲉϫⲁⲓ	ⲡⲉϫⲁ|ⲓ
ⲛⲧⲉⲧⲛⲧⲁⲙⲟⲛ	ⲛⲧⲉⲧⲛ|ⲧⲁⲙⲟ|ⲛ
ⲙⲛⲓⲟⲩⲇⲁⲥ	ⲙⲛ|ⲓⲟⲩⲇⲁⲥ
ⲉⲣϣⲟⲣⲡ	ⲉ|ⲣϣⲟⲣⲡ
ⲉⲧⲉⲉⲓⲟⲩⲛⲟⲩ	ⲉ|ⲧⲉⲉⲓ|ⲟⲩⲛⲟⲩ
ϫⲉⲙⲡⲥⲧⲁⲙⲟⲛ	ϫⲉ|ⲙⲡ|ⲥ|ⲧⲁⲙⲟ|ⲛ
ϩⲓⲣⲙⲡⲣⲟ	ϩⲓⲣⲙ|ⲡ|ⲣⲟ
ⲉⲧⲃⲉⲡⲁϣⲁⲓ	ⲉⲧⲃⲉ|ⲡ|ⲁϣⲁⲓ
ⲙⲛⲓⲱϩⲁⲛⲛⲏⲥ	ⲙⲛ|ⲓⲱϩⲁⲛⲛⲏⲥ
ⲛⲧⲉⲧⲥⲁⲣⲝ	ⲛⲧⲉ|ⲧ|ⲥⲁⲣⲝ
ⲡⲉⲧϫⲟ	ⲡ|ⲉⲧ|ϫⲟ
ⲛϩⲉⲛⲥⲓⲟⲩⲣ	ⲛ|ϩⲉⲛ|ⲥⲓⲟⲩⲣ
ϩⲛⲛⲉⲅⲣⲁⲫⲏ	ϩⲛ|ⲛⲉ|ⲅⲣⲁⲫⲏ
ϫⲉⲙⲁⲣⲉⲡⲥⲁϩⲟⲩ	ϫⲉ|ⲙⲁⲣⲉ|ⲡ|ⲥⲁϩⲟⲩ
ⲉⲩⲟ	ⲉ|ⲩ|ⲟ
ϥⲱⲟⲟⲡ	ϥ|ⲱⲟⲟⲡ
ⲡⲉⲧⲁϩⲉⲣⲣⲁⲧϥ	ⲡ|ⲉⲧ|ⲁϩⲉⲣ|ⲣⲁⲧ|ϥ
ϥⲟⲩⲱⲙ	ϥ|ⲟⲩⲱⲙ
ⲧⲉⲧⲛⲧⲁⲉⲓⲏⲩ	ⲧⲉⲧⲛ|ⲧⲁⲉⲓⲏⲩ
ϥⲛⲁϫⲓⲧⲟⲩ	ϥ|ⲛⲁ|ϫⲓⲧ|ⲟⲩ
ⲉⲧⲕⲟⲓⲛⲱⲛⲓⲁ	ⲉ|ⲧ|ⲕⲟⲓⲛⲱⲛⲓⲁ
ⲙⲛⲟⲩϩⲟⲧⲉ	ⲙⲛ|ⲟⲩ|ϩⲟⲧⲉ
ⲉⲕⲁⲛⲟⲃⲉ	ⲉ|ⲕⲁ|ⲛⲟⲃⲉ
ⲁϥⲥⲱⲧⲙ	ⲁ|ϥ|ⲥⲱⲧⲙ
ⲡⲉⲛⲧⲱϣ	ⲡⲉⲛ|ⲧⲱϣ
ⲛⲛⲁϩⲓⲟⲟⲩⲉ	ⲛ|ⲛⲁ|ϩⲓⲟⲟⲩⲉ
ϣⲱⲗ	ϣⲱⲗ
ⲙⲡϫⲟⲉⲓⲥ	ⲙ|ⲡ|ϫⲟⲉⲓⲥ
ⲛⲧⲉⲩⲙⲛⲧⲁⲧⲛⲁϩⲧⲉ	ⲛ|ⲧⲉⲩ|ⲙⲛⲧⲁⲧⲛⲁϩⲧⲉ
ⲡⲓⲥⲣⲁⲏⲗ	ⲡ|ⲓⲥⲣⲁⲏⲗ
ⲟⲩⲡⲛⲉⲩⲙⲁ	ⲟⲩ|ⲡⲛⲉⲩⲙⲁ
ⲉⲁⲩⲥϩⲟⲩⲣⲡⲣⲟⲫⲏⲧⲏⲥ	ⲉ|ⲁ|ⲩ|ⲥϩⲟⲩⲣ|ⲡⲣⲟⲫⲏⲧⲏⲥ
ⲉⲙⲡⲟⲩⲃⲟⲗⲟⲩ	ⲉ|ⲙⲡ|ⲟⲩ|ⲃⲟⲗ|ⲟⲩ
ⲉⲧⲣⲉⲩϫⲱⲕ	ⲉ|ⲧⲣⲉ|ⲩ|ϫⲱⲕ
ϫⲉⲙⲙⲟⲛ	ϫⲉ|ⲙⲙⲟⲛ
ⲙⲛⲧⲁⲅⲁⲑⲟⲥ	ⲙⲛⲧⲁⲅⲁⲑⲟⲥ
ⲕⲉⲣⲭⲣⲓⲁ	ⲕⲉ|ⲣ|ⲭⲣⲓⲁ
ⲛ[.]ⲉϥϭⲓϫ	ⲛ|[.]ⲉ|ϥ|ϭⲓϫ
ϫⲉⲡⲁⲉⲓⲱⲧ	ϫⲉ|ⲡⲁ|ⲉⲓⲱⲧ
ⲥⲁⲣⲣⲁ	ⲥⲁⲣⲣⲁ
ⲛⲛⲉⲧⲟⲩϯ	ⲛ|ⲛ|ⲉⲧ|ⲟⲩϯ
ϩⲛⲧⲉϥϭⲓϫ	ϩⲛ|ⲧⲉϥ|ϭⲓϫ
ⲛⲥⲱⲛ	ⲛⲥⲱ|ⲛ
ⲛϥⲛⲁϯϩⲏⲩ	ⲛ|ϥ|ⲛⲁ|ϯ|ϩⲏⲩ
ⲙⲛⲛϩⲗⲗⲱ	ⲙⲛ|ⲛ|ϩⲗⲗⲱ
ⲉϣⲉ	ⲉ|ϣⲉ
ⲉⲛⲟⲩⲟⲟⲧⲉ	ⲉ|ⲛ|ⲟⲩⲟⲟⲧⲉ
ⲉⲁⲩϥⲓⲧϥ	ⲉ|ⲁ|ⲩ|ϥⲓⲧ|ϥ
ⲛⲛⲉϥⲛⲟϫⲟⲩ	ⲛⲛⲉ|ϥ|ⲛⲟϫ|ⲟⲩ
ⲕϣⲙϣⲉ	ⲕ|ϣⲙϣⲉ
ⲛⲧⲁⲩϯⲉⲟⲟⲩ	ⲛⲧ|ⲁ|ⲩ|ϯ|ⲉⲟⲟⲩ
ⲁϥⲕⲁⲣⲱϥ	ⲁ|ϥ|ⲕⲁⲣⲱ|ϥ
ⲛⲙⲛⲁ	ⲛⲙⲛⲁ
ⲉⲧⲉⲁⲛⲟⲕ	ⲉⲧⲉ|ⲁⲛⲟⲕ
ⲁⲩⲕⲁⲁϥ	ⲁ|ⲩ|ⲕⲁⲁ|ϥ
ⲉϥⲙⲟϫⲧ	ⲉ|ϥ|ⲙⲟϫⲧ
ⲙⲡⲟⲩⲁ	ⲙ|ⲡ|ⲟⲩⲁ
ϫⲉⲁⲛⲟⲕ	ϫⲉ|ⲁⲛⲟⲕ
ϩⲓⲱⲱⲕ	ϩⲓⲱⲱ|ⲕ
ⲛⲧⲛⲧⲁⲁⲩ	ⲛ|ⲧⲛ|ⲧⲁⲁ|ⲩ
ⲁϥⲡⲱⲣϫ	ⲁ|ϥ|ⲡⲱⲣϫ
ⲙⲛⲛⲉⲡⲛⲉⲩⲙⲁ	ⲙⲛ|ⲛⲉ|ⲡⲛⲉⲩⲙⲁ
ϩⲓⲉⲃⲓⲱ	ϩⲓ|ⲉⲃⲓⲱ
ⲛⲛϩⲉⲗⲗⲏⲛ	ⲛ|ⲛ|ϩⲉⲗⲗⲏⲛ
ϫⲉⲡⲥⲁϩ	ϫⲉ|ⲡ|ⲥⲁϩ
ϫⲉⲁϥϩⲱⲛ	ϫⲉ|ⲁ|ϥ|ϩⲱⲛ
ⲉⲛⲉⲃⲟⲗ	ⲉ|ⲛ|ⲉⲃⲟⲗ
ⲙⲡⲕⲁϣ	ⲙ|ⲡ|ⲕⲁϣ
ϩⲟⲙⲟⲓⲱⲥ	ϩⲟⲙⲟⲓⲱⲥ
ⲁϥϫⲓⲡⲉⲓⲱⲧ	ⲁ|ϥ|ϫⲓ|ⲡ|ⲉⲓⲱⲧ
ϩⲓⲛⲉϫⲏⲩ	ϩⲓ|ⲛ|ⲉϫⲏⲩ
ⲙⲛⲗⲁⲁⲩ	ⲙⲛ|ⲗⲁⲁⲩ
ⲉϫⲛⲟⲩϩⲉⲑⲛⲟⲥ	ⲉϫⲛ|ⲟⲩ|ϩⲉⲑⲛⲟⲥ
ⲉⲟⲩⲕ	ⲉ|ⲟⲩⲕ
ⲥⲟϣϥⲟⲩ	ⲥⲟϣϥ|ⲟⲩ
ⲁⲩϩⲙⲟⲟⲥ	ⲁ|ⲩ|ϩⲙⲟⲟⲥ
ⲡⲧⲁⲉⲓⲟ	ⲡⲧⲁⲉⲓⲟ
ⲛϩⲉⲑⲛⲟⲥ	ⲛ|ϩⲉⲑⲛⲟⲥ
ⲉⲩⲛⲧⲁⲩ	ⲉ|ⲩⲛⲧⲁ|ⲩ
ⲛϩⲗⲗⲱ	ⲛ|ϩⲗⲗⲱ
ⲛⲧⲓⲟⲩⲇⲁⲓⲁ	ⲛ|ⲧ|ⲓⲟⲩⲇⲁⲓⲁ
ⲉⲡⲉⲓⲣⲁⲥⲙⲟⲥ	ⲉ|ⲡ|ⲉⲓⲣⲁⲥⲙⲟⲥ
ⲛϭⲓϩⲟⲓⲛⲉ	ⲛϭⲓ|ϩⲟⲓⲛⲉ
ⲙⲛⲡⲟⲟϩ	ⲙⲛ|ⲡ|ⲟⲟϩ
ⲙⲡⲛⲟⲃⲉ	ⲙ|ⲡ|ⲛⲟⲃⲉ
ⲛⲛⲉⲧⲣϭⲣⲱϩ	ⲛ|ⲛ|ⲉⲧ|ⲣϭⲣⲱϩ
ⲉϥⲛⲉϫⲇⲁⲓⲙⲱⲛⲓⲟⲛ	ⲉ|ϥ|ⲛⲉϫ|ⲇⲁⲓⲙⲱⲛⲓⲟⲛ
ⲛⲥⲉⲡⲱⲧ	ⲛ|ⲥⲉ|ⲡⲱⲧ
ϩⲓϫⲛⲙⲡⲛⲏ	ϩⲓϫⲛ|ⲙ|ⲡⲛⲏ
ⲛⲙϩⲉⲛϩⲣⲟⲩ	ⲛⲙ|ϩⲉⲛ|ϩⲣⲟⲩ
ⲟⲩϩⲱⲃ	ⲟⲩ|ϩⲱⲃ
ⲡⲟⲛⲏⲣⲓⲁ	ⲡⲟⲛⲏⲣⲓⲁ
ⲛⲥⲱⲉⲓ	ⲛⲥⲱ|ⲉⲓ
ⲛⲛⲉⲩⲛⲟⲃⲉ	ⲛ|ⲛⲉⲩ|ⲛⲟⲃⲉ
ⲁϥⲣϣⲡⲏⲣⲉ	ⲁ|ϥ|ⲣϣⲡⲏⲣⲉ
ϫⲉⲁⲫⲑⲟⲛⲓⲁ	ϫⲉ|ⲁⲫⲑⲟⲛⲓⲁ
ⲛⲥⲉⲧⲟⲟⲩ	ⲛ|ⲥⲉ|ⲧⲟⲟⲩ
ⲉϣⲁⲧⲉⲧⲛϣⲁⲧⲟⲩ	ⲉ|ϣⲁ|ⲧⲉⲧⲛ|ϣⲁⲧⲟⲩ
ϫⲉⲧⲉⲕϣⲉⲉⲣⲉ	ϫⲉ|ⲧⲉⲕ|ϣⲉⲉⲣⲉ
ϩⲓϫⲙⲡⲕⲁϩ	ϩⲓϫⲙ|ⲡ|ⲕⲁϩ
ⲙⲡⲉⲕⲙⲧⲟⲛ	ⲙⲡⲉ|ⲕ|ⲙⲧⲟⲛ
ⲛϥⲓ	ⲛϥⲓ
ⲁϥϫⲉⲩ	ⲁ|ϥ|ϫⲉⲩ
ⲉⲧⲙⲉϩ	ⲉⲧ|ⲙⲉϩ
ϫⲉⲛⲛⲁⲥⲱ	ϫⲉ|ⲛⲛⲁ|ⲥⲱ
ⲉⲩⲁⲛⲁⲅⲕⲁⲍⲉ	ⲉ|ⲩ|ⲁⲛⲁⲅⲕⲁⲍⲉ
-	-
ⲧⲛⲥⲟⲟⲩⲛ	ⲧⲛ|ⲥⲟⲟⲩⲛ
ϫⲉⲉⲕⲧⲙⲥⲱ	ϫⲉ|ⲉ|ⲕ|ⲧⲙ|ⲥⲱ
ϩⲓϫⲛⲡⲉⲥⲧⲁⲩⲣⲟⲥ	ϩⲓϫⲛ|ⲡⲉ|ⲥⲧⲁⲩⲣⲟⲥ
ϩⲙⲡⲧⲱϣ	ϩⲙ|ⲡ|ⲧⲱϣ
ⲛⲁⲙⲉⲡⲉ	ⲛⲁⲙⲉ|ⲡⲉ
ⲁϥⲁⲣⲭⲉⲓ	ⲁ|ϥ|ⲁⲣⲭⲉⲓ
ⲛⲛⲁⲣⲇⲟⲥ	ⲛ|ⲛⲁⲣⲇⲟⲥ
ϩⲛⲛⲓⲛⲟϭ	ϩⲛ|ⲛⲓ|ⲛⲟϭ
ϫⲉⲣⲟⲉⲓⲥ	ϫⲉ|ⲣⲟⲉⲓⲥ
ⲛⲉⲡⲣⲉⲥⲃⲩⲧⲉⲣⲟⲥ	ⲛⲉ|ⲡⲣⲉⲥⲃⲩⲧⲉⲣⲟⲥ
ⲉⲧⲉⲣⲉⲧϣⲉⲉⲣⲉ	ⲉⲧⲉⲣⲉ|ⲧ|ϣⲉⲉⲣⲉ
ⲡⲡⲉⲧⲟⲩⲁⲁⲃ	ⲡ|ⲡ|ⲉⲧ|ⲟⲩⲁⲁⲃ
ϩⲁⲧⲡⲉ	ϩⲁ|ⲧ|ⲡⲉ
ⲉⲧϩⲁⲣⲉϩ	ⲉⲧ|ϩⲁⲣⲉϩ
ⲛⲧⲉⲧⲛⲙⲉϣ	ⲛⲧⲉⲧⲛ|ⲙⲉϣ
ϫⲉⲭⲁⲓⲣⲉ	ϫⲉ|ⲭⲁⲓⲣⲉ
ⲉⲓⲥⲛϩⲗⲗⲟⲉⲓ	ⲉⲓⲥ|ⲛ|ϩⲗⲗⲟ|ⲉⲓ
ⲉⲩϣⲧⲣⲧⲱⲣ	ⲉ|ⲩ|ϣⲧⲣⲧⲱⲣ
ϫⲉⲥⲉⲁⲛⲁⲕⲣⲓⲛⲉ	ϫⲉ|ⲥⲉ|ⲁⲛⲁⲕⲣⲓⲛⲉ
ϩⲛⲏⲥⲁⲓⲁⲥ	ϩⲛ|ⲏⲥⲁⲓⲁⲥ
ⲉⲩⲕⲏⲕⲁϩⲏⲩ	ⲉ|ⲩ|ⲕⲏⲕ|ⲁϩⲏⲩ
ⲉϣⲁⲣⲉϩⲁϩ	ⲉ|ϣⲁⲣⲉ|ϩⲁϩ
ⲛⲟⲩⲁϭⲣⲏⲛ	ⲛ|ⲟⲩ|ⲁϭⲣⲏⲛ
ⲕⲁⲧⲁϩⲟⲓ	ⲕⲁⲧⲁ|ϩⲟⲓ
ⲙⲛⲛⲉⲅⲣⲁⲙⲙⲁⲧⲉⲩⲥ	ⲙⲛ|ⲛⲉ|ⲅⲣⲁⲙⲙⲁⲧⲉⲩⲥ
ⲉⲙⲛⲉⲓⲱⲧ	ⲉ|ⲙⲛ|ⲉⲓⲱⲧ
ⲡⲕⲉⲟⲩⲁ	ⲡ|ⲕⲉ|ⲟⲩⲁ
ϩⲣⲏϭ	ϩⲣⲏϭ
ⲉⲧⲃⲏⲕ	ⲉⲧ|ⲃⲏⲕ
ⲛⲛⲁⲡⲛⲟⲩⲧⲉ	ⲛ|ⲛⲁ|ⲡ|ⲛⲟⲩⲧⲉ
ⲁⲧⲉⲧⲛⲣⲣⲙⲙⲁⲟ	ⲁ|ⲧⲉⲧⲛ|ⲣⲣⲙⲙⲁⲟ
ⲧⲉⲧⲛⲡⲉⲓⲣⲁⲍⲉ	ⲧⲉⲧⲛ|ⲡⲉⲓⲣⲁⲍⲉ
ⲛⲣⲓⲣ	ⲛ|ⲣⲓⲣ
ⲛⲧⲉⲧⲛϩⲉ	ⲛ|ⲧⲉⲧⲛ|ϩⲉ
ⲛⲧⲉⲧⲛⲛⲁⲩ	ⲛ|ⲧⲉⲧⲛ|ⲛⲁⲩ
ⲧⲁⲟⲧⲡ	ⲧⲁ|ⲟⲧⲡ
ⲛⲉⲡⲣⲟⲫⲏⲧⲏⲥ	ⲛⲉ|ⲡⲣⲟⲫⲏⲧⲏⲥ
·	·
ⲉⲥⲱⲣⲙ	ⲉ|ⲥⲱⲣⲙ
ⲛϩⲉ	ⲛ|ϩⲉ
ϩⲙⲡⲉⲓⲙⲁ	ϩⲙ|ⲡⲉⲓ|ⲙⲁ
ⲛⲧⲁⲛⲁⲣⲭⲱⲛ	ⲛⲧⲁ|ⲛ|ⲁⲣⲭⲱⲛ
ⲙⲛⲛⲁⲅⲅⲉⲗⲟⲥ	ⲙⲛ|ⲛ|ⲁⲅⲅⲉⲗⲟⲥ
ⲉϩⲣⲁⲩ	ⲉϩⲣⲁ|ⲩ
ϩⲓϫⲛϩⲁϩ	ϩⲓϫⲛ|ϩⲁϩ
ⲛⲉⲛ	ⲛⲉⲛ
ⲛϭⲓⲡⲕⲉⲛⲧⲩⲣⲓⲱⲛ	ⲛϭⲓ|ⲡ|ⲕⲉⲛⲧⲩⲣⲓⲱⲛ
ⲛⲁⲙⲧⲟⲛ	ⲛⲁ|ⲙⲧⲟⲛ
ⲙⲛⲡⲟⲣⲛⲟⲥ	ⲙⲛ|ⲡⲟⲣⲛⲟⲥ
ϩⲙⲡϫⲱⲱⲙⲉ	ϩⲙ|ⲡ|ϫⲱⲱⲙⲉ
ϩⲓⲧⲟⲩⲉⲣⲏⲧⲉ	ϩⲓ|ⲧ|ⲟⲩⲉⲣⲏⲧⲉ
ⲉⲧⲟⲩⲙⲟⲩⲧⲉ	ⲉⲧ|ⲟⲩ|ⲙⲟⲩⲧⲉ
ⲉⲩⲏⲡ	ⲉ|ⲩ|ⲏⲡ
ⲛϭⲓⲛⲉⲧⲛⲙⲙⲁϥ	ⲛϭⲓ|ⲛ|ⲉⲧ|ⲛⲙⲙⲁ|ϥ
ϣⲁⲛⲧⲉⲡϫⲟⲉⲓⲥ	ϣⲁⲛⲧⲉ|ⲡ|ϫⲟⲉⲓⲥ
ⲥⲉⲧⲁⲩⲟ	ⲥⲉ|ⲧⲁⲩⲟ
ⲛⲉⲛⲧⲁⲩϫⲟⲟⲩ	ⲛ|ⲉⲛⲧ|ⲁ|ⲩ|ϫⲟⲟⲩ
ⲁⲩⲟⲩⲱϣ	ⲁ|ⲩ|ⲟⲩⲱϣ
ⲉⲛⲧⲟⲩⲓⲏ	ⲉ|ⲛ|ⲧⲟⲩⲓⲏ
ϫⲉⲛⲣⲱⲙⲉ	ϫⲉ|ⲛ|ⲣⲱⲙⲉ
ⲙⲛⲟⲩⲟⲣⲅⲏ	ⲙⲛ|ⲟⲩ|ⲟⲣⲅⲏ
ⲉⲧϣⲉⲉⲣⲉ	ⲉ|ⲧ|ϣⲉⲉⲣⲉ
ⲙⲡϭⲱⲗⲡ	ⲙ|ⲡ|ϭⲱⲗⲡ
ⲉⲁⲩϣⲉⲧϣⲱⲧϥ	ⲉ|ⲁ|ⲩ|ϣⲉⲧϣⲱⲧ|ϥ
ϫⲉⲛⲧⲟⲕⲡⲉ	ϫⲉ|ⲛⲧⲟⲕ|ⲡⲉ
ⲙⲛⲫⲓⲗⲓⲡⲡⲟⲥ	ⲙⲛ|ⲫⲓⲗⲓⲡⲡⲟⲥ
ⲛϩⲙϩⲁⲗⲙⲡϫⲟⲉⲓⲥ	ⲛ|ϩⲙϩⲁⲗ|ⲙ|ⲡ|ϫⲟⲉⲓⲥ
ⲉϥⲛⲁⲁⲡⲟⲇⲏⲙⲉⲓ	ⲉ|ϥ|ⲛⲁ|ⲁⲡⲟⲇⲏⲙⲉⲓ
ϫⲉϩⲉⲛⲕⲟⲟⲩⲉ	ϫⲉ|ϩⲉⲛ|ⲕⲟⲟⲩⲉ
ϥⲙⲟⲩⲧⲉ	ϥ|ⲙⲟⲩⲧⲉ
ⲛϭⲓⲧⲙⲁⲁⲩ	ⲛϭⲓ|ⲧ|ⲙⲁⲁⲩ
ⲛⲧⲁⲓⲉⲓ	ⲛⲧ|ⲁ|ⲓ|ⲉⲓ
ϩⲙⲡⲧⲣⲉⲡⲉⲧⲛϩⲏⲧ	ϩⲙ|ⲡ|ⲧⲣⲉ|ⲡⲉⲧⲛ|ϩⲏⲧ
ⲛⲧ	ⲛⲧ
ⲛⲁⲅⲅⲉⲗⲟⲥ	ⲛ|ⲁⲅⲅⲉⲗⲟⲥ
ⲉⲩⲥⲱⲧⲙ	ⲉ|ⲩ|ⲥⲱⲧⲙ
ⲉⲩⲙⲁⲕⲁⲣⲓⲍⲉ	ⲉ|ⲩ|ⲙⲁⲕⲁⲣⲓⲍⲉ
ⲥⲉⲛⲁϣⲓ	ⲥⲉ|ⲛⲁ|ϣ|ⲓ
ⲙⲟⲟⲩⲧ	ⲙⲟⲟⲩⲧ
ⲉⲙⲛϣⲏⲣⲉ	ⲉ|ⲙⲛ|ϣⲏⲣⲉ
ⲉϫⲱⲕ	ⲉϫⲱ|ⲕ
ⲛⲛⲉⲧⲙⲉ	ⲛ|ⲛⲉ|ⲧ|ⲙⲉ
ⲛⲉⲧⲙⲟⲟⲛⲉ	ⲛ|ⲉⲧ|ⲙⲟⲟⲛⲉ
ⲡⲉⲡⲛⲉⲩⲙⲁ	ⲡⲉ|ⲡⲛⲉⲩⲙⲁ
ⲉⲃ[........]ⲟⲩⲇ[.......]ⲡⲉ	ⲉⲃ[........]|ⲟⲩⲇ[.......]|ⲡⲉ
ⲛⲙⲙⲛⲧⲁⲧⲥⲃⲱ	ⲛ|ⲙ|ⲙⲛⲧⲁⲧⲥⲃⲱ
ⲙⲙⲁⲧⲉ	ⲙⲙⲁⲧⲉ
ⲉⲧⲁⲙⲛⲧⲁⲑⲏⲧ	ⲉ|ⲧⲁ|ⲙⲛⲧⲁⲑⲏⲧ
ⲥⲛⲁⲩ	ⲥⲛⲁⲩ
ⲁϥⲥⲁⲛϣⲧⲏⲩⲧⲛ	ⲁ|ϥ|ⲥⲁⲛϣ|ⲧⲏⲩⲧⲛ
ⲁϥⲣⲡⲙⲉⲉⲩⲉ	ⲁ|ϥ|ⲣ|ⲡ|ⲙⲉⲉⲩⲉ
ϫⲉⲙⲛϭⲉⲛⲟⲩⲧⲉ	ϫⲉ|ⲙⲛ|ϭⲉ|ⲛⲟⲩⲧⲉ
ⲙⲛϩⲣⲁⲭⲏⲗ	ⲙⲛ|ϩⲣⲁⲭⲏⲗ
ⲛϩⲏⲧⲁⲛⲟⲛ	ⲛϩⲏⲧ|ⲁⲛⲟⲛ
ⲛⲧⲛϩⲱⲃⲥⲉⲃⲟⲗ	ⲛ|ⲧⲛ|ϩⲱⲃⲥ|ⲉⲃⲟⲗ
ⲛⲛⲉⲛⲧⲁⲓⲏⲥⲟⲩⲥ	ⲛⲛⲉ|ⲛⲧ|ⲁ|ⲓⲏⲥⲟⲩⲥ
ⲉⲧⲃⲉⲡⲉⲕⲧⲃⲃⲟ	ⲉⲧⲃⲉ|ⲡⲉⲕ|ⲧⲃⲃⲟ
ⲥⲉⲧⲁⲩⲉⲕⲁⲣⲡⲟⲥ	ⲥⲉ|ⲧⲁⲩⲉ|ⲕⲁⲣⲡⲟⲥ
ⲉⲛⲙⲁ	ⲉ|ⲛ|ⲙⲁ
ⲛⲁϫⲡⲟ	ⲛⲁ|ϫⲡⲟ
ⲁⲡⲓⲗⲁⲧⲟⲥ	ⲁ|ⲡⲓⲗⲁⲧⲟⲥ
ⲉⲛⲉ	ⲉⲛⲉ
ⲡⲣⲟⲥⲕⲁⲣⲧⲉⲣⲉⲓ	ⲡⲣⲟⲥⲕⲁⲣⲧⲉⲣⲉⲓ
ⲧⲙⲛⲧϭⲱⲃ	ⲧ|ⲙⲛⲧϭⲱⲃ
ⲙⲛⲛⲉⲧⲙⲉ	ⲙⲛ|ⲛ|ⲉⲧ|ⲙⲉ
ⲛⲁⲃⲣⲁϩⲁⲙ	ⲛ|ⲁⲃⲣⲁϩⲁⲙ
ⲉⲩⲃⲟⲟⲛⲉ	ⲉ|ⲩ|ⲃⲟⲟⲛⲉ
ϣⲁⲡϩⲗⲗⲟ	ϣⲁ|ⲡ|ϩⲗⲗⲟ
ⲉⲧⲃⲉⲡⲁⲣⲁⲛ	ⲉⲧⲃⲉ|ⲡⲁ|ⲣⲁⲛ
ⲧϩⲙϩⲁⲗ	ⲧ|ϩⲙϩⲁⲗ
ⲙⲡⲉⲕⲏⲓ	ⲙ|ⲡⲉⲕ|ⲏⲓ
ⲛϫⲁⲙⲏ	ⲛ|ϫⲁⲙⲏ
ⲉⲧⲉⲧⲛϫⲱ	ⲉ|ⲧⲉⲧⲛ|ϫⲱ
ⲉⲧⲉⲧⲛⲟⲃϣ	ⲉ|ⲧⲉⲧⲛ|ⲟⲃϣ
ϣⲁⲣⲱⲧⲛ	ϣⲁⲣⲱ|ⲧⲛ
ⲛⲧⲁⲡⲁⲓϣⲱⲡⲉ	ⲛⲧ|ⲁ|ⲡⲁⲓ|ϣⲱⲡⲉ
ϩⲓⲛⲓⲙⲛⲧⲣⲉϥϯϭⲱⲛⲧ	ϩⲓ|ⲛⲓ|ⲙⲛⲧⲣⲉϥϯϭⲱⲛⲧ
ⲛⲉⲩⲥⲱⲃⲉ	ⲛⲉ|ⲩ|ⲥⲱⲃⲉ
ϫⲉⲉⲧⲉⲧⲛⲛⲁⲩ	ϫⲉ|ⲉ|ⲧⲉⲧⲛ|ⲛⲁⲩ
ϫⲉⲉⲛⲉⲁϥⲱⲥⲕ	ϫⲉ|ⲉⲛⲉ|ⲁ|ϥ|ⲱⲥⲕ
ϫⲉⲛⲅⲛⲁϣⲁϫⲉ	ϫⲉ|ⲛ|ⲅ|ⲛⲁ|ϣⲁϫⲉ
ⲛⲉⲓⲙⲉⲉⲩⲉ	ⲛⲉ|ⲓ|ⲙⲉⲉⲩⲉ
ⲅ	ⲅ
ⲁϥϯⲡⲓ	ⲁ|ϥ|ϯⲡⲓ
ⲛϩⲉⲛⲉⲕⲓⲃⲉ	ⲛ|ϩⲉⲛ|ⲉⲕⲓⲃⲉ
ϯⲛⲁϩⲟⲧⲃⲉⲕ	ϯ|ⲛⲁ|ϩⲟⲧⲃⲉ|ⲕ
ⲙⲡⲟⲩϯⲥⲟ	ⲙⲡ|ⲟⲩ|ϯ|ⲥⲟ
ⲡⲉⲧϣⲟⲟⲡ	ⲡ|ⲉⲧ|ϣⲟⲟⲡ
ⲛⲧⲉϥⲣⲓ	ⲛ|ⲧⲉϥ|ⲣⲓ
ⲥⲉⲛⲁⲛⲏⲥⲧⲉⲩⲉ	ⲥⲉ|ⲛⲁ|ⲛⲏⲥⲧⲉⲩⲉ
ϫⲉⲡϫⲟⲉⲓⲥ	ϫⲉ|ⲡ|ϫⲟⲉⲓⲥ
ⲁⲥⲙⲟⲟϣⲉ	ⲁ|ⲥ|ⲙⲟⲟϣⲉ
ⲉⲧⲉⲣⲉⲛⲉⲓⲁⲧⲥⲃⲱ	ⲉⲧⲉⲣⲉ|ⲛⲉⲓ|ⲁⲧⲥⲃⲱ
ⲉⲩⲉϣⲙϣⲉ	ⲉⲩⲉ|ϣⲙϣⲉ
ⲉⲧⲉⲟⲩⲛⲧⲁⲥϥ	ⲉⲧⲉ|ⲟⲩⲛⲧⲁ|ⲥ|ϥ
ⲉϫⲛⲛⲉⲩⲥⲛⲏⲩ	ⲉϫⲛ|ⲛⲉ|ⲩ|ⲥⲛⲏⲩ
ⲧⲁⲓⲟ	ⲧⲁⲓⲟ
ϯⲛⲁⲧⲁⲙⲱⲧⲛ	ϯ|ⲛⲁ|ⲧⲁⲙⲱ|ⲧⲛ
ⲛⲥⲁⲧⲉⲉⲣⲉ	ⲛ|ⲥⲁⲧⲉⲉⲣⲉ
ⲙⲛⲛⲉⲧⲣⲱⲧ	ⲙⲛ|ⲛ|ⲉⲧ|ⲣⲱⲧ
ⲙⲉⲥⲟⲩⲁⲫⲓ	ⲙⲉⲥⲟⲩⲁⲫⲓ
ϩⲛⲛⲧⲟⲩⲓⲏ	ϩⲛ|ⲛ|ⲧⲟⲩⲓⲏ
ⲛⲅⲧⲥⲁⲃⲟⲕ	ⲛ|ⲅ|ⲧⲥⲁⲃⲟ|ⲕ
ⲛⲧⲥⲟⲫⲓⲁ	ⲛ|ⲧ|ⲥⲟⲫⲓⲁ
ϫⲉⲉⲓⲥⲧⲉⲕⲙⲁⲁⲩ	ϫⲉ|ⲉⲓⲥ|ⲧⲉⲕ|ⲙⲁⲁⲩ
ϫⲉϣⲁⲣⲉⲟⲩⲕⲟⲩⲓ	ϫⲉ|ϣⲁⲣⲉ|ⲟⲩ|ⲕⲟⲩⲓ
ⲛⲅⲛⲁϩⲙⲕ	ⲛ|ⲅ|ⲛⲁϩⲙ|ⲕ
ⲟⲩⲟⲛ	ⲟⲩⲟⲛ
ⲉⲛⲉⲙⲡⲕⲥⲱⲧⲉ	ⲉ|ⲛⲉ|ⲙⲡ|ⲕ|ⲥⲱⲧⲉ
ⲉⲓⲙⲉ	ⲉ|ⲓ|ⲙⲉ
ϫⲉⲙⲡⲟⲣⲛⲟⲥ	ϫⲉ|ⲙ|ⲡⲟⲣⲛⲟⲥ
ϩⲛⲧⲉⲑⲁⲗⲁⲥⲥⲁ	ϩⲛ|ⲧⲉ|ⲑⲁⲗⲁⲥⲥⲁ
ⲙⲙⲉ	ⲙ|ⲙⲉ
ⲁⲩⲧⲟⲩ	ⲁⲩⲧⲟⲩ
ⲛⲧⲁⲕϫⲟⲟⲥ	ⲛⲧ|ⲁ|ⲕ|ϫⲟⲟ|ⲥ
ⲛⲁϣⲃⲉⲉⲣ	ⲛⲁ|ϣⲃⲉⲉⲣ
ⲧⲉⲕϩⲓⲏ	ⲧⲉⲕ|ϩⲓⲏ
ⲉⲩϣⲡϩⲙⲟⲧ	ⲉ|ⲩ|ϣⲡ|ϩⲙⲟⲧ
ⲕⲣⲟⲛⲟⲥ	ⲕⲣⲟⲛⲟⲥ
ⲙⲛⲟⲩⲙⲛⲧⲃⲗⲗⲉ	ⲙⲛ|ⲟⲩ|ⲙⲛⲧⲃⲗⲗⲉ
ⲉϫⲱⲥ	ⲉϫⲱ|ⲥ
ϣⲟⲟⲩⲉ	ϣⲟⲟⲩⲉ
ⲛϥϩⲙⲡⲉⲓⲙⲁ	ⲛ|ϥ|ϩⲙ|ⲡⲉⲓ|ⲙⲁ
ⲡⲟⲟϩ	ⲡ|ⲟⲟϩ
ⲙⲏ	ⲙⲏ
ⲉⲁⲩⲟⲩⲱϭⲡ	ⲉ|ⲁ|ⲩ|ⲟⲩⲱϭⲡ
ⲛϭⲓⲥⲓⲙⲱⲛ	ⲛϭⲓ|ⲥⲓⲙⲱⲛ
ⲕⲁⲥⲓⲁⲛⲟⲥ	ⲕⲁⲥⲓⲁⲛⲟⲥ
ⲙⲛⲃⲁⲣⲑⲟⲗⲟⲙⲁⲓⲟⲥ	ⲙⲛ|ⲃⲁⲣⲑⲟⲗⲟⲙⲁⲓⲟⲥ
ⲉⲣϣⲁⲛⲟⲩⲁ	ⲉⲣϣⲁⲛ|ⲟⲩⲁ
ⲛⲧⲉⲗⲟ	ⲛⲧⲉ|ⲗⲟ
ⲛⲧⲥⲛⲧⲉ	ⲛ|ⲧ|ⲥⲛⲧⲉ
ⲉϥⲙⲟⲥⲧⲉ	ⲉ|ϥ|ⲙⲟⲥⲧⲉ
ⲉⲣⲟ	ⲉⲣⲟ
ⲁⲩⲟⲩⲁϩⲟⲩ	ⲁ|ⲩ|ⲟⲩⲁϩ|ⲟⲩ
ⲡⲉⲕⲉⲓⲱⲧ	ⲡⲉⲕ|ⲉⲓⲱⲧ
ⲛⲧⲉⲣⲟⲩⲣⲛⲟⲃⲉ	ⲛⲧⲉⲣ|ⲟⲩ|ⲣ|ⲛⲟⲃⲉ
ⲓⲟⲩⲇⲁⲥ	ⲓⲟⲩⲇⲁⲥ
ⲧⲁⲕⲉⲟⲩⲁ	ⲧⲁ|ⲕⲉ|ⲟⲩⲁ
ⲉϥϩⲙⲟⲟⲥ	ⲉ|ϥ|ϩⲙⲟⲟⲥ
ⲉⲧⲟϣ	ⲉⲧ|ⲟϣ
ϫⲉⲁⲥⲛⲁⲩ	ϫⲉ|ⲁ|ⲥ|ⲛⲁⲩ
ⲉⲝⲉⲥⲧⲓ	ⲉⲝⲉⲥⲧⲓ
ⲉϣϫⲉⲁϩⲉⲛϣⲏⲣⲉ	ⲉϣϫⲉ|ⲁ|ϩⲉⲛ|ϣⲏⲣⲉ
ⲉϥⲉⲕⲁⲧⲁⲣⲅⲉⲓ	ⲉ|ϥ|ⲉ|ⲕⲁⲧⲁⲣⲅⲉⲓ
ϩⲓϯⲧⲱⲛ	ϩⲓ|ϯ|ⲧⲱⲛ
ⲡⲱϣⲥ	ⲡⲱϣ|ⲥ
ⲡϣⲁϫⲉ	ⲡ|ϣⲁϫⲉ
ⲁⲩⲥⲕⲣⲕⲣⲟⲩⲱⲛⲉ	ⲁ|ⲩ|ⲥⲕⲣⲕⲣ|ⲟⲩ|ⲱⲛⲉ
ⲙⲁⲣⲉϥⲣⲥⲟϭ	ⲙⲁⲣⲉ|ϥ|ⲣⲥⲟϭ
ϫⲉⲛⲧⲁⲧⲉⲧⲛⲃⲁⲡⲧⲓⲍⲉ	ϫⲉ|ⲛⲧ|ⲁ|ⲧⲉⲧⲛ|ⲃⲁⲡⲧⲓⲍⲉ
ⲉⲛⲉϥⲙⲁⲑⲏⲧⲏⲥ	ⲉ|ⲛⲉϥ|ⲙⲁⲑⲏⲧⲏⲥ
ⲙⲡϣⲱⲥ	ⲙ|ⲡ|ϣⲱⲥ
ⲙⲡⲣⲧⲣⲉⲛϣⲱⲡⲉ	ⲙⲡⲣ|ⲧⲣⲉ|ⲛ|ϣⲱⲡⲉ
ⲛⲟⲩⲃⲁⲡⲧⲓⲥⲙⲁ	ⲛ|ⲟⲩ|ⲃⲁⲡⲧⲓⲥⲙⲁ
ϩⲁⲧⲏⲛ	ϩⲁⲧⲏ|ⲛ
ⲥⲉⲛⲁⲧⲁⲗⲉ	ⲥⲉ|ⲛⲁ|ⲧⲁⲗⲉ
[...]ⲩ	[...]ⲩ
ⲡⲙⲏⲏϣⲉ	ⲡ|ⲙⲏⲏϣⲉ
ⲡⲉⲧϩⲟⲗϭ	ⲡ|ⲉⲧ|ϩⲟⲗϭ
ϩⲛⲟⲩϫⲓⲥⲉ	ϩⲛ|ⲟⲩ|ϫⲓⲥⲉ
ⲧⲉⲓ	ⲧⲉⲓ
ⲛⲟⲩⲣⲱⲙⲉ	ⲛ|ⲟⲩ|ⲣⲱⲙⲉ
ϩⲉⲛⲉⲡⲟⲓⲕⲓⲟⲛ 	ϩⲉⲛ|ⲉⲡⲟⲓⲕⲓⲟⲛ 
ⲛⲁⲧϣⲁⲩ	ⲛ|ⲁⲧϣⲁⲩ
ⲁⲉⲓϯⲃⲁⲡⲧⲓⲥⲙⲁ	ⲁ|ⲉⲓ|ϯ|ⲃⲁⲡⲧⲓⲥⲙⲁ
ϫⲉⲙⲡⲉⲧⲛⲟϣϥ	ϫⲉ|ⲙⲡⲉ|ⲧⲛ|ⲟϣ|ϥ
ϫⲉⲟⲩⲁϩⲕ	ϫⲉ|ⲟⲩⲁϩ|ⲕ
ⲛⲧⲁⲧⲉⲧⲛⲧⲁϩⲟⲥ	ⲛⲧ|ⲁ|ⲧⲉⲧⲛ|ⲧⲁϩⲟ|ⲥ
ⲉϥⲟⲃⲣⲣⲉ	ⲉ|ϥ|ⲟⲃⲣⲣⲉ
ⲉⲧⲉⲧⲛⲕⲱⲧⲉ	ⲉ|ⲧⲉⲧⲛ|ⲕⲱⲧⲉ
ϩⲁⲣⲓϩⲁⲣⲟⲕ	ϩⲁⲣⲓϩⲁⲣⲟ|ⲕ
ϫⲉⲟⲩⲣⲱⲙⲉ	ϫⲉ|ⲟⲩ|ⲣⲱⲙⲉ
ⲁϩⲣⲟⲟⲩ	ⲁϩⲣⲟ|ⲟⲩ
ⲛⲅⲙⲉϣⲧⲛⲁⲏⲓ	ⲛ|ⲅ|ⲙⲉϣⲧ|ⲛⲁ|ⲏⲓ
ⲛⲧⲁⲡⲉ	ⲛ|ⲧ|ⲁⲡⲉ
ⲉⲧⲉⲛⲧⲟⲕ	ⲉⲧⲉ|ⲛⲧⲟⲕ
ⲛϥⲧⲙϭⲙϭⲟⲙ	ⲛ|ϥ|ⲧⲙ|ϭⲙϭⲟⲙ
ϩⲛϩⲉⲛⲥⲓⲟⲟⲩⲛⲉ	ϩⲛ|ϩⲉⲛ|ⲥⲓⲟⲟⲩⲛⲉ
ⲙⲛⲛⲑⲩⲥⲓⲁ	ⲙⲛ|ⲛ|ⲑⲩⲥⲓⲁ
ϫⲉⲡⲉⲧⲣⲟⲥ	ϫⲉ|ⲡⲉⲧⲣⲟⲥ
ⲓⲥⲁⲁⲕ	ⲓⲥⲁⲁⲕ
ⲛⲟⲩⲥⲓⲛⲇⲱⲛ	ⲛ|ⲟⲩ|ⲥⲓⲛⲇⲱⲛ
ⲙⲛⲛϣⲏⲣⲉ	ⲙⲛ|ⲛ|ϣⲏⲣⲉ
ⲛⲟⲩⲛⲧⲟⲗⲏ	ⲛ|ⲟⲩ|ⲛⲧⲟⲗⲏ
ⲡⲉⲩⲟⲉⲓϣ	ⲡⲉ|ⲩⲟⲉⲓϣ
ⲛⲁⲉⲓⲁⲧⲟⲩ	ⲛⲁ|ⲉⲓⲁⲧ|ⲟⲩ
ϩⲛⲧⲉϥⲧⲉⲭⲛⲉ	ϩⲛ|ⲧⲉϥ|ⲧⲉⲭⲛⲉ
ⲉⲧⲥⲱϣⲉ	ⲉ|ⲧ|ⲥⲱϣⲉ
ϩⲛϣⲁϫⲉ	ϩⲛ|ϣⲁϫⲉ
ϫⲉⲡⲛⲟϭ	ϫⲉ|ⲡ|ⲛⲟϭ
ⲙⲛⲧⲃⲧ	ⲙⲛ|ⲧⲃⲧ
ⲉⲁϥⲛⲁ	ⲉ|ⲁ|ϥ|ⲛⲁ
ⲉⲧⲃⲉⲧⲉϥⲭⲣⲓⲁ	ⲉⲧⲃⲉ|ⲧⲉϥ|ⲭⲣⲓⲁ
ⲙⲡⲟⲩⲉ	ⲙ|ⲡ|ⲟⲩⲉ
ϣϥⲉ	ϣϥⲉ
ⲛⲏⲣⲡ	ⲛ|ⲏⲣⲡ
ⲁϥϫⲟⲟⲩϥ	ⲁ|ϥ|ϫⲟⲟⲩ|ϥ
ⲛⲁⲗⲫⲁⲓⲟⲥ	ⲛ|ⲁⲗⲫⲁⲓⲟⲥ
ⲛⲉⲓⲛⲁϭⲱ	ⲛⲉ|ⲓ|ⲛⲁ|ϭⲱ
ⲛϩⲗⲗⲟⲓ	ⲛ|ϩⲗⲗⲟⲓ
ⲙⲡⲉⲥⲧⲉⲣⲉⲱⲙⲁ	ⲙ|ⲡⲉ|ⲥⲧⲉⲣⲉⲱⲙⲁ
ⲉⲙⲛⲧⲁⲩ	ⲉ|ⲙⲛⲧⲁ|ⲩ
ⲛⲉⲧⲁϩⲉⲣⲁⲧⲟⲩ	ⲛ|ⲉⲧ|ⲁϩⲉ|ⲣⲁⲧ|ⲟⲩ
ϫⲉⲛⲉⲛⲉⲓⲟⲧⲉ	ϫⲉ|ⲛⲉ|ⲛ|ⲉⲓⲟⲧⲉ
ⲁⲩⲙⲉⲣⲉ	ⲁ|ⲩ|ⲙⲉⲣⲉ
ϩⲛⲓⲁⲕⲱⲃ	ϩⲛ|ⲓⲁⲕⲱⲃ
ⲉⲁⲩϫⲉⲣⲱⲟⲩ	ⲉ|ⲁ|ⲩ|ϫⲉⲣⲱ|ⲟⲩ
ϣⲁⲡⲉⲣⲟ	ϣⲁ|ⲡ|ⲉⲣⲟ
ϩⲛⲛⲣⲱⲙⲉ	ϩⲛ|ⲛ|ⲣⲱⲙⲉ
ⲉⲛϣⲁⲛⲉⲓⲣⲉ	ⲉⲛϣⲁⲛ|ⲉⲓⲣⲉ
ⲛⲧⲉⲣⲉϥϩⲕⲟ	ⲛⲧ|ⲉⲣⲉ|ϥ|ϩⲕⲟ
ϫⲉⲟⲩⲛⲟⲩⲁ	ϫⲉ|ⲟⲩⲛ|ⲟⲩⲁ
ⲙⲡⲱⲛϩ	ⲙ|ⲡ|ⲱⲛϩ
ⲙⲟⲟⲩ	ⲙⲟⲟⲩ
ⲛⲉⲧⲛⲁⲟⲩⲁϩⲟⲩ	ⲛ|ⲉⲧ|ⲛⲁ|ⲟⲩⲁϩ|ⲟⲩ
ⲛϥⲛⲁⲕⲗⲏⲣⲟⲛⲟⲙⲉⲓ	ⲛ|ϥ|ⲛⲁ|ⲕⲗⲏⲣⲟⲛⲟⲙⲉⲓ
ⲁⲩⲛⲟϫⲟⲩ	ⲁ|ⲩ|ⲛⲟϫ|ⲟⲩ
ⲡⲥⲟⲫⲟⲥ	ⲡ|ⲥⲟⲫⲟⲥ
ⲛⲁⲣⲱϩⲧ	ⲛⲁ|ⲣⲱϩⲧ
ⲥⲟⲡ	ⲥⲟⲡ
ⲙⲛⲡⲉⲥⲙⲟⲧ	ⲙⲛ|ⲡⲉ|ⲥⲙⲟⲧ
ϫⲉⲕⲱ	ϫⲉ|ⲕⲱ
ϩⲁⲛⲉⲛⲉⲣⲏⲩ	ϩⲁ|ⲛⲉⲛ|ⲉⲣⲏⲩ
ⲛϩⲉⲛϣⲏⲓ	ⲛ|ϩⲉⲛ|ϣⲏⲓ
ⲉⲣⲉⲧⲉⲅⲣⲁⲫⲏ	ⲉⲣⲉ|ⲧⲉ|ⲅⲣⲁⲫⲏ
ϩⲛⲧⲉⲓⲉⲡⲓⲥⲧⲟⲗⲏ	ϩⲛ|ⲧⲉⲓ|ⲉⲡⲓⲥⲧⲟⲗⲏ
ⲛⲛⲉⲛⲧⲁⲙⲱⲩⲥⲏⲥ	ⲛ|ⲛ|ⲉⲛⲧ|ⲁ|ⲙⲱⲩⲥⲏⲥ
ⲛⲧⲁⲩⲡⲁⲣⲁⲇⲓⲇⲟⲩ	ⲛⲧ|ⲁ|ⲩ|ⲡⲁⲣⲁⲇⲓⲇⲟⲩ
ⲉϥⲉⲓⲣⲉ	ⲉ|ϥ|ⲉⲓⲣⲉ
ⲟⲩⲛⲟⲩϩⲉⲑⲛⲟⲥ	ⲟⲩⲛ|ⲟⲩ|ϩⲉⲑⲛⲟⲥ
ⲉⲧⲉⲙⲡⲉⲟⲩⲟⲛ	ⲉⲧⲉ|ⲙⲡⲉ|ⲟⲩⲟⲛ
ⲛⲧⲉϥⲭⲁⲣⲓⲥ	ⲛ|ⲧⲉ|ϥ|ⲭⲁⲣⲓⲥ
ⲛⲥⲁϩⲟⲉⲓⲛⲉ	ⲛⲥⲁ|ϩⲟⲉⲓⲛⲉ
ⲥⲓⲙⲱⲛ	ⲥⲓⲙⲱⲛ
ⲛⲧⲁⲩⲙⲓϣⲉ	ⲛⲧ|ⲁ|ⲩ|ⲙⲓϣⲉ
ⲛⲃⲟⲩⲗⲉⲩⲧⲏⲥ	ⲛ|ⲃⲟⲩⲗⲉⲩⲧⲏⲥ
ⲙⲛⲧⲓⲟⲩⲇⲁⲓⲁ	ⲙⲛ|ⲧ|ⲓⲟⲩⲇⲁⲓⲁ
ⲉⲕⲉⲉⲓ	ⲉⲕⲉ|ⲉⲓ
ⲛⲉⲥϩⲙⲙⲛⲧⲥⲛⲟⲟⲩⲥ	ⲛⲉ|ⲥ|ϩⲙ|ⲙⲛⲧⲥⲛⲟⲟⲩⲥ
ⲛⲧⲉⲧⲛ	ⲛ
ⲁⲩⲧⲁⲙⲓⲟⲛ	ⲁ|ⲩ|ⲧⲁⲙⲓⲟ|ⲛ
ⲙⲁⲣⲛⲣϩⲙϩⲁⲗ	ⲙⲁⲣ|ⲛ|ⲣ|ϩⲙϩⲁⲗ
ⲛϩⲉⲛⲇⲓⲁⲕⲟⲛⲓⲁ	ⲛ|ϩⲉⲛ|ⲇⲓⲁⲕⲟⲛⲓⲁ
ϩⲓⲧⲙⲡⲛⲉⲩⲙⲁ	ϩⲓⲧⲙ|ⲡⲛⲉⲩⲙⲁ
ⲁⲣⲓⲕⲉ	ⲁⲣⲓⲕⲉ
ⲙⲛϩⲣⲉⲃⲉⲕⲕⲁ	ⲙⲛ|ϩⲣⲉⲃⲉⲕⲕⲁ
ⲡϣⲓⲡⲉ	ⲡ|ϣⲓⲡⲉ
ⲛⲉⲩⲏⲓ	ⲛⲉⲩ|ⲏⲓ
ϯⲙⲟⲕϩ	ϯ|ⲙⲟⲕϩ
ⲙⲛϩⲉⲛϣⲉⲉⲣⲉ	ⲙⲛ|ϩⲉⲛ|ϣⲉⲉⲣⲉ
ⲉⲩⲉⲁⲓⲧⲉⲓ	ⲉ|ⲩ|ⲉ|ⲁⲓⲧⲉⲓ
ⲉⲩⲙⲟⲕⲙⲉⲕ	ⲉ|ⲩ|ⲙⲟⲕⲙⲉⲕ
ⲛⲓⲟⲩⲇⲁⲓ	ⲛ|ⲓⲟⲩⲇⲁⲓ
ϩⲟⲧⲉ	ϩⲟⲧⲉ
ⲟⲩⲡⲉⲧⲉϣϣⲉ	ⲟⲩ|ⲡ|ⲉⲧ|ⲉϣ|ϣⲉ
ϩⲛⲛⲉⲙϩⲁⲟⲩ	ϩⲛ|ⲛⲉ|ⲙϩⲁⲟⲩ
ⲙⲡⲁⲧϣⲉⲗⲉⲉⲧ	ⲙ|ⲡ|ⲁⲧϣⲉⲗⲉⲉⲧ
ⲉⲡⲕⲁϩ	ⲉ|ⲡ|ⲕⲁϩ
ⲛⲛⲉϭⲙⲏⲟⲩ	ⲛ|ⲛⲉ|ϭⲙⲏⲟⲩ
ⲛⲉⲛⲧⲁⲩⲕⲗⲏⲣⲟⲛⲟⲙⲉⲓ	ⲛⲉ|ⲛⲧ|ⲁ|ⲩ|ⲕⲗⲏⲣⲟⲛⲟⲙⲉⲓ
ⲉⲩⲉⲉⲓ	ⲉ|ⲩ|ⲉ|ⲉⲓ
ⲧⲁⲧⲥⲃⲱ	ⲧ|ⲁⲧⲥⲃⲱ
ⲉⲧⲃⲉⲡⲉϩⲟⲟⲩ	ⲉⲧⲃⲉ|ⲡⲉ|ϩⲟⲟⲩ
ⲛϥⲥⲣⲙⲣⲱⲙⲉ	ⲛ|ϥ|ⲥⲣⲙⲣⲱⲙ|ⲉ
ⲡⲟⲩⲟⲉⲓⲛ	ⲡ|ⲟⲩⲟⲉⲓⲛ
ⲛⲛϣⲏⲣⲉ	ⲛ|ⲛ|ϣⲏⲣⲉ
ϫⲉⲧⲁϣⲉⲉⲣⲉ	ϫⲉ|ⲧⲁ|ϣⲉⲉⲣⲉ
ⲉⲛⲉⲧⲙⲉ	ⲉ|ⲛⲉ|ⲧⲙⲉ
ⲙⲛⲟⲩⲥⲱⲱϥ	ⲙⲛ|ⲟⲩ|ⲥⲱⲱϥ
ⲙⲡⲁⲡⲉⲧⲧⲥⲟ	ⲙⲡⲁ|ⲡ|ⲉⲧ|ⲧⲥⲟ
ⲧⲛⲟⲃⲉ	ⲧⲛ|ⲟⲃⲉ
ⲛⲉⲧⲉⲛⲥⲉⲥⲟⲟⲩⲛ	ⲛ|ⲉⲧⲉ|ⲛ|ⲥⲉ|ⲥⲟⲟⲩⲛ
ⲉⲓⲉⲁϫⲓⲥ	ⲉⲓⲉ|ⲁϫⲓ|ⲥ
ⲛⲛϫⲟⲉⲓⲧ	ⲛ|ⲛ|ϫⲟⲉⲓⲧ
ⲓⲏⲥⲟⲩⲥ	ⲓⲏⲥⲟⲩⲥ
ⲃⲃⲗⲗⲁϥ	ⲃⲃⲗⲗⲁϥ
ⲉⲩⲥϩⲓⲙⲉ	ⲉ|ⲩ|ⲥϩⲓⲙⲉ
ⲁⲡⲁⲗⲉⲕⲧⲱⲣ	ⲁ|ⲡ|ⲁⲗⲉⲕⲧⲱⲣ
ⲉⲧⲉϭⲓⲛϭⲗⲱⲡⲉ	ⲉⲧⲉ|ϭⲓⲛ|ϭⲗⲱⲡⲉ
ⲙⲛⲧⲙⲛⲧϩⲁⲣϣϩⲏⲧ	ⲙⲛ|ⲧ|ⲙⲛⲧϩⲁⲣϣϩⲏⲧ
ⲛⲥⲩⲛⲁⲅⲱⲅⲏ	ⲛ|ⲥⲩⲛⲁⲅⲱⲅⲏ
ϫⲉⲁⲓⲃⲱⲕ	ϫⲉ|ⲁ|ⲓ|ⲃⲱⲕ
ⲉⲥⲣϥⲉ	ⲉ|ⲥⲣϥⲉ
ϩⲛⲛⲉⲧⲉⲛⲟⲩϥ	ϩⲛ|ⲛ|ⲉⲧⲉ|ⲛⲟⲩϥ
ϩⲛⲟⲩϭⲟⲙ	ϩⲛ|ⲟⲩ|ϭⲟⲙ
ϩⲛⲧⲉⲩⲛⲟⲩ	ϩⲛ|ⲧⲉ|ⲩⲛⲟⲩ
ⲁϥϣⲛ	ⲁ|ϥ|ϣ|ⲛ
ϣⲁϥⲃⲟⲗⲟⲩ	ϣⲁ|ϥ|ⲃⲟⲗ|ⲟⲩ
ⲉⲧⲣⲉⲩⲡⲱⲧ	ⲉ|ⲧⲣⲉ|ⲩ|ⲡⲱⲧ
ⲛϥⲕⲗⲏⲣⲟⲛⲟⲙⲉⲓ	ⲛ|ϥ|ⲕⲗⲏⲣⲟⲛⲟⲙⲉⲓ
ⲁⲧⲉⲧⲛⲥⲟⲧⲡⲧ	ⲁ|ⲧⲉⲧⲛ|ⲥⲟⲧⲡ|ⲧ
ⲙⲁⲧⲁⲙⲟⲓ	ⲙⲁ|ⲧⲁⲙⲟ|ⲓ
ⲙⲛⲡⲉⲧⲛⲏⲩ	ⲙⲛ|ⲡ|ⲉⲧ|ⲛⲏⲩ
ϫⲓⲧⲉ	ϫⲓⲧ|ⲉ
ⲉⲧⲛⲙⲙⲁϥ	ⲉⲧ|ⲛⲙⲙⲁ|ϥ
ⲃⲃⲣⲣⲉ	ⲃ|ⲃⲣⲣⲉ
ⲛⲧⲁϥⲧⲁⲙⲓⲟⲟⲩ	ⲛⲧ|ⲁ|ϥ|ⲧⲁⲙⲓⲟ|ⲟⲩ
ⲉⲣⲛⲧⲟⲟⲧⲉ	ⲉⲣⲛ|ⲧ|ⲟⲟⲧⲉ
ⲛϩⲟⲧⲉ	ⲛ|ϩⲟⲧⲉ
ⲛⲡⲟⲛⲏⲣⲟⲛ	ⲛ|ⲡⲟⲛⲏⲣⲟⲛ
ⲙⲡⲉⲡⲣⲟⲫⲏⲧⲏⲥ	ⲙ|ⲡⲉ|ⲡⲣⲟⲫⲏⲧⲏⲥ
ⲛϥⲛⲁϫⲓϫⲣⲟⲡ	ⲛ|ϥ|ⲛⲁ|ϫⲓ|ϫⲣⲟⲡ
ⲉϥⲛⲁϯⲥⲟ	ⲉ|ϥ|ⲛⲁ|ϯ|ⲥⲟ
ϣⲱⲱⲧ	ϣⲱⲱⲧ
ⲛⲥⲉⲕⲟⲧⲟⲩ	ⲛ|ⲥⲉ|ⲕⲟⲧ|ⲟⲩ
ⲡⲁⲣⲁⲧⲉⲧⲕⲏ	ⲡⲁⲣⲁ|ⲧ|ⲉⲧ|ⲕⲏ
ϩⲛⲟⲩⲡⲛⲉⲩⲙⲁ	ϩⲛ|ⲟⲩ|ⲡⲛⲉⲩⲙⲁ
ⲛϭⲓⲡⲁⲣⲭⲓⲉⲣⲉⲩⲥ	ⲛϭⲓ|ⲡ|ⲁⲣⲭⲓⲉⲣⲉⲩⲥ
ⲙⲡⲙⲟⲩⲥ	ⲙ|ⲡ|ⲙⲟⲩⲥ
ⲧⲟⲩ	ⲧⲟⲩ
ⲟⲩⲁ	ⲟⲩⲁ
ⲉϥϣⲁⲛⲛⲟⲩϫⲉ	ⲉ|ϥ|ϣⲁⲛ|ⲛⲟⲩϫⲉ
ⲛⲙⲥⲓⲙⲱⲛ	ⲛⲙ|ⲥⲓⲙⲱⲛ
ϩⲛⲧⲅⲁⲗⲓⲗⲁⲓⲁ	ϩⲛ|ⲧ|ⲅⲁⲗⲓⲗⲁⲓⲁ
ⲉⲕⲛⲁⲧⲱⲟⲩⲛ	ⲉ|ⲕ|ⲛⲁ|ⲧⲱⲟⲩⲛ
ⲙⲁⲩⲁⲁⲛ	ⲙⲁⲩⲁⲁ|ⲛ
ϫⲛ	ϫⲛ
ⲛⲉⲧⲕⲁⲙⲁ	ⲛ|ⲉⲧ|ⲕⲁ|ⲙⲁ
ⲣⲱⲙⲉ	ⲣⲱⲙⲉ
ϫⲉⲛⲧⲁⲓ	ϫⲉ|ⲛ|ⲧⲁⲓ
ⲙⲙⲛⲡⲉⲧϩⲏⲡ	ⲙⲙⲛ|ⲡ|ⲉⲧ|ϩⲏⲡ
ⲛϩⲉⲛⲕⲣⲟϥ	ⲛ|ϩⲉⲛ|ⲕⲣⲟϥ
ⲛϩⲉⲛϩⲟⲙⲛⲧ	ⲛ|ϩⲉⲛ|ϩⲟⲙⲛⲧ
ⲛⲟⲩⲟⲩⲱϣⲙ	ⲛ|ⲟⲩ|ⲟⲩⲱϣⲙ
ⲛⲥⲁϩⲉⲛⲛⲟⲃⲉ	ⲛⲥⲁ|ϩⲉⲛ|ⲛⲟⲃⲉ
ϩⲛⲟⲩⲥⲟⲟⲩⲧⲛ	ϩⲛ|ⲟⲩ|ⲥⲟⲟⲩⲧⲛ
ⲙⲛϩⲉⲛⲙⲁⲥⲉ	ⲙⲛ|ϩⲉⲛ|ⲙⲁⲥⲉ
ⲡⲉⲧⲟⲩⲛⲁⲁⲓⲧⲉⲓ	ⲡ|ⲉⲧ|ⲟⲩ|ⲛⲁ|ⲁⲓⲧⲉⲓ
ⲛⲛⲉⲛⲧⲁⲡϫⲟⲉⲓⲥ	ⲛⲛⲉ|ⲛⲧ|ⲁ|ⲡ|ϫⲟⲉⲓⲥ
ⲡⲗⲏⲛ	ⲡⲗⲏⲛ
ϩⲛⲛϭⲓϫ	ϩⲛ|ⲛ|ϭⲓϫ
ϣⲟⲡⲟⲩ	ϣⲟⲡ|ⲟⲩ
ⲛⲧⲉⲣⲟⲩⲃⲱⲕ	ⲛⲧⲉⲣ|ⲟⲩ|ⲃⲱⲕ
ⲛⲧⲁⲥⲉⲓ	ⲛⲧ|ⲁ|ⲥ|ⲉⲓ
ϩⲛⲟⲩⲛⲟⲩϭⲥ	ϩⲛ|ⲟⲩ|ⲛⲟⲩϭⲥ
ⲕⲗⲏⲣⲟⲛⲟⲙⲉⲓ	ⲕⲗⲏⲣⲟⲛⲟⲙⲉⲓ
ⲡⲥⲟⲛ	ⲡ|ⲥⲟⲛ
ⲙⲛⲧⲉⲩⲁϭⲟⲗⲧⲉ	ⲙⲛ|ⲧⲉⲩ|ⲁϭⲟⲗⲧⲉ
ϭⲉⲗⲁⲁⲩ	ϭⲉ|ⲗⲁⲁⲩ
ⲁϥⲧⲉⲕⲙⲧⲉϥⲥⲏϥⲉ	ⲁ|ϥ|ⲧⲉⲕⲙ|ⲧⲉϥ|ⲥⲏϥⲉ
ⲓ	ⲓ
ϫⲉⲙⲏ	ϫⲉ|ⲙⲏ
ⲉⲧⲁⲩⲗⲏ	ⲉ|ⲧ|ⲁⲩⲗⲏ
ⲙⲛⲡⲣⲟ	ⲙⲛ|ⲡ|ⲣⲟ
ⲛϥⲥⲃⲧⲉ	ⲛ|ϥ|ⲥⲃⲧⲉ
ⲙⲡⲥⲙⲟⲩ	ⲙⲡ|ⲥ|ⲙⲟⲩ
ⲉⲧⲧⲉⲧⲛⲛⲁϫⲟⲟϥ	ⲉⲧ|ⲧⲉⲧⲛ|ⲛⲁ|ϫⲟⲟ|ϥ
ⲉⲁⲧⲉⲧⲛϣⲓⲃⲉ	ⲉ|ⲁ|ⲧⲉⲧⲛ|ϣⲓⲃⲉ
ⲉⲧⲕⲟ	ⲉⲧ|ⲕ|ⲟ
ⲙⲛⲛⲉⲣⲣⲱⲟⲩ	ⲙⲛ|ⲛⲉ|ⲣⲣⲱⲟⲩ
ⲉⲧⲃⲉⲛⲁⲛⲁⲩϣ	ⲉⲧⲃⲉ|ⲛ|ⲁⲛⲁⲩϣ
ⲙⲛϩⲉⲛⲉϩⲟⲟⲩ	ⲙⲛ|ϩⲉⲛ|ⲉϩⲟⲟⲩ
ϫⲉⲡⲁϣⲏⲣⲉ	ϫⲉ|ⲡⲁ|ϣⲏⲣⲉ
ⲉⲛⲉⲧⲣϩⲟⲧⲉ	ⲉ|ⲛ|ⲉⲧ|ⲣϩⲟⲧⲉ
ⲉⲩⲥϩⲟⲩⲟⲣⲧ	ⲉ|ⲩ|ⲥϩⲟⲩⲟⲣⲧ
ⲧⲉⲧⲛⲣⲱϣⲉ	ⲧⲉⲧⲛ|ⲣⲱϣⲉ
ϫⲉⲉⲛⲛⲉⲛϣⲱⲡⲉ	ϫⲉ|ⲉ|ⲛⲛⲉ|ⲛ|ϣⲱⲡⲉ
ⲣⲛⲟⲃⲣⲉ	ⲣⲛⲟⲃⲣⲉ
ⲁϥϫⲓ	ⲁ|ϥ|ϫⲓ
ⲛⲙⲙⲟⲕⲙⲉⲕ	ⲛ|ⲙ|ⲙⲟⲕⲙⲉⲕ
ⲙⲧⲟ	ⲙⲧⲟ
ⲙⲡⲉⲗϭⲉ	ⲙ|ⲡⲉⲗϭⲉ
ⲉⲡⲉⲧⲛⲛⲟⲩⲧⲉ	ⲉ|ⲡⲉⲧⲛ|ⲛⲟⲩⲧⲉ
ⲁⲩⲟⲩⲱⲙ	ⲁ|ⲩ|ⲟⲩⲱⲙ
ⲛⲛⲣⲉϥϯ	ⲛ|ⲛ|ⲣⲉϥϯ
ⲛϭⲓⲛⲉϩⲟⲟⲩ	ⲛϭⲓ|ⲛⲉ|ϩⲟⲟⲩ
ⲛⲛⲥⲉⲗⲓⲥ	ⲛ|ⲛ|ⲥⲉⲗⲓⲥ
ϥⲛⲁϣⲱⲡ	ϥ|ⲛⲁ|ϣⲱⲡ
ⲡⲉⲙⲕⲁϩ	ⲡⲉ|ⲙⲕⲁϩ
ⲛⲥⲉⲙⲧⲟⲛ	ⲛ|ⲥⲉ|ⲙⲧⲟⲛ
ⲙⲡⲉⲧⲟ	ⲙ|ⲡ|ⲉⲧ|ⲟ
[…..]ⲉⲁ	[…..]ⲉⲁ
ⲟⲩⲣⲟⲟⲩⲉ	ⲟⲩ|ⲣⲟⲟⲩⲉ
ⲛⲧⲉⲣⲉⲛⲁⲩ	ⲛⲧⲉⲣⲉ|ⲛⲁⲩ
ⲉϥϣⲁϫⲉ	ⲉ|ϥ|ϣⲁϫⲉ
ⲁⲕϫⲟⲟⲥ	ⲁ|ⲕ|ϫⲟⲟ|ⲥ
ⲥⲉⲛⲁⲕⲁⲁⲩ	ⲥⲉ|ⲛⲁ|ⲕⲁⲁ|ⲩ
ϩⲛⲁϣ	ϩⲛ|ⲁϣ
ⲙⲁⲣⲛⲣⲧⲙⲉ	ⲙⲁⲣⲛ|ⲣ|ⲧ|ⲙⲉ
ϫⲉⲙⲁⲣⲛⲃⲱⲕ	ϫⲉ|ⲙⲁⲣ|ⲛ|ⲃⲱⲕ
ⲉⲩϣⲁⲛⲥⲱ	ⲉ|ⲩ|ϣⲁⲛ|ⲥⲱ
ⲛⲧⲁⲉⲓ	ⲛⲧ|ⲁ|ⲉⲓ
ⲉϣⲁⲩⲛⲉϫⲏⲣⲡ	ⲉ|ϣⲁ|ⲩ|ⲛⲉϫ|ⲏⲣⲡ
ⲥⲉⲛⲁⲗⲟ	ⲥⲉ|ⲛⲁ|ⲗⲟ
ϩⲛⲛⲉⲩⲧⲟⲡⲟⲥ	ϩⲛ|ⲛⲉⲩ|ⲧⲟⲡⲟⲥ
ⲛⲧⲉⲕⲣⲓⲥⲓⲥ	ⲛⲧⲉ|ⲕⲣⲓⲥⲓⲥ
ⲡⲡⲁⲛⲧⲟⲕⲣⲁⲧⲱⲣ	ⲡ|ⲡⲁⲛⲧⲟⲕⲣⲁⲧⲱⲣ
ⲉϭⲟⲡⲧ	ⲉ|ϭⲟⲡⲧ
ⲁⲥⲟⲣⲭⲉ	ⲁ|ⲥ|ⲟⲣⲭⲉ
ϫⲱ	ϫⲱ
ϩⲙⲡⲉϥⲗⲁⲥ	ϩⲙ|ⲡⲉϥ|ⲗⲁⲥ
ⲛⲧⲉⲛⲉⲥϭⲱⲃⲉ	ⲛⲧⲉ|ⲛⲉⲥ|ϭⲱⲃⲉ
ϫⲉⲛⲛⲉⲕⲃⲁⲥⲁⲛⲓⲍⲉ	ϫⲉ|ⲛⲛⲉ|ⲕ|ⲃⲁⲥⲁⲛⲓⲍⲉ
ⲛⲟⲩⲇⲓⲁⲑⲏⲕⲏ	ⲛ|ⲟⲩ|ⲇⲓⲁⲑⲏⲕⲏ
ⲛⲟϫⲟⲩ	ⲛⲟϫ|ⲟⲩ
ⲉⲧⲛϩⲏⲧϥ	ⲉⲧ|ⲛϩⲏⲧ|ϥ
ⲉⲧⲁⲙⲟⲛ	ⲉ|ⲧⲁⲙⲟ|ⲛ
ⲡ	ⲡ
ⲁⲩⲥⲱⲟⲩϩ	ⲁ|ⲩ|ⲥⲱⲟⲩϩ
ⲛⲟⲩⲙⲟⲓϩⲉ	ⲛ|ⲟⲩ|ⲙⲟⲓϩⲉ
ⲙⲛⲛⲉϥⲥⲱⲛⲉ	ⲙⲛ|ⲛⲉϥ|ⲥⲱⲛⲉ
ϩⲛⲟⲩⲙⲟⲟⲩ	ϩⲛ|ⲟⲩ|ⲙⲟⲟⲩ
ⲓⲥⲁⲁⲕ[...]ϥ̣	ⲓⲥⲁⲁⲕ|[...]ϥ̣
ⲛⲧⲙⲛⲧⲙⲛⲧⲣⲉ	ⲛ|ⲧ|ⲙⲛⲧ|ⲙⲛⲧⲣⲉ
ⲥⲣϥⲉ	ⲥⲣϥⲉ
ⲁⲩϫⲟⲟⲩϥ	ⲁ|ⲩ|ϫⲟⲟⲩ|ϥ
ⲟⲩⲛϩⲁϩ	ⲟⲩⲛ|ϩⲁϩ
ϫⲉ	ϫⲉ
ⲣⲭⲣⲉⲓⲁ	ⲣⲭⲣⲉⲓⲁ
ϫⲉⲉⲣⲉⲡⲉⲡⲛⲉⲩⲙⲁ	ϫⲉ|ⲉⲣⲉ|ⲡⲉ|ⲡⲛⲉⲩⲙⲁ
ⲛⲧⲉⲧⲛⲥⲱⲱϥ	ⲛ|ⲧⲉⲧⲛ|ⲥⲱⲱϥ
ⲉϣⲁⲁⲧⲕ	ⲉ|ϣⲁⲁⲧ|ⲕ
ⲛⲥⲁⲣⲕⲓⲕⲟⲛ	ⲛ|ⲥⲁⲣⲕⲓⲕⲟⲛ
ϫⲉⲛⲛⲉⲛϣⲱⲡⲉ	ϫⲉ|ⲛ|ⲛⲉ|ⲛ|ϣⲱⲡⲉ
ⲙⲡⲁⲡⲉⲧⲧⲱϭⲉ	ⲙⲡⲁ|ⲡ|ⲉⲧ|ⲧⲱϭⲉ
ⲧⲛϣⲧⲣⲧⲱⲣ	ⲧⲛ|ϣⲧⲣⲧⲱⲣ
ϫⲉⲉⲣⲉⲛⲟⲩⲉⲓⲟⲧⲉ	ϫⲉ|ⲉⲣⲉ|ⲛⲟⲩ|ⲉⲓⲟⲧⲉ
ⲛϭⲓⲡⲥⲁⲧⲁⲛⲁⲥ	ⲛϭⲓ|ⲡ|ⲥⲁⲧⲁⲛⲁⲥ
ⲙⲁⲣ	ⲙⲁⲣ
ϫⲉϯⲉⲥⲑⲁⲛⲉ	ϫⲉ|ϯ|ⲉⲥⲑⲁⲛⲉ
ⲉⲓⲱⲧ	ⲉⲓⲱⲧ
ⲙⲛⲟⲩϣⲥ	ⲙⲛ|ⲟⲩ|ϣⲥ
ⲛⲣⲉϥϣⲟⲟⲣ	ⲛ|ⲣⲉϥϣⲟⲟⲣ
ⲡⲉⲭⲣⲓⲥⲧⲟⲥ	ⲡⲉ|ⲭⲣⲓⲥⲧⲟⲥ
ϯ	ϯ
ⲉⲛⲉϩ	ⲉⲛⲉϩ
ⲉϣⲁⲧⲉⲧⲛϣⲱⲱⲧ	ⲉ|ϣⲁ|ⲧⲉⲧⲛ|ϣⲱⲱⲧ
ϫⲉⲛⲅⲟⲃϣ	ϫⲉ|ⲛ|ⲅ|ⲟⲃϣ
ⲛϭⲓⲛϣⲟⲛⲧⲉ	ⲛϭⲓ|ⲛ|ϣⲟⲛⲧⲉ
ⲡⲏⲣⲡ	ⲡ|ⲏⲣⲡ
ⲉⲛⲉϥⲙⲉⲅⲓⲥⲧⲁⲛⲟⲥ	ⲉ|ⲛⲉϥ|ⲙⲉⲅⲓⲥⲧⲁⲛⲟⲥ
ⲡⲉⲧⲥⲟⲃϩ	ⲡ|ⲉⲧ|ⲥⲟⲃϩ
ϩⲛϭⲉⲗⲁⲁⲩ	ϩⲛ|ϭⲉ|ⲗⲁⲁⲩ
ⲡⲉⲥⲙⲟⲧ	ⲡⲉ|ⲥⲙⲟⲧ
ⲙⲛⲛⲉⲩⲙⲛⲧⲁⲕⲁⲑⲁⲣⲧⲟⲥ	ⲙⲛ|ⲛⲉⲩ|ⲙⲛⲧⲁⲕⲁⲑⲁⲣⲧⲟⲥ
ⲛⲛⲕⲟⲟⲩⲉ	ⲛ|ⲛ|ⲕⲟⲟⲩⲉ
ⲙⲛⲟⲩⲉⲟⲟⲩ	ⲙⲛ|ⲟⲩ|ⲉⲟⲟⲩ
ⲉⲩⲃⲱⲗ	ⲉ|ⲩ|ⲃⲱⲗ
ⲁⲓⲕⲱ	ⲁ|ⲓ|ⲕⲱ
ⲉⲧⲥⲩⲛⲧⲉⲗⲓⲁ	ⲉ|ⲧ|ⲥⲩⲛⲧⲉⲗⲓⲁ
ϥⲟⲩⲉϩⲥⲁϩⲛⲉ	ϥ|ⲟⲩⲉϩⲥⲁϩⲛⲉ
ⲉϫⲱⲧⲛ	ⲉϫⲱ|ⲧⲛ
ⲡⲉⲧⲉⲣⲉⲡⲇⲓⲁⲃⲟⲗⲟⲥ	ⲡ|ⲉⲧ|ⲉⲣⲉ|ⲡ|ⲇⲓⲁⲃⲟⲗⲟⲥ
ⲛⲣⲉϥⲧⲱⲣⲡ	ⲛ|ⲣⲉϥⲧⲱⲣⲡ
ⲙⲛⲛⲉⲧⲥⲟϣϥ	ⲙⲛ|ⲛ|ⲉⲧ|ⲥⲟϣϥ
ⲉⲛⲁⲓ	ⲉ|ⲛⲁⲓ
ⲉⲧⲉⲛϣϣⲉ	ⲉⲧⲉ|ⲛ|ϣϣⲉ
ⲉϫⲛⲛⲉⲧⲉⲓⲣⲉ	ⲉϫⲛ|ⲛ|ⲉⲧ|ⲉⲓⲣⲉ
ⲁϥⲥⲟⲩⲱⲛϥ	ⲁ|ϥ|ⲥⲟⲩⲱⲛ|ϥ
ⲛⲟⲩⲉϣ	ⲛ|ⲟⲩⲉϣ
ⲛϥⲣⲛⲟϭ	ⲛ|ϥ|ⲣⲛⲟϭ
ⲉⲣⲉⲡⲉⲩϩⲟⲩⲟ	ⲉⲣⲉ
ⲉⲧⲉⲧⲛⲛⲁⲉⲓⲙⲉ	ⲉ|ⲧⲉⲧⲛ|ⲛⲁ|ⲉⲓⲙⲉ
ⲑⲓⲉⲣⲟⲩⲥⲁⲗⲏⲙ	ⲧ|ϩⲓⲉⲣⲟⲩⲥⲁⲗⲏⲙ
ⲙⲡⲟⲩⲱϣ	ⲙ|ⲡ|ⲟⲩⲱϣ
ⲛⲛⲉⲧⲙⲟⲕϩ	ⲛ|ⲛ|ⲉⲧ|ⲙⲟⲕϩ
ϩⲓⲉⲓⲱⲧ	ϩⲓ|ⲉⲓⲱⲧ
ⲉⲫⲣⲉⲙ	ⲉⲫⲣⲉⲙ
ⲉⲧⲉⲑⲁⲗⲁⲥⲥⲁ	ⲉ|ⲧⲉ|ⲑⲁⲗⲁⲥⲥⲁ
ϩⲙⲡⲉϥⲏⲓ	ϩⲙ|ⲡⲉϥ|ⲏⲓ
ⲉⲧⲉⲧⲛⲛⲁⲥⲟⲃⲧⲉ	ⲉ|ⲧⲉⲧⲛ|ⲛⲁ|ⲥⲟⲃⲧⲉ
ⲉⲩϩⲛⲛϭⲓϫ	ⲉ|ⲩ|ϩⲛ|ⲛ|ϭⲓϫ
ϫⲉⲡⲁⲓ	ϫⲉ|ⲡⲁⲓ
ⲉⲛⲉⲓⲙⲛⲧⲣⲉϥⲧⲱϩ	ⲉ|ⲛⲉⲓ|ⲙⲛⲧⲣⲉϥⲧⲱϩ
ⲉⲛⲧⲁϥϣⲱⲡⲉ	ⲉⲛⲧ|ⲁ|ϥ|ϣⲱⲡⲉ
ⲁⲩⲛⲧⲟⲟⲧⲟⲩ	ⲁ|ⲩ|ⲛⲧⲟⲟⲧ|ⲟⲩ
ⲙⲛⲛⲉⲛⲥⲛⲏⲩ	ⲙⲛ|ⲛⲉⲛ|ⲥⲛⲏⲩ
ⲁϥⲣϩⲛⲁϥ	ⲁ|ϥ|ⲣϩⲛⲁ|ϥ
ⲉⲛϣⲱⲛⲃ	ⲉ|ⲛ|ϣⲱⲛⲃ
ⲛⲕⲱϩⲧ	ⲛ|ⲕⲱϩⲧ
ⲁϥⲟⲩⲱⲛϩ	ⲁ|ϥ|ⲟⲩⲱⲛϩ
ⲁⲥⲣⲱϩⲧ	ⲁ|ⲥ|ⲣⲱϩⲧ
ⲡⲕⲱϩⲧ	ⲡ|ⲕⲱϩⲧ
ⲁϥϭⲛⲧⲟⲩ	ⲁ|ϥ|ϭⲛⲧ|ⲟⲩ
ⲛϭⲓϩⲏⲣⲱⲇⲏⲥ	ⲛϭⲓ|ϩⲏⲣⲱⲇⲏⲥ
ⲉⲩⲡⲓⲥⲧⲟⲥ	ⲉ|ⲩ|ⲡⲓⲥⲧⲟⲥ
ⲙⲛϯⲅⲛⲱⲙⲏ	ⲙⲛ|ϯ|ⲅⲛⲱⲙⲏ
ⲛⲉϫϩⲟⲙⲛⲧ	ⲛⲉϫ|ϩⲟⲙⲛⲧ
ⲉⲧⲉϣⲁⲣⲉⲡⲛⲟⲩⲧⲉ	ⲉⲧⲉ|ϣⲁⲣⲉ|ⲡ|ⲛⲟⲩⲧⲉ
ⲡⲉⲕ	ⲡⲉⲕ
ⲁⲕⲥⲟⲣⲙⲉⲥ	ⲁ|ⲕ|ⲥⲟⲣⲙⲉ|ⲥ
⳾	⳾
ⲉϣϫⲉ	ⲉϣϫⲉ
ϫⲉϩⲉⲛ	ϫⲉ|ϩⲉ|ⲛ
ⲉⲧⲉⲣⲉⲟⲩⲏϩ	ⲉⲧⲉⲣⲉ|ⲟⲩⲏϩ
ⲁϥⲕⲁ	ⲁ|ϥ|ⲕⲁ
ⲥⲟⲧⲡ	ⲥⲟⲧⲡ
ⲉⲣⲟϥ	ⲉⲣⲟ|ϥ
ⲛⲧⲁⲙⲟⲟⲩ	ⲛ|ⲧⲁⲙⲟ|ⲟⲩ
ϩⲛϩⲁϩ	ϩⲛ|ϩⲁϩ
ⲉϥⲕⲏⲕⲁϩⲏⲩ	ⲉ|ϥ|ⲕⲏⲕⲁϩⲏⲩ
ϩⲟⲩⲟ	ϩⲟⲩⲟ
ⲉⲁϥⲧⲱⲟⲩⲛ	ⲉ|ⲁ|ϥ|ⲧⲱⲟⲩⲛ
ϩⲛⲧⲙⲛⲧϩⲁⲡⲗⲟⲩⲥ	ϩⲛ|ⲧ|ⲙⲛⲧϩⲁⲡⲗⲟⲩⲥ
ⲛⲧⲉⲣⲉϥϣⲱⲡⲉ	ⲛⲧⲉⲣⲉ|ϥ|ϣⲱⲡⲉ
ⲟⲩⲱⲛϩ	ⲟⲩⲱⲛϩ
ⲙⲫⲟⲛⲟⲥ	ⲙ|ⲫⲟⲛⲟⲥ
ⲛⲉⲩⲕⲱⲧⲉ	ⲛⲉ|ⲩ|ⲕⲱⲧⲉ
ⲟⲉⲓⲕ	ⲟⲉⲓⲕ
ⲛⲧⲅⲁⲗⲓⲗⲁⲓⲁ	ⲛ|ⲧ|ⲅⲁⲗⲓⲗⲁⲓⲁ
ϩⲣⲉⲃⲉⲕⲕⲁ	ϩⲣⲉⲃⲉⲕⲕⲁ
ⲛⲟⲩⲁⲡⲟⲧ	ⲛ|ⲟⲩ|ⲁⲡⲟⲧ
ⲉⲡⲉⲛⲉⲟⲟⲩ	ⲉ|ⲡⲉⲛ|ⲉⲟⲟⲩ
ⲉⲧϩⲛϩⲉⲛϣⲟϣⲟⲩ	ⲉⲧ|ϩⲛ|ϩⲉⲛ|ϣⲟϣⲟⲩ
ⲛⲛⲉⲩⲉⲣⲏⲩ	ⲛ|ⲛⲉⲩ|ⲉⲣⲏⲩ
ϩⲁϩⲉⲛⲕⲟⲩⲓ	ϩⲁ|ϩⲉⲛ|ⲕⲟⲩⲓ
ⲛⲧⲡⲟⲗⲓⲥ	ⲛ|ⲧ|ⲡⲟⲗⲓⲥ
ⲁⲧⲉⲧⲛϩⲉ	ⲁ|ⲧⲉⲧⲛ|ϩⲉ
ⲉⲣⲉⲡⲉϥⲥⲟⲛ	ⲉⲣⲉ|ⲡⲉϥ|ⲥⲟⲛ
ⲛⲧⲉⲣⲉϥⲙⲟⲩⲧⲉ	ⲛⲧⲉⲣⲉ|ϥ|ⲙⲟⲩⲧⲉ
ⲧⲉⲧⲛⲙⲉⲩⲉ	ⲧⲉⲧⲛ|ⲙⲉⲩⲉ
ⲛⲧⲉⲓⲙⲓⲛⲉ	ⲛ|ⲧⲉⲓ|ⲙⲓⲛⲉ
ⲛⲅⲕⲱ	ⲛ|ⲅ|ⲕⲱ
ϩⲉⲛϩⲟⲟⲩ	ϩⲉⲛ|ϩⲟⲟⲩ
ⲛⲥⲉⲡⲣⲟϩⲓⲥⲧⲁ	ⲛ|ⲥⲉ|ⲡⲣⲟϩⲓⲥⲧⲁ
ϫⲉⲉϥⲟⲩⲱϣ	ϫⲉ|ⲉ|ϥ|ⲟⲩⲱϣ
ⲛⲥⲁⲧⲉϥⲛⲟϥⲣⲉ	ⲛⲥⲁ|ⲧⲉϥ|ⲛⲟϥⲣⲉ
ⲛϩⲏⲧⲥ	ⲛϩⲏⲧ|ⲥ
ϩⲛⲕⲟⲩⲓ	ϩⲛ|ⲕⲟⲩⲓ
ⲛⲧⲁⲩⲧⲟϣⲥ	ⲛⲧ|ⲁ|ⲩ|ⲧⲟϣ|ⲥ
ⲛⲧⲟⲟⲧⲟⲩ	ⲛⲧⲟⲟⲧ|ⲟⲩ
ⲡⲉⲩⲟⲩⲟⲉⲓ	ⲡⲉⲩ|ⲟⲩⲟⲉⲓ
ⲛⲇⲓⲕⲁⲓⲟⲥ	ⲛ|ⲇⲓⲕⲁⲓⲟⲥ
ⲛⲥⲟⲩⲟ	ⲛ|ⲥⲟⲩⲟ
ⲧϣⲟⲣⲡ	ⲧ|ϣⲟⲣⲡ
ⲛⲛⲉⲕⲙⲏⲙⲟⲟⲩ	ⲛ|ⲛⲉⲕ|ⲙⲏ|ⲙⲟⲟⲩ
ⲉⲛⲉⲩⲉⲣⲏⲩ	ⲉ|ⲛⲉⲩ|ⲉⲣⲏⲩ
ⲡⲉⲛϣⲓ	ⲡⲉⲛ|ϣⲓ
ⲛⲣⲱⲙⲉ	ⲛ|ⲣⲱⲙⲉ
ⲛⲉⲧⲛⲏⲩ	ⲛ|ⲉⲧ|ⲛⲏⲩ
ⲡⲁⲙⲉⲣⲓⲧ	ⲡⲁ|ⲙⲉⲣⲓⲧ
ⲛϭⲓϩⲉⲛⲙⲏⲏϣⲉ	ⲛϭⲓ|ϩⲉⲛ|ⲙⲏⲏϣⲉ
ⲛϯⲥⲃⲱ	ⲛ|ϯⲥⲃⲱ
ⲉⲛⲁⲁⲥ	ⲉ|ⲛⲁⲁ|ⲥ
ⲙⲙⲛⲧⲣⲙⲣⲁϣ	ⲙ|ⲙⲛⲧⲣⲙⲣⲁϣ
ⲛϣⲟⲙⲛⲧⲥⲱⲱⲡ	ⲛ|ϣⲟⲙⲛⲧ|ⲥⲱⲱⲡ
ϩⲉⲛⲕⲟⲟⲩⲉ	ϩⲉⲛ|ⲕⲟⲟⲩⲉ
ⲉⲩⲉϣⲛⲁⲥⲡⲁⲥⲙⲟⲥ	ⲉ|ⲩ|ⲉ|ϣⲛ|ⲁⲥⲡⲁⲥⲙⲟⲥ
ⲧⲉⲩⲛⲟⲩ	ⲧⲉ|ⲩⲛⲟⲩ
ⲉⲧⲉⲧⲛⲧⲁⲡⲣⲟ	ⲉ|ⲧⲉⲧⲛ|ⲧⲁⲡⲣⲟ
ϫⲉϯⲟ	ϫⲉ|ϯ|ⲟ
ⲛⲟⲩⲙⲟⲣⲫⲏ	ⲛ|ⲟⲩ|ⲙⲟⲣⲫⲏ
ⲙⲡⲉϥϩⲱⲃ	ⲙ|ⲡⲉϥ|ϩⲱⲃ
ⲉⲧⲉⲙⲛⲙⲛⲧⲗⲏⲥⲧⲏⲥ	ⲉⲧⲉ|ⲙⲛ|ⲙⲛⲧⲗⲏⲥⲧⲏⲥ
ⲛϩⲣⲟⲟⲩ	ⲛ|ϩⲣⲟⲟⲩ
ϫⲉⲡⲉⲧⲉⲣⲁⲁⲓⲧⲉⲓ	ϫⲉ|ⲡⲉⲧ|ⲉⲣⲁ|ⲁⲓⲧⲉⲓ
ⲉϥⲙⲉϩ	ⲉ|ϥ|ⲙⲉϩ
ϩⲁϩⲧⲏϥ	ϩⲁϩⲧⲏ|ϥ
ⲛⲥⲛⲁϣⲁϩⲉ	ⲛ|ⲥ|ⲛⲁ|ϣⲁϩⲉ
ϫⲉⲁϥϩⲙⲟⲟⲥ	ϫⲉ|ⲁ|ϥ|ϩⲙⲟⲟⲥ
[.....]	[.....]
ⲛⲥⲁⲟⲩⲛⲁⲙ	ⲛⲥⲁ|ⲟⲩⲛⲁⲙ
ϩⲛⲛⲉⲓⲭⲁⲣⲧⲏⲥ	ϩⲛ|ⲛⲉⲓ|ⲭⲁⲣⲧⲏⲥ
ϫⲉⲁⲡⲉϥϩⲏⲧ	ϫⲉ|ⲁ|ⲡⲉϥ|ϩⲏⲧ
ϩⲙϩⲁⲗ	ϩⲙϩⲁⲗ
ⲛⲱⲛϩ	ⲛ|ⲱⲛϩ
ⲁⲩⲣϣⲟⲣⲡ	ⲁ|ⲩ|ⲣϣⲟⲣⲡ
ⲁⲩⲙⲟⲩ	ⲁ|ⲩ|ⲙⲟⲩ
ⲛⲥⲁⲣⲝ	ⲛ|ⲥⲁⲣⲝ
ⲙⲛϭⲉ	ⲙⲛ|ϭⲉ
ⲉⲧⲛⲉⲓⲣⲉ	ⲉ|ⲧⲛ|ⲉⲓⲣⲉ
ⲛⲧⲁⲓⲏⲥⲟⲩⲥ	ⲛⲧⲁ|ⲓⲏⲥⲟⲩⲥ
ⲉⲣϣⲁⲛϫⲟⲟⲥ	ⲉⲣϣⲁⲛ|ϫⲟⲟ|ⲥ
ϣⲁⲣⲉⲡⲉϭⲣⲟϭ	ϣⲁⲣⲉ|ⲡⲉ|ϭⲣⲟϭ
ⲛⲧⲁⲩⲑⲙⲕⲟⲟⲩ	ⲛⲧ|ⲁ|ⲩ|ⲑⲙⲕⲟ|ⲟⲩ
ⲛϭⲓⲛⲉⲅⲣⲁⲙⲙⲁⲧⲉⲩⲥ	ⲛϭⲓ|ⲛⲉ|ⲅⲣⲁⲙⲙⲁⲧⲉⲩⲥ
ϫⲉⲁⲓϥⲓ	ϫⲉ|ⲁ|ⲓ|ϥⲓ
ϩⲓⲛⲁⲓ	ϩⲓ|ⲛⲁⲓ
ⲛⲃⲗⲁⲕ	ⲛⲃⲗⲁ|ⲕ
ⲧⲛⲧⲛⲧⲏⲩⲧⲛ	ⲧⲛⲧⲛ|ⲧⲏⲩⲧⲛ
ⲥⲱϣⲉ	ⲥⲱϣⲉ
ⲁϥϫⲱ	ⲁ|ϥ|ϫⲱ
ⲁⲕⲕⲁⲁⲧ	ⲁ|ⲕ|ⲕⲁⲁⲧ
ⲛⲕⲉⲉⲡⲓⲑⲩⲙⲓⲁ	ⲛ|ⲕⲉ|ⲉⲡⲓⲑⲩⲙⲓⲁ
ⲛⲧⲉⲧⲙ	ⲛⲧⲉ|ⲧⲙ
ϫⲉϯⲛⲁⲡⲣⲣⲟ	ϫⲉ|ϯ|ⲛⲁ|ⲡ|ⲣⲣⲟ
ⲁϥⲧⲱⲟⲩⲛϥ	ⲁ|ϥ|ⲧⲱⲟⲩⲛ|ϥ
ⲉⲛⲥⲩⲛϩⲉⲇⲣⲓⲟⲛ	ⲉ|ⲛ|ⲥⲩⲛϩⲉⲇⲣⲓⲟⲛ
ⲛⲁⲧⲙⲟⲩⲛⲅ	ⲛ|ⲁⲧⲙⲟⲩⲛⲅ
ⲉⲧϩⲙⲡⲉⲕⲏⲓ	ⲉⲧ|ϩⲙ|ⲡⲉⲕ|ⲏⲓ
ⲡⲉⲧⲉⲩⲛⲧⲁϥⲥϥ	ⲡ|ⲉⲧⲉ|ⲩⲛⲧⲁ|ϥ|ⲥϥ
ⲉⲡⲉⲡⲛⲉⲩⲙⲁ	ⲉ|ⲡⲉ|ⲡⲛⲉⲩⲙⲁ
ϩⲓⲧⲟⲟⲧⲟⲩ	ϩⲓ|ⲧⲟⲟⲧⲟⲩ
ϫⲉⲉⲣⲉϩⲉⲛⲉϫⲏⲩ	ϫⲉ|ⲉⲣⲉ|ϩⲉⲛ|ⲉϫⲏⲩ
ⲛⲧⲱⲧⲛ	ⲛⲧⲱⲧⲛ
ⲛⲉϥϫⲛⲟⲩ	ⲛⲉ|ϥ|ϫⲛⲟⲩ
ⲉⲡⲓⲉⲣⲟ	ⲉ|ⲡ|ⲓⲉⲣⲟ
ϫⲉⲙⲡⲉⲛϩⲉⲗⲗⲏⲛ	ϫⲉ|ⲙⲡⲉ|ⲛ|ϩⲉⲗⲗⲏⲛ
ⲉⲕⲉⲙⲉⲣⲉ	ⲉ|ⲕ|ⲉ|ⲙⲉⲣⲉ
ⲙⲡⲥⲁⲧⲁⲛⲁⲥ	ⲙ|ⲡ|ⲥⲁⲧⲁⲛⲁⲥ
ϩⲛⲇⲓⲕⲁⲓⲟⲥⲩⲛⲏ	ϩⲛ|ⲇⲓⲕⲁⲓⲟⲥⲩⲛⲏ
ϭⲙϭⲟⲙ	ϭⲙϭⲟⲙ
ⲛⲙⲁⲧⲟⲓ	ⲛ|ⲙⲁⲧⲟⲓ
ⲙⲡⲙⲟⲩ	ⲙ|ⲡ|ⲙⲟⲩ
ⲛⲛⲇⲁⲓⲙⲱⲛⲓⲟⲛ	ⲛ|ⲛ|ⲇⲁⲓⲙⲱⲛⲓⲟⲛ
ⲁⲛⲥⲱⲧⲙ	ⲁ|ⲛ|ⲥⲱⲧⲙ
ⲁⲩⲣϩⲁϩ	ⲁ|ⲩ|ⲣϩⲁϩ
ⲉⲛⲧϥ	ⲉ|ⲛⲧ|ϥ
ⲛⲛⲉⲧϫⲟⲥⲉ	ⲛ|ⲛ|ⲉⲧ|ϫⲟⲥⲉ
ⲉⲣϣⲁⲛⲛⲁⲓ	ⲉⲣϣⲁⲛ|ⲛⲁⲓ
ⲛⲕⲟⲧ	ⲛ|ⲕⲟⲧ
ⲡⲉⲓⲱⲧ	ⲡ|ⲉⲓⲱⲧ
ϣⲁⲛⲕⲗⲗⲉ	ϣⲁ|ⲛ|ⲕⲗⲗⲉ
ϩⲙⲡⲉϥⲧⲟⲩⲧⲏⲩ	ϩⲙ|ⲡⲉ|ϥⲧⲟⲩ|ⲧⲏⲩ
ⲉⲧⲣⲉ[.]ϣⲓⲛⲉ	ⲉ|ⲧⲣⲉ|[.]|ϣⲓⲛⲉ
ϯⲥⲟⲉⲓⲧ	ϯ|ⲥⲟⲉⲓⲧ
ⲙⲡⲉⲓⲉⲩⲁⲅⲅⲉⲗⲓⲟⲛ	ⲙ|ⲡⲉⲓ|ⲉⲩⲁⲅⲅⲉⲗⲓⲟⲛ
ⲛⲧⲉⲥϭⲟⲧ	ⲛ|ⲧⲉⲥ|ϭⲟⲧ
ⲙⲛⲁⲡⲟⲗⲗⲱ	ⲙⲛ|ⲁⲡⲟⲗⲗⲱ
ⲉⲧⲣⲉⲩϥⲓ	ⲉ|ⲧⲣⲉ|ⲩ|ϥⲓ
ⲉⲩⲧⲱⲃϩ	ⲉ|ⲩ|ⲧⲱⲃϩ
ⲣⲡⲉⲧⲛⲁⲛⲟⲩϥ	ⲣ|ⲡ|ⲉⲧ|ⲛⲁⲛⲟⲩ|ϥ
ⲛϥϯ	ⲛ|ϥ|ϯ
ϩⲁⲟⲩⲁ	ϩⲁ|ⲟⲩⲁ
ϩⲟⲧⲁⲛ	ϩⲟⲧⲁⲛ
ⲉⲥⲟⲩⲏϩ	ⲉ|ⲥ|ⲟⲩⲏϩ
.	.
ϣⲁϥϯⲟⲩⲱ	ϣⲁ|ϥ|ϯ|ⲟⲩⲱ
ⲉⲛⲁⲛⲟⲩⲟⲩ	ⲉ|ⲛⲁⲛⲟⲩ|ⲟⲩ
ⲉⲣⲛⲁⲛⲟⲙⲓⲁ	ⲉⲣⲛ|ⲁⲛⲟⲙⲓⲁ
ⲛⲕⲣⲓⲧⲏⲥ	ⲛ|ⲕⲣⲓⲧⲏⲥ
ⲛⲧⲉⲧⲅⲁⲗⲓⲗⲁⲓⲁ	ⲛⲧⲉ|ⲧ|ⲅⲁⲗⲓⲗⲁⲓⲁ
ϩⲁⲣⲉϩ	ϩⲁⲣⲉϩ
ⲛⲧⲉⲣⲉⲡⲥⲁⲃⲃⲁⲧⲟⲛ	ⲛⲧⲉⲣⲉ|ⲡ|ⲥⲁⲃⲃⲁⲧⲟⲛ
ϥⲥϩⲟⲩⲟⲣⲧ	ϥ|ⲥϩⲟⲩⲟⲣⲧ
ϩⲏⲧϥ	ϩⲏⲧ|ϥ
ⲛⲉⲟⲟⲩ	ⲛ|ⲉⲟⲟⲩ
ϥⲛⲁⲟⲩϫⲁⲓ	ϥ|ⲛⲁ|ⲟⲩϫⲁⲓ
ⲉⲛϫⲃⲃⲉⲥ	ⲉ|ⲛ|ϫⲃⲃⲉⲥ
ⲉⲓⲁⲕⲱⲃ	ⲉ|ⲓⲁⲕⲱⲃ
ϩⲓⲧⲛⲡⲉⲧⲛⲛⲟⲩⲧⲉ	ϩⲓⲧⲛ|ⲡⲉⲧⲛ|ⲛⲟⲩⲧⲉ
ⲁϥⲕⲧⲟ	ⲁ|ϥ|ⲕⲧⲟ
ϩⲛⲟⲩⲙⲕⲁϩ	ϩⲛ|ⲟⲩ|ⲙⲕⲁϩ
ⲁⲩⲥⲉⲛϩ	ⲁ|ⲩ|ⲥⲉⲛϩ
ⲕⲁⲧⲁⲡⲉⲛⲃⲓⲟⲥ	ⲕⲁⲧⲁ|ⲡⲉ|ⲛ|ⲃⲓⲟⲥ
ϫⲉⲁⲣϯⲙⲧⲟⲛ	ϫⲉ|ⲁⲣ|ϯ|ⲙⲧⲟⲛ
ϩⲧⲏϥ	ϩⲧⲏ|ϥ
ϫⲉⲁⲛϣⲱⲡⲉ	ϫⲉ|ⲁ|ⲛ|ϣⲱⲡⲉ
ⲡⲉⲧⲛⲁⲃⲗ	ⲡ|ⲉⲧ|ⲛⲁ|ⲃⲗ
ϩⲙⲡⲓⲟⲣⲇⲁⲛⲏⲥ	ϩⲙ|ⲡ|ⲓⲟⲣⲇⲁⲛⲏⲥ
ⲉⲧϣⲟⲟⲡ	ⲉⲧ|ϣⲟⲟⲡ
ⲡⲥⲁⲃⲃⲁⲧⲟⲛ	ⲡ|ⲥⲁⲃⲃⲁⲧⲟⲛ
ⲣⲣⲙⲙⲁⲟ	ⲣⲣⲙⲙⲁⲟ
ⲡⲣⲙⲛϩⲏⲧ	ⲡ|ⲣⲙⲛϩⲏⲧ
ϣⲁϫⲱⲥ	ϣⲁ|ϫⲱ|ⲥ
ϫⲉⲉϣϫⲉ	ϫⲉ|ⲉϣϫⲉ
⸖	⸖
ⲡⲉⲛϫⲟⲉⲓⲥ	ⲡⲉⲛ|ϫⲟⲉⲓⲥ
ⲙⲛⲛⲥⲱϥ	ⲙⲛⲛⲥⲱ|ϥ
ⲙⲡⲉϥⲙⲧⲟ	ⲙ|ⲡⲉϥ|ⲙⲧⲟ
ⲧⲉⲧⲛⲁⲉⲓⲙⲉ	ⲧ|ⲉⲧ|ⲛⲁ|ⲉⲓⲙⲉ
ϩⲛⲛⲁⲓⲥⲙⲟⲧ	ϩⲛ|ⲛⲁⲓ|ⲥⲙⲟⲧ
ⲛⲛⲁⲓ	ⲛ|ⲛⲁⲓ
ⲡⲉⲧϯ	ⲡ|ⲉⲧ|ϯ
ⲉⲣⲉⲡⲉϥϩⲏⲧ	ⲉⲣⲉ|ⲡⲉϥ|ϩⲏⲧ
ϩⲛⲛⲉⲕⲙⲛⲧⲣⲉϥϫⲓⲛϭⲟⲛⲥ	ϩⲛ|ⲛⲉⲕ|ⲙⲛⲧⲣⲉϥϫⲓ|ⲛ|ϭⲟⲛⲥ
ⲛⲙⲁⲛⲇⲣⲉⲁⲥ	ⲛⲙ|ⲁⲛⲇⲣⲉⲁⲥ
ϫⲛⲙⲙⲟⲛ	ϫⲛ|ⲙⲙⲟⲛ
ⲛⲉⲧⲉⲙⲡⲉⲙⲁⲁϫⲉ	ⲛ|ⲉⲧⲉ|ⲙⲡⲉ|ⲙⲁⲁϫⲉ
ⲛⲟⲩⲡⲁϩⲣⲉ	ⲛ|ⲟⲩ|ⲡⲁϩⲣⲉ
ⲉⲩⲟⲩⲱⲙ	ⲉ|ⲩ|ⲟⲩⲱⲙ
ϩⲁⲛⲉⲕⲟⲩⲉⲣⲏⲧⲉ	ϩⲁ|ⲛⲉⲕ|ⲟⲩⲉⲣⲏⲧⲉ
ⲛⲧⲁⲡⲉⲭⲣⲓⲥⲧⲟⲥ	ⲛⲧ|ⲁ|ⲡⲉ|ⲭⲣⲓⲥⲧⲟⲥ
ⲁⲛⲥⲟⲩⲉⲛ	ⲁ|ⲛ|ⲥⲟⲩⲉⲛ
ⲉⲛⲉⲕⲟⲩⲉⲣⲏⲧⲉ	ⲉ|ⲛⲉⲕ|ⲟⲩⲉⲣⲏⲧⲉ
ⲙⲡⲉϥⲡⲛⲁ	ⲙ|ⲡⲉϥ|ⲡⲛⲉⲩⲙⲁ
ϫⲉⲉⲩⲉϫⲓ	ϫⲉ|ⲉⲩⲉ|ϫⲓ
ϩⲛϩⲉⲛⲥⲙⲟⲩ	ϩⲛ|ϩⲉⲛ|ⲥⲙⲟⲩ
ϩⲛⲟⲩⲙⲟⲥⲧⲉ	ϩⲛ|ⲟⲩ|ⲙⲟⲥⲧⲉ
ϣⲁⲥⲣϩⲛⲁⲥ	ϣⲁ|ⲥ|ⲣ|ϩⲛⲁ|ⲥ
ⲡϣⲏⲣⲉ	ⲡ|ϣⲏⲣⲉ
ⲉⲛⲕⲉⲣⲣⲱⲟⲩ	ⲉ|ⲛ|ⲕⲉ|ⲣⲣⲱⲟⲩ
ⲟⲩⲧⲉⲗⲱⲛⲏⲥ	ⲟⲩ|ⲧⲉⲗⲱⲛⲏⲥ
ⲉⲡⲟⲩⲁ	ⲉ|ⲡ|ⲟⲩⲁ
ϫⲉⲓⲱϩⲁⲛⲛⲏⲥ	ϫⲉ|ⲓⲱϩⲁⲛⲛⲏⲥ
ⲉⲧⲡⲓⲥⲧⲉⲩⲉ	ⲉⲧ|ⲡⲓⲥⲧⲉⲩⲉ
ϩⲛⲧⲟⲩⲙⲛⲧϫⲁⲥⲓϩⲏⲧ	ϩⲛ|ⲧⲟⲩ|ⲙⲛⲧϫⲁⲥⲓϩⲏⲧ
ⲉϣⲁⲧⲉⲧⲛϯ	ⲉ|ϣⲁ|ⲧⲉⲧⲛ|ϯ
ⲛⲧⲁⲛϫⲓ	ⲛⲧ|ⲁ|ⲛ|ϫⲓ
…ⲛ	…ⲛ
ⲛⲧⲟ	ⲛⲧⲟ
ϥϣⲁϫⲉ	ϥ|ϣⲁϫⲉ
ⲁⲩⲕⲁⲁⲩ	ⲁ|ⲩ|ⲕⲁⲁ|ⲩ
ⲁⲧⲉⲧⲛⲧⲁⲕⲟϥ	ⲁ|ⲧⲉⲧⲛ|ⲧⲁⲕⲟ|ϥ
ⲙⲡϥⲥϭⲏⲣ	ⲙⲡ|ϥ|ⲥϭⲏⲣ
ⲛⲉϥ	ⲛⲉϥ
ⲉⲛⲉⲡⲣⲟⲫⲏⲧⲏⲥ	ⲉ|ⲛⲉ|ⲡⲣⲟⲫⲏⲧⲏⲥ
ϫⲉⲁⲓⲧⲉⲓ	ϫⲉ|ⲁⲓⲧⲉⲓ
ⲛϣⲁⲓ	ⲛ|ϣⲁⲓ
ⲛⲉϥϩⲟⲉⲓⲧⲉ	ⲛⲉϥ|ϩⲟⲉⲓⲧⲉ
ϫⲉⲁⲙⲏⲓⲛ	ϫⲉ|ⲁⲙⲏⲓⲛ
ⲛϫⲁⲉⲓⲉ	ⲛ|ϫⲁⲉⲓⲉ
ⲉⲙⲟⲟⲩⲧϥ	ⲉ|ⲙⲟⲟⲩⲧ|ϥ
ϩⲓⲧⲙⲡⲛⲟⲩⲧⲉ	ϩⲓⲧⲙ|ⲡ|ⲛⲟⲩⲧⲉ
ⲉⲛⲉⲧⲛⲉⲣⲏⲩ	ⲉ|ⲛⲉⲧⲛ|ⲉⲣⲏⲩ
ⲛⲏⲥⲁⲩ	ⲛ|ⲏⲥⲁⲩ
ϩⲙⲡⲁⲣⲁⲛ	ϩⲙ|ⲡⲁ|ⲣⲁⲛ
ⲛⲧⲁⲕⲡⲁϩⲟⲩ	ⲉⲛⲧ|ⲁ|ⲕ|ⲡⲁϩ|ⲟⲩ
ϩⲙⲡⲛⲟⲙⲟⲥ	ϩⲙ|ⲡ|ⲛⲟⲙⲟⲥ
ⲛϣⲙⲙⲟ	ⲛ|ϣⲙⲙⲟ
ⲁϥϯϩⲉⲛⲣⲁⲛ	ⲁ|ϥ|ϯ|ϩⲉⲛ|ⲣⲁⲛ
ⲁϥⲛⲟϫⲟⲩ	ⲁ|ϥ|ⲛⲟϫ|ⲟⲩ
ⲛⲧⲁⲛⲉⲡⲣⲟⲫⲏⲧⲏⲥ	ⲛⲧ|ⲁ|ⲛⲉ|ⲡⲣⲟⲫⲏⲧⲏⲥ
ⲁⲩⲣϩⲟⲧⲉ	ⲁ|ⲩ|ⲣϩⲟⲧⲉ
ⲉϩⲏⲧϥ	ⲉ|ϩⲏⲧ|ϥ
ⲉⲧⲙⲧⲣⲉⲩϣⲱⲡⲉ	ⲉ|ⲧⲙ|ⲧⲣⲉ|ⲩ|ϣⲱⲡⲉ
ϩⲛⲛⲉⲧⲛϩⲏⲧ	ϩⲛ|ⲛⲉⲧⲛ|ϩⲏⲧ
ϩⲛⲟⲩⲟⲩⲱⲛϩ	ϩⲛ|ⲟⲩ|ⲟⲩⲱⲛϩ
ⲧⲁⲙⲓⲟ	ⲧⲁⲙⲓⲟ
ϩⲁⲧⲏ	ϩⲁⲧⲏ
ⲙⲟⲛⲟⲛ	ⲙⲟⲛⲟⲛ
ϫⲉⲙⲙⲛⲙⲛⲧⲣⲙϩⲉ	ϫⲉ|ⲙⲙⲛ|ⲙⲛⲧⲣⲙϩⲉ
ⲛⲧⲩⲣⲟⲥ	ⲛ|ⲧⲩⲣⲟⲥ
ⲁϥⲗⲟ	ⲁ|ϥ|ⲗⲟ
ϫⲉⲥⲱ	ϫⲉ|ⲥⲱ
ⲛⲙⲡⲙⲛⲧⲥⲛⲟⲟⲩⲥ	ⲛⲙ|ⲡ|ⲙⲛⲧⲥⲛⲟⲟⲩⲥ
ϫⲉⲥⲉⲛⲁⲡⲱⲧ	ϫⲉ|ⲥⲉ|ⲛⲁ|ⲡⲱⲧ
ⲁⲥⲧⲁϩ	ⲁ|ⲥ|ⲧⲁϩ
ⲟⲩⲁϩⲙ	ⲟⲩⲁϩⲙ
ⲉϥⲛⲁⲧⲁⲗⲉ	ⲉ|ϥ|ⲛⲁ|ⲧⲁⲗⲉ
ϥⲛⲁⲧⲱⲙⲛⲧ	ϥ|ⲛⲁ|ⲧⲱⲙⲛⲧ
ϩⲓⲡϫⲁⲓⲉ	ϩⲓ|ⲡ|ϫⲁⲓⲉ
ⲛϥϩⲙⲟⲟⲥ	ⲛ|ϥ|ϩⲙⲟⲟⲥ
ⲛⲧⲛⲧⲙⲉⲓⲙⲉ	ⲛ|ⲧⲛ|ⲧⲙ|ⲉⲓⲙⲉ
ⲙⲡⲉⲓⲙⲁ	ⲙ|ⲡⲉⲓ|ⲙⲁ
ⲥⲟⲩⲱⲛⲥ	ⲥⲟⲩⲱⲛ|ⲥ
ⲁϥϣⲗⲏⲗ	ⲁ|ϥ|ϣⲗⲏⲗ
ϫⲉⲕⲁⲥ	ϫⲉⲕⲁⲥ
ⲉⲛⲉⲧⲛⲁⲡⲓⲥⲧⲉⲩⲉ	ⲉ|ⲛ|ⲉⲧ|ⲛⲁ|ⲡⲓⲥⲧⲉⲩⲉ
ⲉⲝⲁⲡⲁⲧⲁ	ⲉⲝⲁⲡⲁⲧⲁ
ⲛⲧⲉⲣⲟⲩⲛⲁⲩ	ⲛⲧⲉⲣ|ⲟⲩ|ⲛⲁⲩ
ⲉⲧⲣⲉⲧⲛⲧⲁⲙⲟⲛ	ⲉ|ⲧⲣⲉ|ⲧⲛ|ⲧⲁⲙⲟ|ⲛ
ϫⲉⲙⲡⲉⲕⲟⲩⲱϣ	ϫⲉ|ⲙⲡⲉ|ⲕ|ⲟⲩⲱϣ
ϩⲕⲟ	ϩⲕⲟ
ⲛⲧⲉⲣⲉϥϭⲱϣⲧ	ⲛⲧⲉⲣⲉ|ϥ|ϭⲱϣⲧ
ⲉⲧⲉⲛⲟⲩ	ⲉ|ⲧⲉⲛⲟⲩ
ⲉⲧⲉⲉⲓⲣⲉ	ⲉ|ⲧⲉ|ⲉⲓⲣⲉ
ϩⲉⲛⲉⲛⲉⲙⲙⲉ	ϩⲉⲛ|ⲉⲛⲉ|ⲙ|ⲙⲉ
ϫⲉⲁⲩⲡⲉⲓⲣⲁⲍⲉ	ϫⲉ|ⲁ|ⲩ|ⲡⲉⲓⲣⲁⲍⲉ
ϩⲉⲛⲥⲱϣⲉ	ϩⲉⲛ|ⲥⲱϣⲉ
ⲉⲙⲟⲣϥ	ⲉ|ⲙⲟⲣ|ϥ
ⲧⲛⲟⲩⲱϣ	ⲧⲛ|ⲟⲩⲱϣ
ⲉⲓⲥϩⲁⲓ	ⲉ|ⲓ|ⲥϩⲁⲓ
ⲉⲥⲟⲩⲱⲛⲅ	ⲉ|ⲥⲟⲩⲱⲛ|ⲅ
ⲙⲛⲧⲉⲩⲙⲛⲧⲙⲁⲓ	ⲙⲛ|ⲧⲉ|ⲩ|ⲙⲛⲧⲙⲁⲓ
ⲛϣⲟⲛⲧⲉ	ⲛ|ϣⲟⲛⲧⲉ
ⲙⲛⲛⲟⲩⲁ	ⲙⲛ|ⲛ|ⲟⲩⲁ
ϩⲁϩ	ϩⲁϩ
ⲙⲛϩⲛⲕⲟⲟⲩⲉ	ⲙⲛ|ϩⲉⲛ|ⲕⲟⲟⲩⲉ
ⲁⲡϩⲱⲃ	ⲁ|ⲡ|ϩⲱⲃ
ⲧⲉⲧⲛϭⲱϣⲧ	ⲧⲉⲧⲛ|ϭⲱϣⲧ
ⲙⲛⲟⲩⲁⲣⲟⲟⲩⲉ	ⲙⲛ|ⲟⲩ|ⲁⲣⲟⲟⲩⲉ
ϫⲉⲛⲛⲉⲡⲛⲟⲩⲧⲉ	ϫⲉ|ⲛⲛⲉ|ⲡ|ⲛⲟⲩⲧⲉ
ⲛⲧⲙⲛⲧⲣⲣⲟ	ⲛ|ⲧ|ⲙⲛⲧⲣⲣⲟ
ⲙⲡⲉⲧⲥⲙⲁⲙⲁⲁⲧ	ⲙ|ⲡ|ⲉⲧ|ⲥⲙⲁⲙⲁⲁⲧ
ⲁⲓⲟⲩⲱ	ⲁ|ⲓ|ⲟⲩⲱ
ϩⲛⲧⲉϥⲡⲁⲛⲟⲩⲣⲅⲓⲁ	ϩⲛ|ⲧⲉϥ|ⲡⲁⲛⲟⲩⲣⲅⲓⲁ
ⲛⲧⲟⲓⲕⲟⲩⲙⲉⲛⲏ	ⲛ|ⲧ|ⲟⲓⲕⲟⲩⲙⲉⲛⲏ
ⲡⲉⲧⲣⲕⲃⲁ	ⲡ|ⲉⲧ|ⲣⲕⲃⲁ
ⲉⲙⲡⲟⲩϫⲡⲟϥ	ⲉ|ⲙⲡ|ⲟⲩ|ϫⲡⲟ|ϥ
ⲛϭⲱⲃ	ⲛ|ϭⲱⲃ
ⲉϥⲓ	ⲉ|ϥⲓ
ⲙⲡϣⲁϫⲉ	ⲙ|ⲡ|ϣⲁϫⲉ
ⲙⲉⲣⲉ	ⲙⲉⲣⲉ
ⲟⲩⲁⲁⲃ	ⲟⲩⲁⲁⲃ
ⲉⲧⲃⲉϫⲉⲁⲩⲡⲱⲧ	ⲉⲧⲃⲉ|ϫⲉ|ⲁ|ⲩ|ⲡⲱⲧ
ⲉⲧⲉⲓⲟⲩⲛⲟⲩ	ⲉ|ⲧⲉⲓ|ⲟⲩⲛⲟⲩ
ⲡⲥⲁϣϥ	ⲡ|ⲥⲁϣϥ
ⲧⲁⲣⲟⲩⲥⲣϥⲉ	ⲧⲁⲣ|ⲟⲩ|ⲥⲣϥⲉ
ϩⲙⲡⲉⲥⲥⲱⲙⲁ	ϩⲙ|ⲡⲉⲥ|ⲥⲱⲙⲁ
ⲁⲩϫⲓ	ⲁ|ⲩ|ϫⲓ
ⲧⲁϩⲟϥ	ⲧⲁϩⲟ|ϥ
ⲡⲉⲛⲉⲓⲱⲧ	ⲡⲉⲛ|ⲉⲓⲱⲧ
ⲛⲉⲩϫⲓⲟⲩⲁ	ⲛⲉ|ⲩ|ϫⲓⲟⲩⲁ
ϩⲛⲧⲉϩⲣⲉ	ϩⲛ|ⲧⲉ|ϩⲣⲉ
ⲛⲥⲉⲙⲟⲟⲩⲧⲟⲩ	ⲛ|ⲥⲉ|ⲙⲟⲟⲩⲧ|ⲟⲩ
ϩⲙⲡⲉⲥⲕⲁⲣⲡⲟⲥ	ϩⲙ|ⲡⲉⲥ|ⲕⲁⲣⲡⲟⲥ
ⲟⲩϫⲁⲓ	ⲟⲩϫⲁⲓ
ⲧⲁⲡⲕⲟⲩⲉⲓ	ⲧⲁ|ⲡ|ⲕⲟⲩⲉⲓ
ⲛϭⲓⲛⲉⲛⲉⲓⲟⲧⲉ	ⲛϭⲓ|ⲛⲉⲛ|ⲉⲓⲟⲧⲉ
ⲛⲙⲓⲱϩⲁⲛⲛⲏⲥ	ⲛⲙ|ⲓⲱϩⲁⲛⲛⲏⲥ
ⲛⲛⲥⲟⲫⲟⲥ	ⲛ|ⲛ|ⲥⲟⲫⲟⲥ
ⲉⲕⲁⲡⲁⲧⲁ	ⲉ|ⲕ|ⲁⲡⲁⲧⲁ
ⲉⲧⲉⲣⲏⲙⲟⲥ	ⲉ|ⲧ|ⲉⲣⲏⲙⲟⲥ
ⲉⲛⲉϩⲃⲏⲩⲉ	ⲉ|ⲛⲉ|ϩⲃⲏⲩⲉ
ⲛⲉⲩⲅⲉⲛⲏⲥ	ⲛ|ⲉⲩⲅⲉⲛⲏⲥ
ϫⲉⲕⲛⲁⲩ	ϫⲉ|ⲕ|ⲛⲁⲩ
ϯⲛⲁⲧⲥⲁⲃⲱⲧⲛ	ϯ|ⲛⲁ|ⲧⲥⲁⲃⲱ|ⲧⲛ
ⲛⲧⲉⲣⲉⲥⲃⲱⲕ	ⲛⲧⲉⲣⲉ|ⲥ|ⲃⲱⲕ
ⲛⲥⲁⲟⲩϭⲉⲣⲱⲃ	ⲛⲥⲁ|ⲟⲩ|ϭⲉⲣⲱⲃ
ⲉⲧⲱⲕⲙ	ⲉ|ⲧⲱⲕⲙ
ⲉⲧⲡⲉ	ⲉ|ⲧ|ⲡⲉ
ⲉⲧⲉⲙⲛⲙⲉ	ⲉⲧⲉ|ⲙⲛ|ⲙⲉ
ϫⲓⲛⲟⲩϩⲱⲥ	ϫⲓⲛ|ⲟⲩ|ϩⲱⲥ
ⲡⲉⲛⲧⲁϥⲕⲱⲗⲩⲉ	ⲡ|ⲉⲛⲧ|ⲁ|ϥ|ⲕⲱⲗⲩⲉ
ϩⲓⲥⲓϣⲉ	ϩⲓ|ⲥⲓϣⲉ
ⲛⲛⲉϥⲁⲅⲅⲉⲗⲟⲥ	ⲛ|ⲛⲉϥ|ⲁⲅⲅⲉⲗⲟⲥ
ϫⲉϯϯ	ϫⲉ|ϯ|ϯ
ⲛϫⲟⲩⲧⲏ	ⲛ|ϫⲟⲩⲧⲏ
ⲡⲉⲧⲉϣϣⲉ	ⲡ|ⲉⲧ|ⲉϣϣⲉ
ⲛⲥⲉⲕⲱ	ⲛ|ⲥⲉ|ⲕⲱ
ⲡⲁⲧϣⲉⲗⲉⲉⲧ	ⲡⲁ|ⲧ|ϣⲉⲗⲉⲉⲧ
ⲛⲧⲉⲓϩⲉ	ⲛ|ⲧⲉⲓ|ϩⲉ
ϫⲉⲁⲥⲉⲣ	ϫⲉ|ⲁ|ⲥ|ⲉⲣ
ⲡⲉⲛⲁⲣⲭⲱⲛ	ⲡⲉⲛ|ⲁⲣⲭⲱⲛ
ⲧⲁⲣⲉϥϯϩⲏⲩ	ⲧⲁⲣⲉ|ϥ|ϯ|ϩⲏⲩ
ⲛϩⲉⲛⲙⲁⲓⲛ	ⲛ|ϩⲉⲛ|ⲙⲁⲓⲛ
ⲉⲧϫⲏⲕ	ⲉⲧ|ϫⲏⲕ
ⲭⲁⲣⲓⲍⲉ	ⲭⲁⲣⲓⲍⲉ
ⲛⲉⲛⲧⲁⲡⲛⲟⲩⲧⲉ	ⲛ|ⲉⲛⲧ|ⲁ|ⲡ|ⲛⲟⲩⲧⲉ
ⲏⲣⲡ	ⲏⲣⲡ
ⲉϫⲱϥ	ⲉϫⲱ|ϥ
ⲛⲉⲓⲇⲱⲗⲟⲛ	ⲛ|ⲉⲓⲇⲱⲗⲟⲛ
ⲛⲥⲁϩⲟⲟⲩ	ⲛⲥⲁ|ϩⲟⲟⲩ
ⲧⲉⲧⲛⲥⲏⲩ	ⲧⲉⲧⲛ|ⲥⲏⲩ
ⲁϥϫⲛⲟⲩϥ	ⲁ|ϥ|ϫⲛⲟⲩ|ϥ
ⲙⲡⲉϥⲣⲡⲉ	ⲙ|ⲡⲉϥ|ⲣⲡⲉ
ⲁϥϣⲧⲟⲣⲧⲣ	ⲁ|ϥ|ϣⲧⲟⲣⲧⲣ
ⲡⲅⲁⲙⲟⲥ	ⲡ|ⲅⲁⲙⲟⲥ
ⲛϩⲏⲧ	ⲛ|ϩⲏⲧ
ⲉⲛⲏⲡ	ⲉ|ⲛ|ⲏⲡ
ϫⲉⲛⲛⲉⲧⲉⲓⲅⲉⲛⲉⲁ	ϫⲉ|ⲛⲛⲉ|ⲧⲉⲓ|ⲅⲉⲛⲉⲁ
ⲙⲡⲓⲟⲣⲇⲁⲛⲏⲥ	ⲙ|ⲡ|ⲓⲟⲣⲇⲁⲛⲏⲥ
ⲛⲥⲱ	ⲛⲥⲱ
ⲛⲛⲉϥⲣⲙⲛⲏⲓ	ⲛ|ⲛⲉϥ|ⲣⲙⲛ|ⲏⲓ
ⲉⲧⲟⲩⲕⲱ	ⲉⲧ|ⲟⲩ|ⲕⲱ
ⲧⲛⲥⲙⲟⲩ	ⲧⲛ|ⲥⲙⲟⲩ
ⲉϫⲛⲧⲉϥⲁⲡⲉ	ⲉϫⲛ|ⲧⲉϥ|ⲁⲡⲉ
ⲉϥⲓⲡⲉⲩⲣⲟⲟⲩϣ	ⲉ|ϥⲓ|ⲡⲉⲩ|ⲣⲟⲟⲩϣ
ⲉⲛⲁϣⲱⲟⲩ	ⲉ|ⲛⲁϣⲱ|ⲟⲩ
ⲉⲡϫⲟⲉⲓⲥ	ⲉ|ⲡ|ϫⲟⲉⲓⲥ
ⲉⲩⲛϭⲟⲙ	ⲉ|ⲩⲛ|ϭⲟⲙ
ⲡⲉⲑⲟⲟⲩ	ⲡ|ⲉⲧ|ϩⲟⲟⲩ
ϩⲉ	ϩⲉ
ⲙⲛⲛⲉⲓⲥϩⲁⲓ	ⲙⲛ|ⲛⲉⲓ|ⲥϩⲁⲓ
ⲉϥⲛⲁⲃⲁⲡⲧⲓⲍⲉ	ⲉ|ϥ|ⲛⲁ|ⲃⲁⲡⲧⲓⲍⲉ
ⲁϥϫⲛⲉ	ⲁ|ϥ|ϫⲛⲉ
ϯⲛⲁⲧⲣⲉⲡⲟⲩϩⲏⲧ	ϯ|ⲛⲁ|ⲧⲣⲉ|ⲡⲟⲩ|ϩⲏⲧ
ⲉⲣϣⲁⲛϩⲟⲓⲛⲉ	ⲉⲣϣⲁⲛ|ϩⲟⲓⲛⲉ
ⲛⲧⲙⲡϫⲟⲉⲓⲥ	ⲛ|ⲧⲙ|ⲡ|ϫⲟⲉⲓⲥ
ⲁⲩⲉⲓⲟⲣϩϥ	ⲁ|ⲩ|ⲉⲓⲟⲣϩ|ϥ
ⲛⲁⲓ	ⲛⲁⲓ
ⲛⲧⲉⲧⲛϣⲱⲡ	ⲛ|ⲧⲉⲧⲛ|ϣⲱⲡ
ⲛⲁϩⲣⲁϥ	ⲛⲁϩⲣⲁ|ϥ
ⲉⲧⲟⲟⲧⲥ	ⲉⲧⲟⲟⲧ|ⲥ
ⲛⲉϥϩⲛⲛⲉⲙϩⲁⲟⲩ	ⲛⲉ|ϥ|ϩⲛ|ⲛⲉ|ⲙϩⲁⲟⲩ
ⲧⲟⲟⲧⲟⲩ	ⲧⲟⲟⲧ|ⲟⲩ
ⲡⲣⲏⲛⲁⲣⲉⲃⲏ	ⲡ|ⲣⲏ|ⲛⲁ|ⲣⲉⲃⲏ
ⲁϥⲕⲱⲧ	ⲁ|ϥ|ⲕⲱⲧ
ⲧⲃⲗⲗⲏ	ⲧ|ⲃⲗⲗⲏ
ⲛϭⲓⲟⲩⲙⲏⲏϣⲉ	ⲛϭⲓ|ⲟⲩ|ⲙⲏⲏϣⲉ
ⲙⲛⲓⲉⲣⲉⲙⲓⲁⲥ	ⲙⲛ|ⲓⲉⲣⲉⲙⲓⲁⲥ
ⲙⲁⲣⲓⲥⲱⲧⲙ	ⲙⲁⲣ|ⲓ|ⲥⲱⲧⲙ
ⲙⲛⲛⲟⲩⲏⲏⲃ	ⲙⲛ|ⲛ|ⲟⲩⲏⲏⲃ
ⲉⲣϣⲁⲛⲡⲛⲟⲩⲧⲉ	ⲉⲣϣⲁⲛ|ⲡ|ⲛⲟⲩⲧⲉ
ⲁⲩϣⲱⲱⲧ	ⲁ|ⲩ|ϣⲱⲱⲧ
ⲛⲁϭⲣⲏⲛ	ⲛ|ⲁϭⲣⲏⲛ
ϣⲁⲡⲛⲁⲩ	ϣⲁ|ⲡ|ⲛⲁⲩ
ⲛⲉϥϩⲓⲡⲁϩⲟⲩ	ⲛⲉ|ϥ|ϩⲓ|ⲡⲁϩⲟⲩ
ϫⲉⲁ	ϫⲉ|ⲁ
ⲁⲩⲛⲉϩⲥⲉ	ⲁ|ⲩ|ⲛⲉϩⲥⲉ
ⲉⲧⲃⲉⲧⲙⲁⲕⲁⲣⲓⲁ	ⲉⲧⲃⲉ|ⲧ|ⲙⲁⲕⲁⲣⲓⲁ
ⲡϣⲁⲉⲛⲉϩ	ⲡ|ϣⲁ|ⲉⲛⲉϩ
ϫⲟⲟⲩ	ϫⲟ|ⲟⲩ
ϩⲙⲡⲉϥⲕⲱⲧⲉ	ϩⲙ|ⲡⲉϥ|ⲕⲱⲧⲉ
ⲛⲙⲙⲏⲧⲛ	ⲛⲙⲙⲏ|ⲧⲛ
ⲙⲉϥϣⲱⲡ	ⲙⲉ|ϥ|ϣⲱⲡ
ⲙⲛⲃⲉⲛⲓⲁⲙⲓⲛ	ⲙⲛ|ⲃⲉⲛⲓⲁⲙⲓⲛ
ⲛⲉⲛⲇⲓⲱⲅⲙⲟⲥ	ⲛⲉⲛ|ⲇⲓⲱⲅⲙⲟⲥ
ⲉⲛⲉⲑⲏⲡ	ⲉ|ⲛⲉ|ⲑⲏⲡ
ϫⲉⲉⲓϣⲁⲛϫⲱϩ	ϫⲉ|ⲉⲓϣⲁⲛ|ϫⲱϩ
ⲛⲧⲉⲩϣⲃⲉⲓⲱ	ⲛ|ⲧⲉⲩ|ϣⲃⲉⲓⲱ
ⲛϭⲓⲡⲉⲧϫⲟ	ⲛϭⲓ|ⲡ|ⲉⲧ|ϫⲟ
ⲁⲩϫⲛⲟⲩϥ	ⲁ|ⲩ|ϫⲛⲟⲩ|ϥ
ⲉϣⲓⲏⲧ	ⲉ|ϣⲓⲏⲧ
ⲉⲣϣⲁⲛⲧⲃⲁϣⲟⲣ	ⲉⲣϣⲁⲛ|ⲧ|ⲃⲁϣⲟⲣ
ⲛⲧⲁⲩⲥⲧⲁⲩⲣⲟⲩ	ⲛⲧ|ⲁ|ⲩ|ⲥⲧⲁⲩⲣⲟⲩ
ⲉⲧϩⲓⲃⲟⲗ	ⲉⲧ|ϩⲓⲃⲟⲗ
ⲛⲧⲛϫⲱ	ⲛⲧ|ⲛ|ϫⲱ
ϩⲛϩⲉⲛⲁⲧⲑⲁⲃ	ϩⲛ|ϩⲉⲛ|ⲁⲧⲑⲁⲃ
ⲉⲧⲣⲉⲛϫⲟⲟⲥ	ⲉ|ⲧⲣⲉ|ⲛ|ϫⲟⲟ|ⲥ
ⲛⲧⲉⲓ‎ⲙⲓⲛⲉ	ⲛ|ⲧⲉⲓ|ⲙⲓⲛⲉ
ⲧⲉⲧⲛⲛⲁⲛⲁⲩ	ⲧⲉⲧⲛ|ⲛⲁ|ⲛⲁⲩ
ϫⲉⲉⲩⲉⲥⲧⲁⲩⲣⲟⲩ	ϫⲉ|ⲉ|ⲩ|ⲉ|ⲥⲧⲁⲩⲣⲟⲩ
ϫⲉⲛⲉⲟⲩⲛ	ϫⲉ|ⲛⲉ|ⲟⲩⲛ
ϫⲉⲡⲛⲟⲩⲧⲉ	ϫⲉ|ⲡ|ⲛⲟⲩⲧⲉ
ⲉⲡⲟⲩⲏⲏⲃ	ⲉ|ⲡ|ⲟⲩⲏⲏⲃ
ⲧⲉⲧⲛϫⲟⲥⲉ	ⲧⲉⲧⲛ|ϫⲟⲥⲉ
ⲛⲧⲉⲣⲉϥⲕⲁ	ⲛⲧⲉⲣⲉ|ϥ|ⲕⲁ
ⲉⲣϣⲁⲛⲟⲩⲏⲓ	ⲉⲣϣⲁⲛ|ⲟⲩ|ⲏⲓ
ϩⲛ̅ⲑ	ϩⲛ|ⲧ
ϫⲉⲛⲉⲧⲟⲩϯ	ϫⲉ|ⲛ|ⲉⲧ|ⲟⲩ|ϯ
ⲛⲕⲉⲙⲛⲧⲣⲉ	ⲛ|ⲕⲉ|ⲙⲛⲧⲣⲉ
ⲛⲃⲟⲗ	ⲛ|ⲃⲟⲗ
ⲛϭⲓⲡⲉⲅⲣⲁⲙⲙⲁⲧⲉⲩⲥ	ⲛϭⲓ|ⲡⲉ|ⲅⲣⲁⲙⲙⲁⲧⲉⲩⲥ
ⲁⲩⲧⲁϩⲟϥ	ⲁ|ⲩ|ⲧⲁϩⲟ|ϥ
ⲉⲧⲃⲉⲧⲉⲩⲙⲛⲧϫⲁⲥⲓϩⲏⲧ	ⲉⲧⲃⲉ|ⲧⲉⲩ|ⲙⲛⲧϫⲁⲥⲓϩⲏⲧ
ⲙⲧⲟⲛ	ⲙⲧⲟⲛ
ⲛⲉⲓⲟⲟⲩⲉ	ⲛ|ⲉⲓⲟⲟⲩⲉ
ⲛⲁⲉⲓⲣⲉ	ⲛⲁ|ⲉⲓⲣⲉ
ⲛⲛⲉⲭⲏⲣⲁ	ⲛ|ⲛⲉ|ⲭⲏⲣⲁ
ⲙⲛϩⲛⲁⲩ	ⲙⲛ|ϩⲛⲁⲩ
ⲛⲉⲣⲉⲡⲉⲩϩⲏⲧ	ⲛⲉⲣⲉ|ⲡⲉⲩ|ϩⲏⲧ
ϩⲟⲉⲓⲛⲉ	ϩⲟⲉⲓⲛⲉ
ϩⲛⲙⲡⲏⲩⲉ	ϩⲛ|ⲙ|ⲡⲏⲩⲉ
ⲙⲛϩⲉⲛϣⲗⲏⲗ	ⲙⲛ|ϩⲉⲛ|ϣⲗⲏⲗ
ⲛⲧⲛⲙⲡϣⲁ	ⲛ|ⲧⲛ|ⲙⲡϣⲁ
ⲉⲧϩⲙⲟⲟⲥ	ⲉⲧ|ϩⲙⲟⲟⲥ
ⲟⲩⲥϩⲓⲙⲉ	ⲟⲩ|ⲥϩⲓⲙⲉ
ⲛⲕⲟⲟⲩⲉ	ⲛ|ⲕⲟⲟⲩⲉ
ⲉⲧⲛⲁⲟⲩⲱⲥϥ	ⲉⲧ|ⲛⲁ|ⲟⲩⲱⲥϥ
ⲉⲛⲁϣⲱⲟⲩⲙⲟⲩ	ⲉⲛ|ⲁϣⲱ|ⲟⲩ|ⲙⲟⲩ
ⲛⲇⲁⲓⲙⲱⲛⲓⲟⲛ	ⲛ|ⲇⲁⲓⲙⲱⲛⲓⲟⲛ
ⲡⲱⲥ	ⲡⲱⲥ
ϫⲓⲛⲧⲡⲉ	ϫⲓⲛ|ⲧ|ⲡⲉ
ϩⲟⲙⲛⲧ	ϩⲟⲙⲛⲧ
ⲉⲡⲁⲓ	ⲉ|ⲡⲁⲓ
ϣⲁⲛⲧⲟⲩⲣⲛⲟϭ	ϣⲁⲛⲧ|ⲟⲩ|ⲣⲛⲟϭ
ⲛⲣⲟⲉⲓⲥ	ⲛ|ⲣⲟⲉⲓⲥ
ⲉⲧⲉⲣⲉⲡⲛⲟⲩⲧⲉ	ⲉⲧⲉⲣⲉ|ⲡ|ⲛⲟⲩⲧⲉ
ⲙⲛⲛϩⲁⲗⲁⲧⲉ	ⲙⲛ|ⲛ|ϩⲁⲗⲁⲧⲉ
ⲛⲛⲓⲣⲱⲙⲉ	ⲛ|ⲛⲓ|ⲣⲱⲙⲉ
ⲙⲛⲛⲥⲱⲥ	ⲙⲛⲛⲥⲱ|ⲥ
ⲁϥϫⲓⲃⲁⲡⲧⲓⲥⲙⲁ	ⲁ|ϥ|ϫⲓ|ⲃⲁⲡⲧⲓⲥⲙⲁ
ⲁϥϫⲉⲩⲕⲉϩⲙϩⲁⲗ	ⲁ|ϥ|ϫⲉⲩ|ⲕⲉ|ϩⲙϩⲁⲗ
ⲇⲁⲓⲙⲱⲛⲓⲟⲛ	ⲇⲁⲓⲙⲱⲛⲓⲟⲛ
ⲙⲡⲟⲩϣⲃⲱⲕ	ⲙⲡ|ⲟⲩ|ϣ|ⲃⲱⲕ
ⲛⲧⲕⲟⲗⲗⲏⲅⲓⲟⲛ	ⲛ|ⲧ|ⲕⲟⲗⲗⲏⲅⲓⲟⲛ
ⲉⲥⲁϩⲉⲣⲁⲧⲥ	ⲉ|ⲥ|ⲁϩⲉⲣⲁⲧ|ⲥ
ⲉⲣⲟⲟⲩ	ⲉⲣⲟ|ⲟⲩ
ⲛⲁⲟⲓⲕⲟⲛⲟⲙⲟⲥ	ⲛⲁ|ⲟⲓⲕⲟⲛⲟⲙⲟⲥ
ⲉⲧϩⲟⲟⲩ	ⲉⲧ|ϩⲟⲟⲩ
ⲉⲛϣⲟⲛⲧⲉ	ⲉ|ⲛ|ϣⲟⲛⲧⲉ
ⲉϫⲛⲟⲩⲱⲛⲉ	ⲉϫⲛ|ⲟⲩ|ⲱⲛⲉ
ⲉⲓⲥⲟⲩⲥⲃⲱ	ⲉⲓⲥ|ⲟⲩ|ⲥⲃⲱ
 	 
ⲙⲡⲥⲁϩ	ⲙ|ⲡ|ⲥⲁϩ
ⲉⲧⲉⲧⲛⲛⲁ	ⲉ|ⲧⲉⲧⲛ|ⲛⲁ
ⲕⲉⲙⲓⲛⲉ	ⲕⲉ|ⲙⲓⲛⲉ
ϫⲉⲟⲩ	ϫⲉ|ⲟⲩ
ϩⲟⲥⲟⲛ	ϩⲟⲥⲟⲛ
ϩⲛⲛⲉϥⲥⲩⲅⲅⲉⲛⲏⲥ	ϩⲛ|ⲛⲉϥ|ⲥⲩⲅⲅⲉⲛⲏⲥ
ⲛⲥⲉⲟⲩⲁϩⲟⲩ	ⲛ|ⲥⲉ|ⲟⲩⲁϩ|ⲟⲩ
ϥϥⲓ	ϥ|ϥⲓ
ⲡⲉϫⲉⲛⲉϥⲙⲁⲑⲏⲧⲏⲥ	ⲡⲉϫⲉ|ⲛⲉϥ|ⲙⲁⲑⲏⲧⲏⲥ
ⲛⲧⲁⲩϯ	ⲛⲧ|ⲁ|ⲩ|ϯ
ⲡⲉⲛⲧⲁϥⲧⲁⲕⲟ	ⲡ|ⲉⲛⲧ|ⲁ|ϥ|ⲧⲁⲕⲟ
ⲛⲉⲟⲩⲛϩⲉⲛϩⲓⲟⲙⲉ	ⲛⲉ|ⲟⲩⲛ|ϩⲉⲛ|ϩⲓⲟⲙⲉ
ⲙⲛⲛⲣⲉϥⲛⲕⲟⲧⲕ	ⲙⲛ|ⲛ|ⲣⲉϥⲛⲕⲟⲧⲕ
ⲛⲧⲉⲣⲟⲩⲟⲩⲱ	ⲛⲧⲉⲣ|ⲟⲩ|ⲟⲩⲱ
ⲛⲉⲕⲙⲁⲑⲏⲧⲏⲥ	ⲛⲉⲕ|ⲙⲁⲑⲏⲧⲏⲥ
ⲛⲟⲩϩⲉⲑⲛⲓⲕⲟⲥ	ⲛ|ⲟⲩ|ϩⲉⲑⲛⲓⲕⲟⲥ
ⲉⲓϩⲁⲧⲛⲧⲏⲩⲧⲛ	ⲉ|ⲓ|ϩⲁⲧⲛ|ⲧⲏⲩⲧⲛ
ⲁⲛⲅⲡⲁⲁⲡⲟⲗⲗⲱ	ⲁⲛⲅ|ⲡⲁ|ⲁⲡⲟⲗⲗⲱ
ϩⲓⲧⲛⲓⲏⲥⲟⲩⲥ	ϩⲓⲧⲛ|ⲓⲏⲥⲟⲩⲥ
ⲛϭⲓⲧϣⲉⲉⲣⲉ	ⲛϭⲓ|ⲧ|ϣⲉⲉⲣⲉ
ⲉϥⲛⲁⲙⲟⲩ	ⲉ|ϥ|ⲛⲁ|ⲙⲟⲩ
ϩⲓϩⲏ	ϩⲓϩⲏ
ϩⲁⲣⲟⲟⲩ	ϩⲁⲣⲟ|ⲟⲩ
ⲛⲉⲩϭⲟⲛⲧ	ⲛⲉ|ⲩ|ϭⲟⲛⲧ
ⲛⲉⲓⲥⲁϩⲟⲩ	ⲛⲉⲓ|ⲥⲁϩⲟⲩ
ⲙⲛⲛⲉⲧⲉⲣⲉⲛⲇⲁⲓⲙⲱⲛⲓⲟⲛ	ⲙⲛ|ⲛ|ⲉⲧ|ⲉⲣ|ⲉⲛⲇⲁⲓⲙⲱⲛⲓⲟⲛ
ⲡⲉⲧⲉⲩⲛⲧϥⲙⲁⲁϫⲉ	ⲡ|ⲉⲧⲉ|ⲩⲛⲧ|ϥ|ⲙⲁⲁϫⲉ
ⲙⲁⲟⲩⲁⲁϥ	ⲙⲁⲟⲩⲁⲁ|ϥ
ⲙⲛϩⲛϣⲧⲏⲛ	ⲙⲛ|ϩⲛ|ϣⲧⲏⲛ
ⲧⲉⲧⲛⲉⲓⲣⲉ	ⲧⲉⲧⲛ|ⲉⲓⲣⲉ
ⲉⲁⲩⲥⲙⲟⲩ	ⲉ|ⲁ|ⲩ|ⲥⲙⲟⲩ
ϩⲛⲟ	ϩⲛⲟ
ⲛⲧⲟⲟⲧϥ	ⲛⲧⲟⲟⲧ|ϥ
ⲛⲟⲩϩⲉ	ⲛ|ⲟⲩ|ϩⲉ
ⲛⲧⲁⲩⲥⲟⲟⲩⲧⲛ	ⲛⲧ|ⲁ|ⲩ|ⲥⲟⲟⲩⲧⲛ
ϣⲁⲣⲟϥ	ϣⲁⲣⲟ|ϥ
ⲁϥϯ	ⲁ|ϥ|ϯ
ϩⲓⲟⲩⲥⲟⲡ	ϩⲓ|ⲟⲩ|ⲥⲟⲡ
ⲉϫⲛⲛⲉⲧⲛϫⲓⲛϭⲟⲛⲥ	ⲉϫⲛ|ⲛⲉⲧⲛ|ϫⲓⲛ|ϭⲟⲛⲥ
ⲡⲉⲧⲱϣ	ⲡ|ⲉⲧ|ⲱϣ
ⲉⲱⲣⲕ	ⲉ|ⲱⲣⲕ
ⲉⲧⲃⲉⲡⲉⲭⲣⲓⲥⲧⲟⲥ	ⲉⲧⲃⲉ|ⲡⲉ|ⲭⲣⲓⲥⲧⲟⲥ
ⲡϣⲟⲣⲡ	ⲡ|ϣⲟⲣⲡ
ⲉⲧⲉⲣⲉϯⲥⲙⲏ	ⲉⲧⲉⲣⲉ|ϯⲥⲙⲏ
ⲛⲧⲛⲉⲓⲣⲉ	ⲛ|ⲧⲛ|ⲉⲓⲣⲉ
ⲛϩⲉⲛⲉⲥⲟⲟⲩ	ⲛ|ϩⲉⲛ|ⲉⲥⲟⲟⲩ
ⲛⲉⲛⲧⲁⲩⲟⲩⲱⲙ	ⲛ|ⲉⲛⲧ|ⲁ|ⲩ|ⲟⲩⲱⲙ
ϩⲉⲛⲕⲉⲙⲏⲏϣⲉ	ϩⲉⲛ|ⲕⲉ|ⲙⲏⲏϣⲉ
ϩⲙⲡϫⲟⲉⲓ	ϩⲙ|ⲡ|ϫⲟⲉⲓ
ⲛⲟⲩϩⲟⲟⲩ	ⲛ|ⲟⲩ|ϩⲟⲟⲩ
ⲙⲁⲩⲁⲁⲩ	ⲙⲁⲩⲁⲁ|ⲩ
ⲉϫⲛⲟⲩⲕⲟⲗⲗⲏⲅⲓⲟⲛ	ⲉϫⲛ|ⲟⲩ|ⲕⲟⲗⲗⲏⲅⲓⲟⲛ
ⲙⲡⲕⲟⲙⲉⲍ	ⲙ|ⲡ|ⲕⲟⲙⲉⲥ
ⲉⲧⲣⲉⲩϣⲱⲡⲉ	ⲉ|ⲧⲣⲉ|ⲩ|ϣⲱⲡⲉ
ⲧⲁⲃⲱⲕ	ⲧⲁ|ⲃⲱⲕ
ⲛϩⲉⲗⲗⲏⲛ	ⲛ|ϩⲉⲗⲗⲏⲛ
ⲡⲁϣⲏⲣⲉ	ⲡⲁ|ϣⲏⲣⲉ
ⲛⲧⲉⲡⲉⲑⲃⲃⲓⲟ	ⲛⲧⲉ|ⲡⲉ|ⲑⲃⲃⲓⲟ
ⲛϭⲓⲧⲡⲁⲣⲑⲉⲛⲟⲥ	ⲛϭⲓ|ⲧ|ⲡⲁⲣⲑⲉⲛⲟⲥ
ⲉⲧⲣⲉⲡⲟⲩⲁ	ⲉ|ⲧⲣⲉ|ⲡ|ⲟⲩⲁ
ⲙⲡⲣϥⲓⲣⲟⲟⲩϣ	ⲙⲡⲣ|ϥⲓ|ⲣⲟⲟⲩϣ
ⲙⲁⲣⲉϥⲛⲟⲓ	ⲙⲁⲣⲉ|ϥ|ⲛⲟⲓ
ⲙⲛⲉⲗⲓⲥⲁⲃⲉⲧ	ⲙⲛ|ⲉⲗⲓⲥⲁⲃⲉⲧ
ⲛⲧⲁⲧⲉⲧⲛⲙⲟⲛⲕⲟⲩ	ⲛⲧ|ⲁ|ⲧⲉⲧⲛ|ⲙⲟⲛⲕ|ⲟⲩ
ϫⲉⲁϥϣⲡ	ϫⲉ|ⲁ|ϥ|ϣⲡ
ⲡⲉϩⲣⲟⲟⲩ	ⲡⲉ|ϩⲣⲟⲟⲩ
ⲕⲛⲁϭⲙϭⲟⲙ	ⲕ|ⲛⲁ|ϭⲙϭⲟⲙ
ⲛⲛⲇⲁⲓⲙⲱⲛ	ⲛ|ⲛ|ⲇⲁⲓⲙⲱⲛ
ⲙ̅ⲙⲟⲟⲩ	ⲙ|ⲙⲟⲟⲩ
ⲛⲉⲧⲛⲁϣϭⲙϭⲟⲙ	ⲛ|ⲉⲧ|ⲛⲁ|ϣ|ϭⲙϭⲟⲙ
ϯⲛⲁϫⲉⲩⲡⲁⲁⲅⲅⲉⲗⲟⲥ	ϯ|ⲛⲁ|ϫⲉⲩ|ⲡⲁ|ⲁⲅⲅⲉⲗⲟⲥ
ⲛⲁϣⲃⲱⲕ	ⲛ|ⲁϣ|ⲃⲱⲕ
ϫⲉⲡⲕⲉⲧⲏⲩ	ϫⲉ|ⲡ|ⲕⲉ|ⲧⲏⲩ
ϫⲉϩⲁⲙⲏⲛ	ϫⲉ|ϩⲁⲙⲏⲛ
ⲛⲉϥϩⲙϩⲁⲗ	ⲛⲉ|ϥ|ϩⲙϩⲁⲗ
ⲛⲟⲩϣⲏⲣⲉ	ⲛ|ⲟⲩ|ϣⲏⲣⲉ
ⲉⲩⲛⲁϫⲓϩⲱⲃ	ⲉ|ⲩ|ⲛⲁ|ϫⲓ|ϩⲱⲃ
ⲉⲡϫⲟⲉⲓ	ⲉ|ⲡ|ϫⲟⲉⲓ
ϩⲛⲛⲉⲕⲡⲉⲧⲟⲩⲁⲁⲃ	ϩⲛ|ⲛⲉⲕ|ⲡ|ⲉⲧ|ⲟⲩⲁⲁⲃ
ⲛⲧⲉϫⲟⲟⲥ	ⲛ|ⲧⲉ|ϫⲟⲟ|ⲥ
ⲛⲥⲉⲧⲁⲁⲩ	ⲛ|ⲥⲉ|ⲧⲁⲁ|ⲩ
ⲥⲉϫⲓ	ⲥⲉ|ϫⲓ
ⲉⲧⲉⲓⲥⲙⲁⲏⲗ	ⲉⲧⲉ|ⲓⲥⲙⲁⲏⲗ
ⲛⲧⲁⲩⲡⲱϣ	ⲛⲧ|ⲁ|ⲩ|ⲡⲱϣ
ⲉⲩϩⲓⲟⲩⲉ	ⲉ|ⲩ|ϩⲓⲟⲩⲉ
ϩⲙⲡⲉⲩⲁⲅⲅⲉⲗⲓⲟⲛ	ϩⲙ|ⲡ|ⲉⲩⲁⲅⲅⲉⲗⲓⲟⲛ
ⲉⲡⲁⲣⲁⲇⲓⲇⲟⲩ	ⲉ|ⲡⲁⲣⲁⲇⲓⲇⲟⲩ
ⲉⲛⲉⲡⲛⲉⲩⲙⲁ	ⲉ|ⲛⲉ|ⲡⲛⲉⲩⲙⲁ
[.....]ⲩⲟ	[.....]ⲩⲟ
ⲉⲧⲉϩⲙⲛⲇⲓⲕⲁⲓⲟⲥ	ⲉⲧⲉ|ϩⲙ|ⲛ|ⲇⲓⲕⲁⲓⲟⲥ
ⲛϥⲕⲁⲧⲉϥⲥϩⲓⲙⲉ	ⲛ|ϥ|ⲕⲁ|ⲧⲉϥ|ⲥϩⲓⲙⲉ
ⲛⲧⲙⲏⲧⲉ	ⲛ|ⲧ|ⲙⲏⲧⲉ
ⲛⲟⲩⲱⲧ	ⲛ|ⲟⲩⲱⲧ
ⲛⲉⲩⲑⲗⲓⲃⲉ	ⲛⲉ|ⲩ|ⲑⲗⲓⲃⲉ
ⲉⲧⲙⲙⲁⲩ	ⲉⲧ|ⲙⲙⲁⲩ
ⲉⲓⲧⲁ	ⲉⲓⲧⲁ
ϩⲛⲧϩⲟⲧⲉ	ϩⲛ|ⲧ|ϩⲟⲧⲉ
ϩⲙϫⲁⲓⲉ	ϩⲙ|ϫⲁⲓⲉ
ⲩ	ⲩ
ⲁϥⲑⲉⲣⲁⲡⲟⲩ	ⲁ|ϥ|ⲑⲉⲣⲁⲡⲟⲩ
ⲃⲱⲕ	ⲃⲱⲕ
ⲙⲡⲣⲧⲣⲉϥⲉⲓ	ⲙⲡⲣ|ⲧⲣⲉ|ϥ|ⲉⲓ
ⲉⲧⲉⲙⲛⲥⲃⲱ	ⲉⲧⲉ|ⲙⲛ|ⲥⲃⲱ
ⲡⲉⲛⲧⲁϥⲧⲥⲟ	ⲡ|ⲉⲛⲧ|ⲁ|ϥ|ⲧⲥⲟ
ⲥⲟⲛ	ⲥⲟⲛ
ⲙⲡϩⲱⲃ	ⲙ|ⲡ|ϩⲱⲃ
ⲉϩⲉⲛⲕⲉⲉⲥⲛⲉ	ⲉ|ϩⲉⲛ|ⲕⲉⲉⲥ|ⲛⲉ
ⲟϣⲉ	ⲟϣⲉ
ϩⲉⲛⲙⲁⲉⲓⲛ	ϩⲉⲛ|ⲙⲁⲉⲓⲛ
ⲛⲓⲟⲩⲇⲁⲥ	ⲛ|ⲓⲟⲩⲇⲁⲥ
ⲛⲙⲟⲩⲛⲟϭ	ⲛⲙ|ⲟⲩ|ⲛⲟϭ
ⲛϩⲟⲥⲟⲛ	ⲛ|ϩⲟⲥⲟⲛ
ⲙⲱⲅⲓⲥ	ⲙⲱⲅⲓⲥ
ⲟⲩⲁⲗⲉⲕⲧⲱⲣ	ⲟⲩ|ⲁⲗⲉⲕⲧⲱⲣ
ⲛⲉϣⲁⲩⲡⲟⲣϫⲛ	ⲛⲉ|ϣⲁ|ⲩ|ⲡⲟⲣϫ|ⲛ
ϫⲉⲡⲉⲧϣⲟⲩϣⲟⲩ	ϫⲉ|ⲡ|ⲉⲧ|ϣⲟⲩϣⲟⲩ
ⲛϭⲓⲡⲁⲡⲟⲥⲧⲟⲗⲟⲥ	ⲛϭⲓ|ⲡ|ⲁⲡⲟⲥⲧⲟⲗⲟⲥ
ⲙⲡⲉⲕⲣⲁⲛ	ⲙ|ⲡⲉⲕ|ⲣⲁⲛ
ⲉⲧⲕϩⲉⲗⲡⲓⲍⲉ	ⲉⲧ|ⲕ|ϩⲉⲗⲡⲓⲍⲉ
ϩⲛⲟⲩⲙϩⲁⲟⲩ	ϩⲛ|ⲟⲩ|ⲙϩⲁⲟⲩ
ⲙⲛϩⲉⲛⲣⲓⲣ	ⲙⲛ|ϩⲉⲛ|ⲣⲓⲣ
ⲉⲣⲉⲓⲏⲥⲟⲩⲥ	ⲉⲣⲉ|ⲓⲏⲥⲟⲩⲥ
ϩⲙⲡⲏⲓ	ϩⲙ|ⲡ|ⲏⲓ
ⲙⲛⲛⲉⲫⲁⲣⲓⲥⲥⲁⲓⲟⲥ	ⲙⲛ|ⲛⲉ|ⲫⲁⲣⲓⲥⲥⲁⲓⲟⲥ
ⲛϩⲁⲧⲏⲩ	ⲛ|ϩⲁⲧⲏⲩ
ⲛϩⲁⲁⲩ	ⲛ|ϩⲁⲁⲩ
ⲧⲁϩⲁϩ	ⲧⲁ|ϩⲁϩ
ⲛϭⲓⲟⲩⲛⲟϭ	ⲛϭⲓ|ⲟⲩ|ⲛⲟϭ
ⲛⲉⲡⲓⲥⲧⲟⲗⲏ	ⲛ|ⲉⲡⲓⲥⲧⲟⲗⲏ
ⲉⲧⲃⲉⲡⲣⲁⲛ	ⲉⲧⲃⲉ|ⲡ|ⲣⲁⲛ
ⲥⲉϫⲱⲙⲙⲟⲥ	ⲥⲉ|ϫⲱ|ⲙⲙⲟ|ⲥ
ⲛϣⲱⲛⲉ	ⲛ|ϣⲱⲛⲉ
ⲙⲡⲉⲕϭⲗⲟϭ	ⲙ|ⲡⲉⲕ|ϭⲗⲟϭ
ϩⲛⲟⲩⲥⲟⲫⲓⲁ	ϩⲛ|ⲟⲩ|ⲥⲟⲫⲓⲁ
ⲉⲓⲣϩⲟⲧⲉ	ⲉ|ⲓ|ⲣϩⲟⲧⲉ
ⲁϥⲧⲃⲃⲟ	ⲁ|ϥ|ⲧⲃⲃⲟ
ⲙⲛⲛⲉⲩϣⲏⲣⲉ	ⲙⲛ|ⲛⲉⲩ|ϣⲏⲣⲉ
ⲁⲕⲙⲉϩ	ⲁ|ⲕ|ⲙⲉϩ
ⲛⲧⲁⲩⲑⲙⲕⲟⲥ	ⲛⲧ|ⲁ|ⲩ|ⲑⲙⲕⲟ|ⲥ
ⲟⲩⲛⲧⲉ	ⲟⲩⲛⲧⲉ
ⲉⲧⲣⲉⲡⲛⲟⲩⲧⲉ	ⲉ|ⲧⲣⲉ|ⲡ|ⲛⲟⲩⲧⲉ
ⲛϣⲃⲛⲛⲉ	ⲛ|ϣⲃⲛⲛⲉ
ⲉⲧⲁⲁⲩ	ⲉ|ⲧⲁⲁ|ⲩ
ⲁⲩⲡⲉϩⲛⲉⲩϩⲟⲉⲓⲧⲉ	ⲁ|ⲩ|ⲡⲉϩ|ⲛⲉⲩ|ϩⲟⲉⲓⲧⲉ
ⲁⲩⲧⲁⲁϥ	ⲁ|ⲩ|ⲧⲁⲁ|ϥ
ⲉⲡⲉⲭⲣⲓⲥⲧⲟⲥ	ⲉ|ⲡⲉ|ⲭⲣⲓⲥⲧⲟⲥ
ⲉⲡⲏⲉⲓ	ⲉ|ⲡ|ⲏⲉⲓ
ⲙⲡⲣⲧⲣⲉϥⲕⲟⲧϥ	ⲙⲡⲣ|ⲧⲣⲉ|ϥ|ⲕⲟⲧ|ϥ
ⲁⲡⲁ	ⲁⲡⲁ
ⲙⲁ	ⲙⲁ
ⲛⲛⲉⲧϩⲟⲟⲩ	ⲛ|ⲛ|ⲉⲧ|ϩⲟⲟⲩ
ⲉⲧⲕⲑⲗⲓⲃⲉ	ⲉⲧ|ⲕ|ⲑⲗⲓⲃⲉ
ⲁⲥϭⲱϣⲧ	ⲁ|ⲥ|ϭⲱϣⲧ
ⲉϫⲛⲛⲉⲧⲣϩⲙⲙⲉ	ⲉϫⲛ|ⲛⲉⲧ|ⲣ|ϩⲙ|ⲙⲉ
ⲛⲧⲁⲩⲣⲁⲛⲁϥ	ⲛⲧ|ⲁ|ⲩ|ⲣ|ⲁⲛⲁϥ
ⲉⲧⲉⲧⲛⲛⲁⲉⲓ	ⲉ|ⲧⲉⲧⲛ|ⲛⲁ|ⲉⲓ
ⲛⲟⲩⲣⲧⲁⲃ	ⲛ|ⲟⲩ|ⲣⲧⲁⲃ
ϩⲛⲟⲩⲗⲟⲓϭⲉ	ϩⲛ|ⲟⲩ|ⲗⲟⲓϭⲉ
ⲙⲁⲩⲁⲧⲧⲏⲩⲧⲛ	ⲙⲁⲩⲁⲧ|ⲧⲏⲩⲧⲛ
ⲛⲉⲩϣⲏϣ	ⲛⲉ|ⲩ|ϣⲏϣ
ⲛⲉⲩⲥⲱⲧⲙ	ⲛⲉ|ⲩ|ⲥⲱⲧⲙ
ϩⲙⲡⲡⲁⲣⲁⲇⲉⲓⲥⲟⲥ	ϩⲙ|ⲡ|ⲡⲁⲣⲁⲇⲉⲓⲥⲟⲥ
ⲡⲉⲕⲗⲏⲣⲟⲛⲟⲙⲟⲥ	ⲡⲉ|ⲕⲗⲏⲣⲟⲛⲟⲙⲟⲥ
ⲛⲥⲁⲛⲣⲱⲙⲉ	ⲛⲥⲁ|ⲛ|ⲣⲱⲙⲉ
ⲉⲧⲣⲉⲩ[....]ⲥⲧⲁ	ⲉ|ⲧⲣⲉ|ⲩ|[....]ⲥⲧⲁ
ⲡⲟⲛⲏⲣⲟⲥ	ⲡⲟⲛⲏⲣⲟⲥ
ϩⲓⲱⲱϥ	ϩⲓⲱⲱ|ϥ
ⲛⲧⲁⲉⲓⲟ	ⲛ|ⲧⲁⲉⲓⲟ
ⲉⲛⲉⲟⲩⲛⲉⲡⲓⲥⲧⲏⲙⲏ	ⲉⲛⲉ|ⲟⲩⲛ|ⲉⲡⲓⲥⲧⲏⲙⲏ
ϩⲙⲡⲙⲏⲏϣⲉ	ϩⲙ|ⲡ|ⲙⲏⲏϣⲉ
ⲛⲉⲓⲱⲧ	ⲛ|ⲉⲓⲱⲧ
ⲉⲛⲟⲩϩⲃⲏⲩⲉ	ⲉ|ⲛⲟⲩ|ϩⲃⲏⲩⲉ
ⲉϫⲟⲟⲥ	ⲉ|ϫⲟⲟ|ⲥ
ⲙⲛϭⲟⲙ	ⲙⲛ|ϭⲟⲙ
ⲛϭⲓⲛⲉⲥⲛⲏⲩ	ⲛϭⲓ|ⲛⲉ|ⲥⲛⲏⲩ
ⲁⲩⲛⲉϭⲛⲟⲩϭϥ	ⲁ|ⲩ|ⲛⲉϭⲛⲟⲩϭ|ϥ
ⲧⲛϭⲟⲟⲃ	ⲧⲛ|ϭⲟⲟⲃ
ⲙⲡⲟⲩⲉⲓⲱⲧ	ⲙ|ⲡⲟⲩ|ⲉⲓⲱⲧ
ϩⲙⲛⲕⲁⲣⲡⲟⲥ	ϩⲙ|ⲛ|ⲕⲁⲣⲡⲟⲥ
ϩⲛⲟⲩ	ϩⲛ|ⲟⲩ
ⲉⲩϩⲟⲥⲉ	ⲉ|ⲩ|ϩⲟⲥⲉ
ⲉⲡⲱⲛⲉ	ⲉ|ⲡ|ⲱⲛⲉ
ϫⲉⲙⲡⲟⲩⲡⲓⲥⲧⲉⲩⲉ	ϫⲉ|ⲙⲡ|ⲟⲩ|ⲡⲓⲥⲧⲉⲩⲉ
ϫⲉⲉⲩⲣⲟⲩ	ϫⲉ|ⲉ|ⲩ|ⲣ|ⲟⲩ
ϩⲛⲟⲩϭⲉⲣⲱⲃ	ϩⲛ|ⲟⲩ|ϭⲉⲣⲱⲃ
ϯⲛⲏⲩ	ϯ|ⲛⲏⲩ
ⲉⲧⲙⲧⲣⲉⲩⲥⲱⲧ	ⲉ|ⲧⲙ|ⲧⲣⲉ|ⲩ|ⲥⲱⲧ
ⲙⲁⲣⲉ	ⲙⲁⲣⲉ
ⲉⲡⲗⲁⲛⲁ	ⲉ|ⲡⲗⲁⲛⲁ
ⲉⲩϩⲱⲃ	ⲉ|ⲩ|ϩⲱⲃ
ⲥⲁϩⲛⲉ	ⲥⲁϩⲛⲉ
ⲉⲁⲡⲣⲏϣⲁ	ⲉ|ⲁ|ⲡ|ⲣⲏ|ϣⲁ
ⲧⲉⲭⲁⲣⲓⲥ	ⲧⲉ|ⲭⲁⲣⲓⲥ
ⲛⲛⲉⲧⲛⲉⲓⲟⲧⲉ	ⲛ|ⲛⲉⲧⲛ|ⲉⲓⲟⲧⲉ
ⲡⲉⲧⲟⲩⲛⲁⲡⲁⲣⲁⲇⲓⲇⲟⲩ	ⲡ|ⲉⲧ|ⲟⲩ|ⲛⲁ|ⲡⲁⲣⲁⲇⲓⲇⲟⲩ
ⲙⲁⲣⲛϯⲥⲃⲱ	ⲙⲁⲣ|ⲛ|ϯ|ⲥⲃⲱ
ⲛϭⲓⲟⲩⲉⲓ	ⲛϭⲓ|ⲟⲩⲉⲓ
ⲛⲉⲧⲛⲁⲡⲓⲥⲧⲉⲩⲉ	ⲛ|ⲉⲧ|ⲛⲁ|ⲡⲓⲥⲧⲉⲩⲉ
ⲉⲧϫⲟⲡϫⲡ	ⲉⲧ|ϫⲟⲡϫⲡ
ⲁⲩⲙⲟⲟϣⲉ	ⲁ|ⲩ|ⲙⲟⲟϣⲉ
ϣⲁϫⲉ	ϣⲁϫⲉ
ⲉϯϩⲏⲩ	ⲉ|ϯ|ϩⲏⲩ
ⲙⲙⲁⲓⲛⲟⲩⲧⲉ	ⲙ|ⲙⲁⲓⲛⲟⲩⲧⲉ
ⲉϣⲗⲏⲗ	ⲉ|ϣⲗⲏⲗ
ⲧⲏⲣⲟⲩ	ⲧⲏⲣ|ⲟⲩ
ⲙⲛⲡⲉⲕⲣⲟ	ⲙⲛ|ⲡⲉ|ⲕⲣⲟ
ϫⲉⲧϣⲟⲣⲡ	ϫⲉ|ⲧ|ϣⲟⲣⲡ
ⲉⲧⲉ	ⲉⲧⲉ
ⲙⲛⲛⲥⲁⲛⲁⲓ	ⲙⲛⲛⲥⲁ|ⲛⲁⲓ
ⲛⲛⲟⲩⲧⲉ	ⲛ|ⲛⲟⲩⲧⲉ
ϩⲓⲧⲙⲡⲟⲩⲱϣ	ϩⲓⲧⲙ|ⲡ|ⲟⲩⲱϣ
ⲙⲛⲧⲙⲁⲁⲩ	ⲙⲛ|ⲧ|ⲙⲁⲁⲩ
ϫⲓⲥⲉ	ϫⲓⲥⲉ
ⲟⲩⲁϩⲧⲏⲩⲧⲛ	ⲟⲩⲁϩ|ⲧⲏⲩⲧⲛ
ⲛⲕⲉⲁⲣⲭⲓⲉⲣⲉⲩⲥ	ⲛ|ⲕⲉ|ⲁⲣⲭⲓⲉⲣⲉⲩⲥ
ϫⲉⲁϥⲣⲟⲩⲱ	ϫⲉ|ⲁ|ϥ|ⲣⲟⲩⲱ
ϫⲉⲟⲩⲛⲧⲏⲧⲛ	ϫⲉ|ⲟⲩⲛⲧⲏ|ⲧⲛ
ⲧϣⲱⲙⲉ	ⲧ|ϣⲱⲙⲉ
ⲛⲣⲉϥϭⲉⲡⲣⲱⲙⲉ	ⲛ|ⲣⲉϥϭⲉⲡⲣⲱⲙⲉ
ⲉⲩⲥⲁϩⲟⲩ	ⲉ|ⲩ|ⲥⲁϩⲟⲩ
ⲉⲕⲧⲣⲉϩⲉⲛⲕⲟⲟⲩⲉ	ⲉ|ⲕ|ⲧⲣⲉ|ϩⲉⲛ|ⲕⲟⲟⲩⲉ
ϫⲉⲙⲡⲣⲧⲣⲉ[..]ⲁⲩϣⲓⲛⲉ	ϫⲉ|ⲙⲡⲣ|ⲧⲣⲉ|[..]ⲁⲩ|ϣⲓⲛⲉ
ⲁⲩⲁⲣⲭⲉⲓ	ⲁ|ⲩ|ⲁⲣⲭⲉⲓ
ⲛⲛⲉⲩⲧⲃⲛⲟⲟⲩⲉ	ⲛ|ⲛⲉⲩ|ⲧⲃⲛⲟⲟⲩⲉ
ⲉⲩϣⲁⲛⲧⲱⲟⲩⲛ	ⲉ|ⲩ|ϣⲁⲛ|ⲧⲱⲟⲩⲛ
ⲉⲩϩⲱⲃⲥ	ⲉ|ⲩ|ϩⲱⲃⲥ
ϩⲓϫⲛⲡⲕⲁϩ	ϩⲓϫⲛ|ⲡ|ⲕⲁϩ
ⲉⲥⲥⲟⲃⲕ	ⲉ|ⲥ|ⲥⲟⲃⲕ
ⲛϥⲕⲧⲟ	ⲛ|ϥ|ⲕⲧⲟ
ⲙⲁⲣⲉϥϣⲱⲡⲉ	ⲙⲁⲣⲉ|ϥ|ϣⲱⲡⲉ
ⲛϩⲟⲟⲩⲧ	ⲛ|ϩⲟⲟⲩⲧ
ⲙⲛⲟⲩⲙⲟⲩⲥ	ⲙⲛ|ⲟⲩ|ⲙⲟⲩⲥ
ⲧⲁⲟⲩⲱⲙ	ⲧⲁ|ⲟⲩⲱⲙ
ⲡⲁϣⲁϫⲉ	ⲡⲁ|ϣⲁϫⲉ
ⲛⲧⲕⲟⲩⲉⲃⲟⲗ	ⲛⲧ|ⲕ|ⲟⲩ|ⲉⲃⲟⲗ
ϫⲉϯⲛⲁⲃⲱⲕ	ϫⲉ|ϯ|ⲛⲁ|ⲃⲱⲕ
ϩⲓϭⲟⲙ	ϩⲓ|ϭⲟⲙ
ϩⲓⲱⲱⲥ	ϩⲓⲱⲱ|ⲥ
ϫⲉⲉⲩⲉϣⲱⲡⲉ	ϫⲉ|ⲉⲩⲉ|ϣⲱⲡⲉ
ⲡⲉⲛⲧⲁⲩⲥⲧⲁⲩⲣⲟⲩ	ⲡ|ⲉⲛⲧ|ⲁ|ⲩ|ⲥⲧⲁⲩⲣⲟⲩ
ⲁϥⲙⲉⲧⲁⲛⲟⲓ	ⲁ|ϥ|ⲙⲉⲧⲁⲛⲟⲓ
ⲉⲩⲟⲃϣ	ⲉ|ⲩ|ⲟⲃϣ
ⲉⲡⲉⲕϩⲏⲧ	ⲉ|ⲡⲉⲕ|ϩⲏⲧ
ⲉⲛⲁⲩ	ⲉ|ⲛⲁⲩ
ϩⲓⲧϩⲏ	ϩⲓ|ⲧ|ϩⲏ
ϫⲉⲁⲛⲅⲟⲩⲥⲟⲫⲟⲥ	ϫⲉ|ⲁⲛⲅ|ⲟⲩ|ⲥⲟⲫⲟⲥ
ⲁϫⲛⲧⲓ	ⲁϫⲛ|ϯ
ϩⲉⲛⲙⲉ	ϩⲉⲛ|ⲙⲉ
ⲛⲧⲉⲣⲉϥϩⲱⲛ	ⲛⲧⲉⲣⲉ|ϥ|ϩⲱⲛ
ⲉⲧⲟⲩⲏϩ	ⲉⲧ|ⲟⲩⲏϩ
ϫⲉϭⲱϣⲧ	ϫⲉ|ϭⲱϣⲧ
ⲙⲛⲥⲁⲗⲱⲙⲏ	ⲙⲛ|ⲥⲁⲗⲱⲙⲏ
ⲛϫⲱⲕ	ⲛ|ϫⲱ|ⲕ
ϩⲓⲛⲟⲉⲓⲕ	ϩⲓ|ⲛ|ⲟⲉⲓⲕ
ⲛⲛⲁⲟⲩⲉⲣⲏⲧⲉ	ⲛ|ⲛⲁ|ⲟⲩⲉⲣⲏⲧⲉ
ⲉⲛⲛⲉϥϣⲱⲡⲉ	ⲉⲛⲛⲉ|ϥ|ϣⲱⲡⲉ
ⲉⲩϣⲓⲛⲉ	ⲉ|ⲩ|ϣⲓⲛⲉ
ⲧⲛⲕⲏⲕⲁϩⲏⲩ	ⲧⲛ|ⲕⲏⲕ|ⲁϩⲏⲩ
ⲕϫⲱ	ⲕ|ϫⲱ
ⲙⲡⲉⲓⲁⲓⲱⲛ	ⲙ|ⲡⲉⲓ|ⲁⲓⲱⲛ
ⲉⲡⲁϩⲧ	ⲉ|ⲡⲁϩⲧ
ⲕⲁⲕⲱⲥ	ⲕⲁⲕⲱⲥ
ϩⲟⲗϭ	ϩⲟⲗϭ
ϩⲓⲣⲱϥ	ϩⲓ|ⲣⲱ|ϥ
ⲉⲣⲉⲙⲟⲩⲧⲉ	ⲉⲣⲉ|ⲙⲟⲩⲧⲉ
ⲛϥⲧⲱⲣⲡ	ⲛ|ϥ|ⲧⲱⲣⲡ
ϩⲁⲧⲉϩⲏ	ϩⲁ|ⲧⲉ|ϩⲏ
ϩⲛϩⲉⲛⲙⲛⲧⲥⲟϭ	ϩⲛ|ϩⲉⲛ|ⲙⲛⲧⲥⲟϭ
ⲧⲏⲣϥ	ⲧⲏⲣ|ϥ
ⲉⲁⲛⲉⲭⲉ	ⲉ|ⲁⲛⲉⲭⲉ
ⲛⲧⲉⲑⲁⲗⲁⲥⲥⲁ	ⲛ|ⲧⲉ|ⲑⲁⲗⲁⲥⲥⲁ
ⲉϥⲧⲛⲧⲱⲛ	ⲉ|ϥ|ⲧⲛⲧⲱⲛ
ϩⲛⲟⲩⲛⲟϭ	ϩⲛ|ⲟⲩ|ⲛⲟϭ
ϫⲉⲁⲧⲥⲱⲛⲉ	ϫⲉ|ⲁ|ⲧ|ⲥⲱⲛⲉ
ⲛⲉⲫⲁⲣⲓⲥⲥⲁⲓⲟⲥ	ⲛⲉ|ⲫⲁⲣⲓⲥⲥⲁⲓⲟⲥ
ⲛⲛⲉⲡⲣⲟⲫⲏⲧⲏⲥ	ⲛ|ⲛⲉ|ⲡⲣⲟⲫⲏⲧⲏⲥ
ϩⲱⲱⲛ	ϩⲱⲱ|ⲛ
ⲛⲥⲙⲟⲧ	ⲛ|ⲥⲙⲟⲧ
ⲛⲧⲉⲛⲧⲟⲗⲏ	ⲛ|ⲧ|ⲉⲛⲧⲟⲗⲏ
ⲛⲛⲉⲫⲁⲣⲓⲥⲥⲁⲓⲟⲥ	ⲛ|ⲛⲉ|ⲫⲁⲣⲓⲥⲥⲁⲓⲟⲥ
ϥⲛⲁϫⲉⲩ	ϥ|ⲛⲁ|ϫⲉⲩ
ⲗⲱⲕ	ⲗⲱⲕ
ⲛⲁⲛⲟⲩ	ⲛⲁⲛⲟⲩ
ⲛⲥⲁⲡⲉⲧⲣⲟⲥ	ⲛⲥⲁ|ⲡⲉⲧⲣⲟⲥ
ⲛⲉⲥⲥⲙⲟⲛⲧ	ⲛⲉ|ⲥ|ⲥⲙⲟⲛⲧ
ⲛⲛⲉⲩϣⲧⲟⲣⲧⲣ	ⲛⲛⲉ|ⲩ|ϣⲧⲟⲣⲧⲣ
ⲉⲁⲥϫⲟⲟⲥ	ⲉ|ⲁ|ⲥ|ϫⲟⲟ|ⲥ
ⲛⲉϥⲙⲁⲑⲏⲧⲏⲥ	ⲛⲉϥ|ⲙⲁⲑⲏⲧⲏⲥ
ⲉⲛⲉⲭⲏⲣⲁ	ⲉ|ⲛⲉ|ⲭⲏⲣⲁ
ϩⲛⲧⲉⲥⲙⲛⲧϩⲗⲗⲱ	ϩⲛ|ⲧⲉⲥ|ⲙⲛⲧϩⲗⲗⲱ
ⲉⲓⲟⲩⲏϩ	ⲉ|ⲓ|ⲟⲩⲏϩ
ⲉⲧⲣⲉⲩⲁⲛⲁⲕⲣⲓⲛⲉ	ⲉ|ⲧⲣⲉ|ⲩ|ⲁⲛⲁⲕⲣⲓⲛⲉ
ⲣⲁⲧ	ⲣⲁⲧ
ⲡⲁⲡⲛⲟⲩⲧⲉ	ⲡⲁⲡⲛⲟⲩⲧⲉ
ⲛⲛⲉⲧⲙⲟⲥⲧⲉ	ⲛ|ⲛ|ⲉⲧ|ⲙⲟⲥⲧⲉ
ⲁⲥϫⲟⲟⲥ	ⲁ|ⲥ|ϫⲟⲟ|ⲥ
ϩⲛⲧⲁⲛⲁⲥⲧⲁⲥⲓⲥ	ϩⲛ|ⲧ|ⲁⲛⲁⲥⲧⲁⲥⲓⲥ
ϫⲉϩⲙⲡϣⲁ	ϫⲉ|ϩⲙ|ⲡ|ϣⲁ
ϩⲛⲧⲉⲭⲱⲣⲁ	ϩⲛ|ⲧⲉ|ⲭⲱⲣⲁ
ⲙⲡⲁⲧⲓϫⲟⲟⲩⲥⲟⲩ	ⲙⲡⲁⲧ|ⲓ|ϫⲟⲟⲩ|ⲥⲟⲩ
ⲛⲧⲉⲣⲟⲩⲉⲓ	ⲛⲧⲉⲣ|ⲟⲩ|ⲉⲓ
ϫⲉⲧⲁⲣeⲣⲟⲩ	ϫⲉ|ⲧⲁⲣe|ⲣ|ⲟⲩ
ⲡⲉⲧⲛⲁⲟⲩϫⲁⲉⲓ	ⲡ|ⲉⲧ|ⲛⲁ|ⲟⲩϫⲁⲉⲓ
ⲛⲛⲉⲧⲉⲓⲣⲉ	ⲛ|ⲛ|ⲉⲧ|ⲉⲓⲣⲉ
ⲛⲛⲓⲁⲧⲥⲃⲱ	ⲛ|ⲛⲓ|ⲁⲧⲥⲃⲱ
ⲙⲛ	ⲙⲛ
ⲛⲧⲁⲡⲟⲫⲁⲥⲓⲥ	ⲛ|ⲧ|ⲁⲡⲟⲫⲁⲥⲓⲥ
ⲙⲛⲛⲕⲉϩⲃⲏⲩⲉ	ⲙⲛ|ⲛ|ⲕⲉ|ϩⲃⲏⲩⲉ
ⲙⲉⲛⲡⲉ	ⲙⲉⲛ|ⲡⲉ
ⲉⲛⲱⲭⲗⲉⲓ	ⲉⲛⲱⲭⲗⲉⲓ
ⲛϥϫⲓⲟⲩⲉ	ⲛ|ϥ|ϫⲓ|ⲟⲩⲉ
ⲙⲛⲛⲟⲩϯⲧⲱⲛ	ⲙⲛ|ⲛⲟⲩ|ϯ|ⲧⲱⲛ
ⲛⲧⲁⲥⲁⲑⲉⲧⲓ	ⲛ|ⲧⲁ|ⲥ|ⲁⲑⲉⲧⲓ
ⲙⲡⲉⲛⲡⲁⲥⲭⲁ	ⲙ|ⲡⲉⲛ|ⲡⲁⲥⲭⲁ
ⲉⲛϣⲁⲛⲟⲩⲁ	ⲉⲛϣⲁⲛ|ⲟⲩⲁ
ⲉⲓⲕⲣⲓⲛⲉ	ⲉ|ⲓ|ⲕⲣⲓⲛⲉ
ⲛⲉⲣⲉⲡϫⲟⲉⲓ	ⲛⲉⲣⲉ|ⲡ|ϫⲟⲉⲓ
ⲛⲧⲁⲩϫⲱⲕ	ⲛⲧ|ⲁ|ⲩ|ϫⲱⲕ
ⲥⲟⲧⲙⲟⲩ	ⲥⲟⲧⲙ|ⲟⲩ
ⲉϥⲛⲁⲃⲱⲕ	ⲉ|ϥ|ⲛⲁ|ⲃⲱⲕ
ⲙⲙⲛⲟⲩⲟⲛ	ⲙⲙⲛ|ⲟⲩⲟⲛ
ⲛⲟⲩⲕⲁϩ	ⲛ|ⲟⲩ|ⲕⲁϩ
ⲙⲛⲛϣⲁϫⲉ	ⲙⲛ|ⲛ|ϣⲁϫⲉ
ⲉⲧⲱⲛ	ⲉ|ⲧⲱⲛ
ⲟⲩⲇⲉ	ⲟⲩⲇⲉ
ⲉⲧⲉⲩⲡⲓⲥⲧⲓⲥ	ⲉ|ⲧⲉⲩ|ⲡⲓⲥⲧⲓⲥ
ⲛϭⲓⲛⲉⲧⲧⲏⲕ	ⲛϭⲓ|ⲛ|ⲉⲧ|ⲧⲏⲕ
ⲣⲟⲩ	ⲣ|ⲟⲩ
ⲛⲥⲱⲟⲩ	ⲛⲥⲱ|ⲟⲩ
ϩⲓⲙⲛⲧⲥⲧⲙⲏⲧ	ϩⲓ|ⲙⲛⲧⲥⲧⲙⲏⲧ
ϫⲓⲛⲧⲅⲁⲗⲓⲗⲁⲓⲁ	ϫⲓⲛ|ⲧ|ⲅⲁⲗⲓⲗⲁⲓⲁ
ϫⲉⲉⲓⲥϩⲏⲏⲧⲉ	ϫⲉ|ⲉⲓⲥ|ϩⲏⲏⲧⲉ
ϩⲓϫⲛⲛⲉⲕⲉⲩⲣⲓⲡⲟⲥ	ϩⲓϫⲛ|ⲛⲉⲕ|ⲉⲩⲣⲓⲡⲟⲥ
ϩⲛⲟⲩϫⲱϩⲙ	ϩⲛ|ⲟⲩ|ϫⲱϩⲙ
ⲕⲧⲣⲉⲛⲉⲕⲙⲁⲅⲉⲓⲣⲟⲥ	ⲕ|ⲧⲣⲉ|ⲛⲉⲕ|ⲙⲁⲅⲉⲓⲣⲟⲥ
ⲛⲧⲉⲧⲛϩⲉⲛⲣⲱⲙⲉ	ⲛⲧⲉⲧⲛ|ϩⲉⲛ|ⲣⲱⲙⲉ
ⲉⲛⲉⲓⲣⲉ	ⲉ|ⲛ|ⲉⲓⲣⲉ
ⲛⲧⲧⲁⲁϥ	ⲛⲧ|ⲧⲁⲁ|ϥ
ⲉⲙⲡⲏⲩⲉ	ⲉ|ⲙ|ⲡⲏⲩⲉ
ⲡϩⲉⲣⲙⲁⲛ	ⲡ|ϩⲉⲣⲙⲁⲛ
ϣⲟⲣⲡ	ϣⲟⲣⲡ
ⲁϥⲙⲟⲩ	ⲁ|ϥ|ⲙⲟⲩ
ⲁⲩϫⲓⲡⲟⲩⲱ	ⲁ|ⲩ|ϫⲓ|ⲡ|ⲟⲩⲱ
ⲙⲛⲡⲁⲡⲛⲉⲩⲙⲁ	ⲙⲛ|ⲡⲁ|ⲡⲛⲉⲩⲙⲁ
ⲉⲁϥⲕⲱⲧⲉ	ⲉ|ⲁ|ϥ|ⲕⲱⲧⲉ
ϥⲛⲁⲡⲁⲣⲁⲇⲓⲇⲟⲩ	ϥ|ⲛⲁ|ⲡⲁⲣⲁⲇⲓⲇⲟⲩ
ϫⲉⲡⲱⲛⲉ	ϫⲉ|ⲡ|ⲱⲛⲉ
ⲉⲧⲉⲙⲡⲕⲟⲥⲙⲟⲥ	ⲉⲧⲉ|ⲙ|ⲡ|ⲕⲟⲥⲙⲟⲥ
ⲧⲉⲧⲙⲙⲁⲩ	ⲧ|ⲉⲧ|ⲙⲙⲁⲩ
ⲉⲧⲉⲙⲡⲉⲗⲁⲁⲩ	ⲉⲧⲉ|ⲙⲡⲉ|ⲗⲁⲁⲩ
ⲉⲩⲛⲁⲣϫⲟⲩⲱⲧ	ⲉ|ⲩ|ⲛⲁ|ⲣϫⲟⲩⲱⲧ
ⲙⲡⲉⲗⲁⲁⲩ	ⲙⲡⲉ|ⲗⲁⲁⲩ
ⲉⲕϭⲱⲗⲡ	ⲉ|ⲕ|ϭⲱⲗⲡ
ϫⲉⲙⲛϣϭⲟⲙ	ϫⲉ|ⲙⲛ|ϣϭⲟⲙ
ⲉⲧⲉⲡⲛⲟⲩⲧⲉ	ⲉⲧⲉ|ⲡ|ⲛⲟⲩⲧⲉ
ⲡⲱⲛ	ⲡⲱⲛ
ⲁⲩⲕⲁⲛⲉⲩϣⲛⲏⲩ	ⲁ|ⲩ|ⲕⲁ|ⲛⲉⲩ|ϣⲛⲏⲩ
ⲉϥⲡⲓⲑⲉ	ⲉ|ϥ|ⲡⲓⲑⲉ
ϣⲁⲛⲧⲉϥⲕⲁⲡⲙⲏⲏϣⲉ	ϣⲁⲛⲧⲉ|ϥ|ⲕⲁ|ⲡ|ⲙⲏⲏϣⲉ
ⲁⲫⲑⲟⲛⲓⲁ	ⲁⲫⲑⲟⲛⲓⲁ
ⲉϥⲟⲩⲱϣ	ⲉ|ϥ|ⲟⲩⲱϣ
ⲡⲏⲣⲁ	ⲡⲏⲣⲁ
ϫⲉⲡⲉⲧⲙⲓϣⲉ	ϫⲉ|ⲡ|ⲉⲧ|ⲙⲓϣⲉ
ⲕⲉⲟⲩⲁ	ⲕⲉ|ⲟⲩⲁ
ⲙⲁⲣⲉϥⲉⲓ	ⲙⲁⲣⲉ|ϥ|ⲉⲓ
ⲉⲡϫⲓⲛϫⲏ	ⲉ|ⲡ|ϫⲓⲛϫⲏ
ⲁϥϯⲡⲉϥⲟⲩⲟⲉⲓ	ⲁ|ϥ|ϯ|ⲡⲉϥ|ⲟⲩⲟⲉⲓ
ⲉϥϫⲟ	ⲉ|ϥ|ϫⲟ
ϫⲉⲁⲓⲧⲛⲛⲟⲟⲩ	ϫⲉ|ⲁ|ⲓ|ⲧⲛⲛⲟ|ⲟⲩ
ϫⲉⲛⲧⲕⲛⲓⲙ	ϫⲉ|ⲛⲧⲕ|ⲛⲓⲙ
ⲛϭⲓⲃⲁⲥⲓⲙⲟⲥ	ⲛϭⲓ|ⲃⲁⲥⲓⲙⲟⲥ
ⲉⲧⲡⲁⲣⲁⲃⲟⲗⲏ	ⲉ|ⲧ|ⲡⲁⲣⲁⲃⲟⲗⲏ
ϥⲛⲁⲧⲥⲁⲃⲱⲧⲛ	ϥ|ⲛⲁ|ⲧⲥⲁⲃⲱ|ⲧⲛ
ⲉⲗⲱⲉⲓ	ⲉⲗⲱⲉⲓ
ϩⲓⲡⲉⲕⲣⲟ	ϩⲓ|ⲡⲉ|ⲕⲣⲟ
ⲉⲧⲉϥⲉⲕⲕⲗⲏⲥⲓⲁ	ⲉ|ⲧⲉϥ|ⲉⲕⲕⲗⲏⲥⲓⲁ
ⲁⲧⲛⲟⲩⲧⲉ	ⲁⲧⲛⲟⲩⲧⲉ
ⲥⲟⲫⲓⲁ	ⲥⲟⲫⲓⲁ
ϩⲕⲁⲉⲓⲧ	ϩⲕⲁⲉⲓⲧ
ⲁⲩⲉⲓⲛⲉ	ⲁ|ⲩ|ⲉⲓⲛⲉ
ⲛϩⲛⲁⲁⲩ	ⲛ|ϩⲛⲁⲁⲩ
ϩⲛⲟⲩϩⲩⲡⲟⲕⲣⲓⲥⲓⲥ	ϩⲛ|ⲟⲩ|ϩⲩⲡⲟⲕⲣⲓⲥⲓⲥ
ⲉⲧⲡⲗⲁⲛⲁ	ⲉⲧ|ⲡⲗⲁⲛⲁ
ⲧⲱⲧ	ⲧⲱⲧ
ⲛⲥⲁⲃⲟⲗ	ⲛⲥⲁ|ⲃⲟⲗ
ⲉϥⲡⲁⲣⲁⲅⲉ	ⲉ|ϥ|ⲡⲁⲣⲁⲅⲉ
ϩⲙⲡⲉⲕⲏⲓ	ϩⲙ|ⲡⲉⲕ|ⲏⲓ
ⲉⲩⲙⲟⲩⲧⲉ	ⲉ|ⲩ|ⲙⲟⲩⲧⲉ
ⲙⲉⲧⲁⲛⲟⲉⲓ	ⲙⲉⲧⲁⲛⲟⲉⲓ
ⲉⲥⲱⲧⲙ	ⲉ|ⲥⲱⲧⲙ
ⲛϥⲕⲟⲧϥ	ⲛ|ϥ|ⲕⲟⲧ|ϥ
ⲙⲡⲉⲧⲡⲉ	ⲙ|ⲡⲉ|ⲧⲡⲉ
ⲡⲉⲧⲧⲁϫⲣⲏⲩ	ⲡⲉⲧ|ⲧⲁϫⲣⲏⲩ
ⲉⲧⲉϥϯⲡⲉ	ⲉ|ⲧⲉϥ|ϯⲡⲉ
ⲛⲟⲩⲙⲛⲧϣⲁϥⲧⲉ	ⲛ|ⲟⲩ|ⲙⲛⲧϣⲁϥⲧⲉ
ϫⲉⲁⲩϫⲟⲟⲥ	ϫⲉ|ⲁ|ⲩ|ϫⲟⲟ|ⲥ
ⲁϥⲡⲁϩⲧϥ	ⲁ|ϥ|ⲡⲁϩⲧ|ϥ
ⲉⲛϯϩⲁⲧⲉⲧⲏⲩⲧⲛ	ⲉ|ⲛ|ϯ|ϩⲁⲧⲉ|ⲧⲏⲩⲧⲛ
ⲉⲣϣⲁⲛⲟⲩⲙⲛⲧⲣⲣⲟ	ⲉⲣϣⲁⲛ|ⲟⲩ|ⲙⲛⲧⲣⲣⲟ
ⲛϣⲧⲟⲣⲧⲣ	ⲛ|ϣⲧⲟⲣⲧⲣ
ⲙⲛⲡϣⲣⲡ	ⲙⲛ|ⲡ|ϣⲣⲡ
ϩⲓⲱⲟⲩ	ϩⲓⲱ|ⲟⲩ
ⲛⲥⲕⲉⲡⲁⲥⲧⲏⲥ	ⲛ|ⲥⲕⲉⲡⲁⲥⲧⲏⲥ
ⲛⲃⲁⲣⲁⲃⲃⲁⲥ	ⲛ|ⲃⲁⲣⲁⲃⲃⲁⲥ
ⲙⲡⲕⲟⲩⲓ	ⲙ|ⲡ|ⲕⲟⲩⲓ
ⲟⲩⲛⲟⲩⲃ	ⲟⲩ|ⲛⲟⲩⲃ
ⲉϥϣⲟⲟⲡ	ⲉ|ϥ|ϣⲟⲟⲡ
ⲛϫⲟⲟⲩⲥⲉ	ⲛ|ϫⲟⲟⲩⲥⲉ
ⲧⲉⲓⲅⲣⲁⲫⲏ	ⲧⲉⲓ|ⲅⲣⲁⲫⲏ
ⲁⲩⲛⲟϭ	ⲁ|ⲩ|ⲛⲟϭ
ⲥⲧⲟϥ	ⲥⲧⲟ|ϥ
ⲉⲩⲛⲁⲛⲟϭⲛⲉϭ	ⲉ|ⲩ|ⲛⲁ|ⲛⲟϭⲛⲉϭ
ⲙⲟⲩ	ⲙⲟⲩ
ⲉⲗⲁⲁⲩ	ⲉ|ⲗⲁⲁⲩ
ⲕⲁⲁⲩ	ⲕⲁⲁ|ⲩ
ⲛⲛⲕⲁ	ⲛ|ⲛⲕⲁ
ⲉⲧⲉⲧⲛⲉϣ	ⲉ|ⲧⲉⲧⲛ|ⲉ|ϣ
ⲙⲛⲟⲩⲧⲱⲙ	ⲙⲛ|ⲟⲩ|ⲧⲱⲙ
ⲛⲧⲛⲙⲟⲟⲩⲧϥ	ⲛ|ⲧⲛ|ⲙⲟⲟⲩⲧ|ϥ
ⲕⲁⲧⲁ	ⲕⲁⲧⲁ
ⲙⲙⲛⲧⲣⲉ	ⲙ|ⲙⲛⲧⲣⲉ
ⲗⲁⲙⲁ	ⲗⲁⲙⲁ
ⲉⲧⲉϥϭⲓⲛⲱⲛⲁϩ	ⲉ|ⲧⲉϥ|ϭⲓⲛ|ⲱⲛⲁϩ
ϩⲛⲛⲉⲩⲧⲟϣ	ϩⲛ|ⲛⲉⲩ|ⲧⲟϣ
ⲙⲛⲛⲓⲕⲟⲟⲩⲉ	ⲙⲛ|ⲛⲓ|ⲕⲟⲟⲩⲉ
ⲙⲛⲟⲩϭⲱⲛⲧ	ⲙⲛ|ⲟⲩ|ϭⲱⲛⲧ
ⲁϣ	ⲁϣ
ⲛⲉϩⲟⲟⲩ	ⲛⲉ|ϩⲟⲟⲩ
ⲟⲩϫⲣⲟⲡ	ⲟⲩ|ϫⲣⲟⲡ
ⲉⲣⲙⲁⲑⲏⲧⲏⲥ	ⲉ|ⲣ|ⲙⲁⲑⲏⲧⲏⲥ
ⲛⲥⲓⲟⲩ	ⲛ|ⲥⲓⲟⲩ
ⲉⲁⲩⲉⲓⲛⲉ	ⲉ|ⲁ|ⲩ|ⲉⲓⲛⲉ
ⲛⲧⲁϥϫⲟⲟϥ	ⲛⲧ|ⲁ|ϥ|ϫⲟⲟ|ϥ
ϩⲛⲧⲥⲁⲧⲉ	ϩⲛ|ⲧ|ⲥⲁⲧⲉ
ⲛϣⲓⲛⲉ	ⲛ|ϣⲓⲛⲉ
ⲉϭⲱ	ⲉ|ϭⲱ
ϩⲁⲛⲑⲗⲓⲯⲓⲥ	ϩⲁ|ⲛ|ⲑⲗⲓⲯⲓⲥ
ⲛⲉⲥⲟⲟⲩ	ⲛ|ⲉⲥⲟⲟⲩ
ⲁⲥϭⲱ	ⲁ|ⲥ|ϭⲱ
ⲙⲡⲓϣⲁϫⲉ	ⲙ|ⲡⲓ|ϣⲁϫⲉ
ⲛⲟⲩⲕⲣⲓⲙⲁ	ⲛ|ⲟⲩ|ⲕⲣⲓⲙⲁ
ⲛⲛⲉϩ	ⲛ|ⲛⲉϩ
ⲉⲡⲧⲟⲡ	ⲉ|ⲡ|ⲧⲟⲡ
ⲁϥⲧⲱⲙⲛⲧ	ⲁ|ϥ|ⲧⲱⲙⲛⲧ
ⲁⲩϫⲓϣⲟϫⲛⲉ	ⲁ|ⲩ|ϫⲓ|ϣⲟϫⲛⲉ
ϫⲉⲉⲧⲓ	ϫⲉ|ⲉⲧⲓ
ⲙⲛⲛⲥⲱⲉⲓ	ⲙⲛⲛⲥⲱ|ⲉⲓ
ⲙⲙⲏⲏϣⲉ	ⲙ|ⲙⲏⲏϣⲉ
ⲉϩⲃⲥⲡⲉϥϩⲟ	ⲉ|ϩⲃⲥ|ⲡⲉϥ|ϩⲟ
ⲛⲉϭⲙⲏⲩ	ⲛⲉ|ϭⲙⲏⲩ
ϫⲉⲉⲛⲉϥⲛⲁⲑⲉⲣⲁⲡⲟⲩ	ϫⲉ|ⲉⲛⲉ|ϥ|ⲛⲁ|ⲑⲉⲣⲁⲡⲟⲩ
ⲛⲉⲧⲃⲏⲕ	ⲛ|ⲉⲧ|ⲃⲏⲕ
ⲛⲉϥⲙⲟⲉⲓⲧ	ⲛⲉϥ|ⲙⲟⲉⲓⲧ
ⲙⲡⲣⲣ	ⲙⲡⲣ|ⲣ
ⲛⲉⲕϣⲟⲟⲡ	ⲛⲉ|ⲕ|ϣⲟⲟⲡ
ⲛⲧⲁⲉⲓⲣⲉ	ⲛ|ⲧⲁ|ⲉⲓⲣⲉ
ⲁⲙⲡⲉ	ⲁⲙ|ⲡⲉ
ⲉⲛϯ	ⲉ|ⲛ|ϯ
ⲡⲓⲗⲁⲧⲟⲥ	ⲡⲓⲗⲁⲧⲟⲥ
ⲙⲡⲅⲁⲍⲟⲫⲩⲗⲁⲕⲓⲟⲛ	ⲙ|ⲡ|ⲅⲁⲍⲟⲫⲩⲗⲁⲕⲓⲟⲛ
ⲉⲛⲣϩⲱⲃ	ⲉ|ⲛ|ⲣϩⲱⲃ
ⲛⲉⲧⲛⲡⲉⲑⲟⲟⲩ	ⲛⲉⲧⲛ|ⲡ|ⲉⲧ|ϩⲟⲟⲩ
ϯⲧⲏⲩⲧⲛ	ϯ|ⲧⲏⲩⲧⲛ
ⲙⲛⲛⲥⲁⲧⲉⲑⲗⲓⲯⲓⲥ	ⲙⲛⲛⲥⲁ|ⲧⲉ|ⲑⲗⲓⲯⲓⲥ
ϩⲁⲧⲛ	ϩⲁ|ⲧⲛ
ϩⲙⲡⲉϥⲡⲛⲉⲩⲙⲁ	ϩⲙ|ⲡⲉϥ|ⲡⲛⲉⲩⲙⲁ
ⲕⲡⲟⲛⲏⲣⲉⲩⲉ	ⲕ|ⲡⲟⲛⲏⲣⲉⲩⲉ
ⲛϭⲓⲓⲁⲕⲱⲃ	ⲛϭⲓ|ⲓⲁⲕⲱⲃ
ⲛⲣⲁⲧϥ	ⲛ|ⲣⲁⲧ|ϥ
ⲛⲥⲉⲧⲙⲛⲟⲉⲓ	ⲛ|ⲥⲉ|ⲧⲙ|ⲛⲟⲉⲓ
ⲛ̄ⲧⲁⲩⲱⲛϩ	ⲛ̄ⲧ|ⲁ|ⲩ|ⲱⲛϩ
ⲉⲧⲉⲙⲛⲃⲁⲗ	ⲉⲧⲉ|ⲙⲛ|ⲃⲁⲗ
ⲙⲡⲉⲧⲉⲟⲩⲁϣϥ	ⲙ|ⲡ|ⲉⲧⲉ|ⲟⲩⲁϣ|ϥ
ⲛⲧⲁⲩⲥϩⲁⲓ	ⲛⲧ|ⲁ|ⲩ|ⲥϩⲁⲓ
ϥⲛⲁϫⲓ	ϥ|ⲛⲁ|ϫⲓ
ϩⲓⲡⲟⲛⲏⲣⲓⲁ	ϩⲓ|ⲡⲟⲛⲏⲣⲓⲁ
ⲉⲁϩⲁϩ	ⲉ|ⲁ|ϩⲁϩ
ϭⲁⲗⲱⲟⲩ	ϭⲁⲗⲱ|ⲟⲩ
ⲛⲟⲩϩⲱⲃ	ⲛ|ⲟⲩ|ϩⲱⲃ
ⲛϣⲟⲣⲡ	ⲛ|ϣⲟⲣⲡ
ⲙ̅ⲡⲉⲓⲥⲁ	ⲙ|ⲡⲉⲓ|ⲥⲁ
ⲛⲧⲉϥⲟⲣⲅⲏ	ⲛ|ⲧⲉϥ|ⲟⲣⲅⲏ
ⲙⲉϥϣⲁϫⲉ	ⲙⲉ|ϥ|ϣⲁϫⲉ
ⲛⲙⲙⲁϥ	ⲛⲙⲙⲁ|ϥ
ⲡⲉⲓⲣⲁⲍⲉ	ⲡⲉⲓⲣⲁⲍⲉ
ⲉϯⲥⲃⲱ	ⲉ|ϯ|ⲥⲃⲱ
ⲧⲉⲧⲛⲁⲥⲟⲩⲱⲛⲟⲩ	ⲧⲉⲧ|ⲛⲁ|ⲥⲟⲩⲱⲛ|ⲟⲩ
ⲛⲟⲩⲡⲩⲣⲅⲟⲥ	ⲛ|ⲟⲩ|ⲡⲩⲣⲅⲟⲥ
ϩⲙⲡⲥⲱⲙⲁ	ϩⲙ|ⲡ|ⲥⲱⲙⲁ
ⲙⲡⲕⲟⲥⲙⲟⲥ	ⲙ|ⲡ|ⲕⲟⲥⲙⲟⲥ
ϩⲙⲡⲧⲟⲕ	ϩⲙ|ⲡ|ⲧⲟⲕ
ⲉⲧⲟⲩϫⲉⲛⲉⲧⲡⲓⲥⲧⲉⲩⲉ	ⲉ|ⲧⲟⲩϫⲉ|ⲛ|ⲉⲧ|ⲡⲓⲥⲧⲉⲩⲉ
ϩⲟⲧϩⲧ	ϩⲟⲧϩⲧ
ⲛⲁⲓⲁⲧⲟⲩ	ⲛⲁⲓⲁⲧ|ⲟⲩ
ⲡⲉⲧⲛⲧⲟⲟⲧⲕ	ⲡ|ⲉⲧ|ⲛⲧⲟⲟⲧ|ⲕ
ⲛⲧⲉⲣⲉⲡⲉⲡⲛⲉⲩⲙⲁ	ⲛⲧⲉⲣⲉ|ⲡⲉ|ⲡⲛⲉⲩⲙⲁ
ϫⲉⲡⲥⲁⲃⲃⲁⲧⲟⲛ	ϫⲉ|ⲡ|ⲥⲁⲃⲃⲁⲧⲟⲛ
ϩⲛⲁⲙⲛⲧⲉ	ϩⲛ|ⲁⲙⲛⲧⲉ
ⲛⲛⲉⲧⲟⲩϫⲓ	ⲛ|ⲛ|ⲉⲧ|ⲟⲩ|ϫⲓ
ⲛⲙⲙⲁⲛ	ⲛⲙⲙⲁ|ⲛ
ⲉⲛⲧⲁⲩϫⲟϥ	ⲉⲛⲧ|ⲁ|ⲩ|ϫⲟ|ϥ
ϣⲁⲛⲧⲟⲩⲕⲟⲧⲟⲩ	ϣⲁⲛⲧ|ⲟⲩ|ⲕⲟⲧ|ⲟⲩ
ⲉⲡⲱϩⲥ	ⲉ|ⲡ|ⲱϩⲥ
ϩⲛⲧⲡⲁϣⲉ	ϩⲛ|ⲧ|ⲡⲁϣⲉ
ⲛⲉⲥⲙⲟⲕϩ	ⲛⲉ|ⲥ|ⲙⲟⲕϩ
ϩⲓϣⲉⲉⲣⲉ	ϩⲓ|ϣⲉⲉⲣⲉ
ⲛⲛⲓⲁⲧⲛⲁ	ⲛ|ⲛⲓ|ⲁⲧⲛⲁ
ⲕⲁⲧⲁⲧⲉⲛϩⲓⲕⲱⲛ	ⲕⲁⲧⲁ|ⲧⲉⲛ|ϩⲓⲕⲱⲛ
ⲉⲧⲛⲁⲉⲓⲣⲉ	ⲉⲧ|ⲛⲁ|ⲉⲓⲣⲉ
ϫⲉⲁϥⲕⲱ	ϫⲉ|ⲁ|ϥ|ⲕⲱ
ⲉⲧⲣⲉⲩⲥⲟⲧⲡⲥ	ⲉ|ⲧⲣⲉ|ⲩ|ⲥⲟⲧⲡ|ⲥ
ϩⲓϫⲛ	ϩⲓϫⲛ
ⲙⲫⲁⲛⲟⲩⲏⲗ	ⲙ|ⲫⲁⲛⲟⲩⲏⲗ
ⲁϥⲙⲟⲣϥ	ⲁ|ϥ|ⲙⲟⲣ|ϥ
ⲛϭⲓⲡⲉⲧⲛⲁϫⲱϩⲙ	ⲛϭⲓ|ⲡ|ⲉⲧ|ⲛⲁ|ϫⲱϩⲙ
ⲉⲛⲉⲛⲧⲟⲗⲏ	ⲉ|ⲛ|ⲉⲛⲧⲟⲗⲏ
ⲕⲁⲥⲡⲉⲣⲙⲁ	ⲕⲁ|ⲥⲡⲉⲣⲙⲁ
ⲁϥϩⲙⲟⲟⲥ	ⲁ|ϥ|ϩⲙⲟⲟⲥ
ⲛⲧⲉⲣⲟⲩⲉⲓⲙⲉ	ⲛⲧⲉⲣ|ⲟⲩ|ⲉⲓⲙⲉ
ⲁϣϣⲕⲁⲕ	ⲁϣ|ϣⲕⲁⲕ
ϩⲓϫⲱϥ	ϩⲓϫⲱ|ϥ
ⲉⲥⲇⲟⲕⲉⲓ	ⲉ|ⲥ|ⲇⲟⲕⲉⲓ
ⲉⲩϣⲁⲛⲛⲁⲩ	ⲉⲩϣⲁⲛ|ⲛⲁⲩ
ϩⲓⲙⲛⲧⲁⲧⲥⲃⲱ	ϩⲓ|ⲙⲛⲧⲁⲧⲥⲃⲱ
ϥⲥⲱ	ϥ|ⲥⲱ
ⲉⲩⲛⲏϫ	ⲉ|ⲩ|ⲛⲏϫ
ⲉⲁⲩϭⲁⲗⲱⲟⲩ	ⲉ|ⲁ|ⲩ|ϭⲁⲗⲱ|ⲟⲩ
ⲉⲧⲉⲓⲣⲉ	ⲉⲧ|ⲉⲓⲣⲉ
ϩⲣⲟϣ	ϩⲣⲟϣ
ⲛⲉⲣⲁⲥⲱϣ	ⲛⲉⲣ|ⲁ|ⲥⲱϣ
ⲛⲟⲩⲙⲁⲓⲛ	ⲛ|ⲟⲩ|ⲙⲁⲓⲛ
ⲉⲡϣⲏⲣⲉ	ⲉ|ⲡ|ϣⲏⲣⲉ
ϩⲏⲣⲱⲇⲓⲁⲥ	ϩⲏⲣⲱⲇⲓⲁⲥ
ϩⲛⲧⲉⲩⲙⲏⲧⲉ	ϩⲛ|ⲧⲉⲩ|ⲙⲏⲧⲉ
ⲉⲧⲣⲉⲛⲕⲁ	ⲉ|ⲧⲣⲉ|ⲛ|ⲕⲁ
ⲙⲛⲧⲉϩⲉ	ⲙⲛ|ⲧ|ⲉϩⲉ
ⲥⲟⲧⲡⲟⲩ	ⲥⲟⲧⲡ|ⲟⲩ
ⲉⲓϣⲁⲛⲥⲟⲟϥ	ⲉ|ⲓ|ϣⲁⲛ|ⲥⲟⲟ|ϥ
ϫⲉⲙⲛⲧⲁⲛ	ϫⲉ|ⲙⲛⲧⲁ|ⲛ
ⲡⲉϣⲃⲣⲣϩⲱⲃ	ⲡⲉ|ϣⲃⲣ|ⲣϩⲱⲃ
ⲛⲛⲉⲧⲉⲛⲟⲩⲕ	ⲛ|ⲛ|ⲉⲧⲉ|ⲛⲟⲩⲕ
ⲉⲩϫⲡⲓⲟ	ⲉ|ⲩ|ϫⲡⲓⲟ
ϩⲓⲕⲣⲟϥ	ϩⲓ|ⲕⲣⲟϥ
ⲛϫⲓ	ⲛϫⲓ
ⲙⲡⲟⲩⲟⲉⲓⲛ	ⲙ|ⲡ|ⲟⲩⲟⲉⲓⲛ
ⲛⲉⲛϩⲓⲥⲉ	ⲛⲉⲛ|ϩⲓⲥⲉ
ⲙⲡϥⲕⲁⲁϥ	ⲙⲡ|ϥ|ⲕⲁⲁ|ϥ
ⲛⲙⲡⲧⲃⲧ	ⲛⲙ|ⲡ|ⲧⲃⲧ
ⲛⲉⲓⲑⲗⲓⲯⲓⲥ	ⲛⲉⲓ|ⲑⲗⲓⲯⲓⲥ
ⲉⲧⲟⲩⲛⲁϣⲥⲱⲧⲙ	ⲉⲧ|ⲟⲩ|ⲛⲁ|ϣ|ⲥⲱⲧⲙ
ⲛⲗⲏⲥⲧⲏⲥ	ⲛ|ⲗⲏⲥⲧⲏⲥ
ⲉⲓⲇⲱⲗⲟⲛ	ⲉⲓⲇⲱⲗⲟⲛ
ⲙⲫⲓⲗⲓⲡⲡⲟⲥ	ⲙ|ⲫⲓⲗⲓⲡⲡⲟⲥ
ⲁϥⲧⲟⲗⲙⲁ	ⲁ|ϥ|ⲧⲟⲗⲙⲁ
ⲉⲛⲉⲩⲙⲟϫϩ	ⲉ|ⲛⲉⲩ|ⲙⲟϫϩ
ϩⲓⲧⲛⲛⲉϩⲃⲏⲩⲉ	ϩⲓⲧⲛ|ⲛⲉ|ϩⲃⲏⲩⲉ
ϩⲛⲟⲩⲙⲛⲧϩⲙϩⲁⲗ	ϩⲛ|ⲟⲩ|ⲙⲛⲧϩⲙϩⲁⲗ
ϫⲉⲛⲅⲛⲁⲩ	ϫⲉ|ⲛ|ⲅ|ⲛⲁⲩ
ϩⲱⲱϥ	ϩⲱⲱ|ϥ
[....]ⲥ	[....]ⲥ
ϫⲉⲛⲟⲃⲉⲛⲓⲙ	ϫⲉ|ⲛⲟⲃⲉ|ⲛⲓⲙ
ⲙⲡⲣϫⲟⲟⲥ	ⲙⲡⲣ|ϫⲟⲟ|ⲥ
ⲉⲧⲉϣⲁⲩⲣⲱϩⲧ	ⲉⲧⲉ|ϣⲁ|ⲩ|ⲣⲱϩⲧ
ϫⲉⲙⲛⲡⲁⲣⲣⲏⲥⲓⲁ	ϫⲉ|ⲙⲛ|ⲡⲁⲣⲣⲏⲥⲓⲁ
ⲛⲉϥⲟ	ⲛⲉ|ϥ|ⲟ
ⲉϣⲱⲡⲉ	ⲉ|ϣⲱⲡⲉ
ⲙⲡⲉϭⲗⲟϭ	ⲙ|ⲡⲉ|ϭⲗⲟϭ
ⲙⲡⲣⲧⲣⲉⲛⲁⲡⲟⲧⲁⲥⲥⲉ	ⲙⲡⲣ|ⲧⲣⲉ|ⲛ|ⲁⲡⲟⲧⲁⲥⲥⲉ
ⲛⲥⲧⲉⲫⲁⲛⲁ	ⲛ|ⲥⲧⲉⲫⲁⲛⲁ
ⲛⲛⲉⲧⲙⲙⲁⲩ	ⲛ|ⲛ|ⲉⲧ|ⲙⲙⲁⲩ
ⲧⲣⲉ	ⲧⲣⲉ
ⲙⲡⲛⲟⲩⲧⲉ	ⲙ|ⲡ|ⲛⲟⲩⲧⲉ
ⲉⲛⲁⲛⲟⲩ	ⲉ|ⲛⲁⲛⲟⲩ
ⲛⲉⲛⲧⲁⲩⲡⲗⲁⲛⲁ	ⲛ|ⲉⲛⲧ|ⲁ|ⲩ|ⲡⲗⲁⲛⲁ
ϩⲛⲛⲉⲧⲙⲟⲟⲩⲧ	ϩⲛ|ⲛ|ⲉⲧ|ⲙⲟⲟⲩⲧ
ϣⲱⲥ	ϣⲱⲥ
ⲁⲣϯⲉⲟⲟⲩ	ⲁⲣ|ϯ|ⲉⲟⲟⲩ
ⲙⲡⲉϣⲗⲁⲁⲩ	ⲙⲡⲉ|ϣ|ⲗⲁⲁⲩ
ϫⲉⲟⲩⲫⲁⲛⲧⲁⲥⲙⲁⲡⲉ	ϫⲉ|ⲟⲩ|ⲫⲁⲛⲧⲁⲥⲙⲁ|ⲡⲉ
ⲕⲟⲩⲱϣⲧ	ⲕ|ⲟⲩⲱϣⲧ
ⲛⲏⲩ	ⲛⲏⲩ
ⲉⲡⲡⲉⲧϩⲟⲟⲩ	ⲉ|ⲡ|ⲡ|ⲉⲧ|ϩⲟⲟⲩ
ϩⲛⲟⲩⲙⲁⲕϩ	ϩⲛ|ⲟⲩ|ⲙⲁⲕϩ
ⲉⲙⲡⲟⲩϯⲗⲁⲁⲩ	ⲉ|ⲙⲡ|ⲟⲩ|ϯ|ⲗⲁⲁⲩ
ⲁϥⲡⲉϣⲛⲟⲉⲓⲕ	ⲁ|ϥ|ⲡⲉϣⲛ|ⲟⲉⲓⲕ
ⲃⲁⲡⲧⲓⲥⲙⲁ	ⲃⲁⲡⲧⲓⲥⲙⲁ
ⲉⲧⲗⲟⲙⲥ	ⲉⲧ|ⲗⲟⲙⲥ
ϣⲁⲡⲙⲉϩⲥⲁϣϥ	ϣⲁ|ⲡ|ⲙⲉϩⲥⲁϣϥ
ⲛⲁⲃⲟⲩⲭⲟⲇⲟⲛⲟⲥⲟⲣ	ⲛⲁⲃⲟⲩⲭⲟⲇⲟⲛⲟⲥⲟⲣ
ⲁϫⲓⲥ	ⲁϫⲓ|ⲥ
ⲙⲙⲛⲧⲣⲉϥϣⲙϣⲉⲛⲟⲩⲧⲉ	ⲙ|ⲙⲛⲧⲣⲉϥϣⲙϣⲉⲛⲟⲩⲧⲉ
ϫⲉⲥⲱⲧⲙ	ϫⲉ|ⲥⲱⲧⲙ
ⲛⲛⲟⲩⲉⲓⲟⲧⲉ	ⲛ|ⲛⲟⲩ|ⲉⲓⲟⲧⲉ
ⲉⲧⲉⲣⲉⲧⲓⲙⲱⲣⲓⲁ	ⲉⲧⲉⲣⲉ|ⲧⲓⲙⲱⲣⲓⲁ
ϫⲉⲉⲓⲥⲧⲁⲙⲁⲁⲩ	ϫⲉ|ⲉⲓⲥ|ⲧⲁ|ⲙⲁⲁⲩ
ⲛⲧⲁϭⲥⲉ	ⲛ|ⲧⲁϭⲥⲉ
ⲉⲁⲓⲥⲁⲁⲕ	ⲉ|ⲁ|ⲓⲥⲁⲁⲕ
ϫⲉϣⲁⲛⲧⲉⲟⲩϣⲱⲡⲉ	ϫⲉ|ϣⲁⲛⲧⲉ|ⲟⲩ|ϣⲱⲡⲉ
ⲉⲩⲙⲛⲧⲙⲛⲧⲣⲉ	ⲉ|ⲩ|ⲙⲛⲧⲙⲛⲧⲣⲉ
ϩⲛⲙⲡⲟⲗⲓⲥ	ϩⲛ|ⲙ|ⲡⲟⲗⲓⲥ
ⲉⲧⲣϩⲟⲧⲉ	ⲉⲧ|ⲣϩⲟⲧⲉ
ⲉⲉⲙⲧⲟⲛ	ⲉ|ⲉⲙⲧⲟⲛ
ⲛⲥϩⲓⲙⲉ	ⲛ|ⲥϩⲓⲙⲉ
ⲛⲉⲙⲙⲛⲗⲁⲁⲩ	ⲛⲉ|ⲙⲙⲛ|ⲗⲁⲁⲩ
ⲁϥⲕⲁⲃⲁⲣⲁⲃⲃⲁⲥ	ⲁ|ϥ|ⲕⲁ|ⲃⲁⲣⲁⲃⲃⲁⲥ
ⲉⲧϩⲏⲛ	ⲉⲧ|ϩⲏⲛ
ϣⲁⲛⲧⲉϥⲃⲱⲕ	ϣⲁⲛⲧⲉ|ϥ|ⲃⲱⲕ
ⲧⲏⲣⲧⲛ	ⲧⲏⲣ|ⲧⲛ
ⲧⲉ	ⲧⲉ
ⲛⲧⲉⲧⲛⲡⲓⲥⲧⲉⲩⲉ	ⲛ|ⲧⲉⲧⲛ|ⲡⲓⲥⲧⲉⲩⲉ
ϩⲛⲧⲥⲓⲛⲇⲱⲛ	ϩⲛ|ⲧ|ⲥⲓⲛⲇⲱⲛ
[..]	[..]
ⲙⲛⲅⲁⲓⲟⲥ	ⲙⲛ|ⲅⲁⲓⲟⲥ
ϩⲛϩⲉⲛϩⲃⲏⲩⲉ	ϩⲛ|ϩⲉⲛ|ϩⲃⲏⲩⲉ
ϫⲉⲛⲧⲁⲓⲁⲑⲉⲧⲓ	ϫⲉ|ⲛⲧ|ⲁ|ⲓ|ⲁⲑⲉⲧⲓ
ⲟⲩϣⲁϫⲉ	ⲟⲩ|ϣⲁϫⲉ
ⲟⲩⲉϩⲥⲁϩⲛⲉ	ⲟⲩⲉϩⲥⲁϩⲛⲉ
ⲛϩⲁⲅⲓⲟⲥ	ⲛ|ϩⲁⲅⲓⲟⲥ
ⲛⲁⲧⲙⲡϣⲁ	ⲛ|ⲁⲧⲙⲡϣⲁ
ⲙⲛⲓⲱϩⲁⲛⲏⲥ	ⲙⲛ|ⲓⲱϩⲁⲛⲏⲥ
ⲕⲁⲧⲁⲗⲁⲁⲩ	ⲕⲁⲧⲁ|ⲗⲁⲁⲩ
ⲛϣⲡⲏⲣⲉ	ⲛ|ϣⲡⲏⲣⲉ
ⲛⲉⲧⲛⲁϣⲱⲡⲉ	ⲛ|ⲉⲧ|ⲛⲁ|ϣⲱⲡⲉ
ⲙⲡⲉⲕϩⲉ	ⲙⲡⲉ|ⲕ|ϩⲉ
ⲕⲟⲓⲛⲱⲛⲟⲥ	ⲕⲟⲓⲛⲱⲛⲟⲥ
ⲉⲣⲉⲡϩⲏⲃⲥ	ⲉⲣⲉ|ⲡ|ϩⲏⲃⲥ
ⲉⲛⲉⲙⲡⲉⲡϫⲟⲉⲓⲥ	ⲉⲛⲉ|ⲙⲡⲉ|ⲡ|ϫⲟⲉⲓⲥ
ⲛⲉⲧⲛⲁⲟⲩϫⲁⲓ	ⲛ|ⲉⲧ|ⲛⲁ|ⲟⲩϫⲁⲓ
ⲉϫⲙⲡⲟⲩⲱϣ	ⲉϫⲙ|ⲡ|ⲟⲩⲱϣ
ⲛⲉⲧϣⲁϫⲉ	ⲛ|ⲉⲧ|ϣⲁϫⲉ
ⲡⲁⲡⲟⲥⲧⲟⲗⲟⲥ	ⲡ|ⲁⲡⲟⲥⲧⲟⲗⲟⲥ
ⲁϥⲛⲁⲩ	ⲁ|ϥ|ⲛⲁⲩ
ⲙⲡϥⲣⲗⲁⲁⲩ	ⲙⲡ|ϥ|ⲣⲗⲁⲁⲩ
ⲙⲡⲉⲛⲣⲟⲟⲩϣ	ⲙ|ⲡⲉⲛ|ⲣⲟⲟⲩϣ
ⲛⲛⲓⲙ	ⲛ|ⲛⲓⲙ
ⲙⲙⲟ	ⲙⲙⲟ
ⲥⲉⲛⲁϣⲁϫⲉ	ⲥⲉ|ⲛⲁ|ϣⲁϫⲉ
ⲙⲡⲣⲧⲣⲉϥⲃⲱⲕ	ⲙⲡⲣ|ⲧⲣⲉ|ϥ|ⲃⲱⲕ
ⲁⲩϭⲉⲗⲡⲧⲟⲩⲉϩⲥⲟⲓ	ⲁ|ⲩ|ϭⲉⲗⲡ|ⲧⲟⲩⲉϩⲥⲟⲓ
ⲛⲉⲧⲛϩⲃⲏⲩⲉ	ⲛⲉⲧⲛ|ϩⲃⲏⲩⲉ
ϩⲙⲡⲉϥⲏⲉⲓ	ϩⲙ|ⲡⲉϥ|ⲏⲉⲓ
ⲙⲡⲉⲓⲕⲉ	ⲙ|ⲡⲉⲓ|ⲕⲉ
 ⲥⲟⲡ[.]	ⲥⲟⲡ[.]
ϫⲁϫⲉ	ϫⲁϫⲉ
ϩⲓϫⲱⲥ	ϩⲓϫⲱ|ⲥ
ⲉⲩⲧⲁⲉⲓⲏⲩ	ⲉ|ⲩ|ⲧⲁⲉⲓⲏⲩ
ⲛϭⲓⲛϩⲁⲗⲁⲁⲧⲉ	ⲛϭⲓ|ⲛ|ϩⲁⲗⲁⲁⲧⲉ
ⲉⲩⲁⲡⲟⲗⲁⲩⲥⲓⲥ	ⲉ|ⲩ|ⲁⲡⲟⲗⲁⲩⲥⲓⲥ
ⲁⲩⲡⲓⲑⲉ	ⲁ|ⲩ|ⲡⲓⲑⲉ
ⲛⲅϫⲓ	ⲛ|ⲅ|ϫⲓ
ⲙⲡⲣⲡⲉ	ⲙ|ⲡ|ⲣⲡⲉ
ⲥⲛⲟϥ	ⲥⲛⲟϥ
ⲛⲉⲣⲉⲓⲏⲥⲟⲩⲥ	ⲛⲉⲣⲉ|ⲓⲏⲥⲟⲩⲥ
ⲙⲛⲛⲥⲁⲧⲣⲉϥϣⲁϫⲉ	ⲙⲛⲛⲥⲁ|ⲧⲣⲉ|ϥ|ϣⲁϫⲉ
ⲛϩⲙⲟⲧ	ⲛ|ϩⲙⲟⲧ
ⲥⲉⲛⲁⲉⲓⲣⲉ	ⲥⲉ|ⲛⲁ|ⲉⲓⲣⲉ
ⲁⲩϫⲟⲟⲥ	ⲁ|ⲩ|ϫⲟⲟ|ⲥ
ⲕⲁϩⲏⲩ	ⲕⲁϩⲏⲩ
ⲛⲉⲓⲕⲟⲟⲩⲉ	ⲛⲉⲓ|ⲕⲟⲟⲩⲉ
ⲛⲟⲩⲙⲙⲟⲟⲩ	ⲛ|ⲟⲩ|ⲙⲙⲟ|ⲟⲩ
ⲡⲁⲥⲟⲛ	ⲡⲁ|ⲥⲟⲛ
ϫⲉⲛⲉϥⲟⲩⲱϣ	ϫⲉ|ⲛⲉ|ϥ|ⲟⲩⲱϣ
ⲉⲩⲥⲙⲟⲩ	ⲉ|ⲩ|ⲥⲙⲟⲩ
ⲡⲉⲩϩⲟⲩⲟ	ⲡⲉⲩ
ⲉⲓⲛⲁⲙⲟⲩⲧⲉ	ⲉ|ⲓ|ⲛⲁ|ⲙⲟⲩⲧⲉ
ⲛⲧⲁⲩⲣⲫⲟⲛⲟⲥ	ⲛⲧ|ⲁ|ⲩ|ⲣⲫⲟⲛⲟⲥ
ⲁⲩⲧⲁⲙⲟⲓ	ⲁ|ⲩ|ⲧⲁⲙⲟ|ⲓ
ⲛⲕⲁⲕⲓⲁ	ⲛ|ⲕⲁⲕⲓⲁ
ⲉⲩⲣⲁⲥⲟⲩ	ⲉ|ⲩ|ⲣⲁⲥⲟⲩ
ⲙ̅ⲙⲟⲥ	ⲙⲙⲟ|ⲥ
ϫⲉⲟⲩⲕ	ϫⲉ|ⲟⲩⲕ
ⲟⲩⲣⲙⲏ	ⲟⲩ|ⲣⲙⲏ
ⲛⲛⲓⲉⲥⲟⲟⲩ	ⲛ|ⲛⲓ|ⲉⲥⲟⲟⲩ
ⲙⲛⲛⲉⲧⲉⲓⲛⲉ	ⲙⲛ|ⲛ|ⲉⲧ|ⲉⲓⲛⲉ
ⲛⲥⲉⲧⲁϩⲥϥ	ⲛ|ⲥⲉ|ⲧⲁϩⲥ|ϥ
ⲛⲧⲉⲣⲟⲩⲁⲙⲁϩⲧⲉ	ⲛⲧⲉⲣ|ⲟⲩ|ⲁⲙⲁϩⲧⲉ
ⲛⲧⲁⲥϫⲡⲟϥ	ⲛⲧ|ⲁ|ⲥ|ϫⲡⲟ|ϥ
ⲡⲉⲥⲏⲧ	ⲡ|ⲉⲥⲏⲧ
ϩⲛⲧⲉⲓϣⲙⲟⲩⲛⲉ	ϩⲛ|ⲧⲉⲓ|ϣⲙⲟⲩⲛⲉ
ⲛⲥⲉⲧⲙⲛⲁⲩ	ⲛ|ⲥⲉ|ⲧⲙ|ⲛⲁⲩ
ⲛⲏⲧⲛⲛⲧⲁⲉⲓⲟ	ⲛⲏ|ⲧⲛ|ⲛ|ⲧⲁⲉⲓⲟ
ⲉⲣⲉϥⲧⲟⲟⲩ	ⲉⲣⲉ|ϥ|ⲧⲟⲟⲩ
ⲛϩⲉⲛϩⲃⲏⲩⲉ	ⲛ|ϩⲉⲛ|ϩⲃⲏⲩⲉ
ⲛⲧⲉⲡⲏⲣⲡ	ⲛⲧⲉ|ⲡ|ⲏⲣⲡ
ⲛⲣⲙⲙⲁⲟ	ⲛ|ⲣⲙⲙⲁⲟ
ⲛⲥⲁⲛⲟⲩⲏⲏⲃ	ⲛⲥⲁ|ⲛ|ⲟⲩⲏⲏⲃ
ⲁⲩⲧⲁⲩⲟ	ⲁ|ⲩ|ⲧⲁⲩⲟ
ⲁϥϩⲱⲛ	ⲁ|ϥ|ϩⲱⲛ
ⲉϥⲟⲩⲟⲗⲥ	ⲉ|ϥ|ⲟⲩⲟⲗⲥ
ⲕⲁⲧⲁⲥⲁⲣⲝ	ⲕⲁⲧⲁ|ⲥⲁⲣⲝ
ⲉⲩϣⲁⲛⲡⲱⲛⲅ	ⲉⲩϣⲁⲛ|ⲡⲱⲛⲅ
ⲕⲁⲧⲁⲣⲱⲙⲉ	ⲕⲁⲧⲁ|ⲣⲱⲙⲉ
ϫⲉⲧⲙⲛⲧⲥⲩⲛⲕⲗⲏⲧⲓⲕⲟⲥ	ϫⲉ|ⲧ|ⲙⲛⲧⲥⲩⲛⲕⲗⲏⲧⲓⲕⲟⲥ
ⲛϩⲟⲟⲩ	ⲛ|ϩⲟⲟⲩ
ⲉⲓⲥϩⲏⲏⲛⲉ	ⲉⲓⲥ|ϩⲏⲏⲛⲉ
ⲛϣⲉ	ⲛ|ϣⲉ
ⲛⲟⲩⲃⲗⲃⲓⲗⲉ	ⲛ|ⲟⲩ|ⲃⲗⲃⲓⲗⲉ
ⲛⲛⲉⲧϣⲟⲟⲡ	ⲛ|ⲛ|ⲉⲧ|ϣⲟⲟⲡ
ⲛⲛⲉϥϩⲟⲓⲧⲉ	ⲛ|ⲛⲉϥ|ϩⲟⲓⲧⲉ
ⲁⲥⲁⲓⲧⲉⲓ	ⲁ|ⲥ|ⲁⲓⲧⲉⲓ
ⲉⲧⲟⲩⲛⲁϫⲟⲟⲩ	ⲉⲧ|ⲟⲩ|ⲛⲁ|ϫⲟ|ⲟⲩ
ⲅⲉⲑⲥⲏⲙⲁⲛⲉⲓ	ⲅⲉⲑⲥⲏⲙⲁⲛⲉⲓ
ⲁⲓⲡⲁϩⲧ	ⲁ|ⲓ|ⲡⲁϩⲧ
ϫⲉⲡⲉⲓⲗⲁⲟⲥ	ϫⲉ|ⲡⲉⲓ|ⲗⲁⲟⲥ
ⲡⲉⲓⲣⲱⲙⲉ	ⲡⲉⲓ|ⲣⲱⲙⲉ
ϩⲓⲃⲟⲗ	ϩⲓⲃⲟⲗ
ⲁⲥϣⲱⲡⲉ	ⲁ|ⲥ|ϣⲱⲡⲉ
ⲉⲩϩⲛⲛⲧⲟⲉⲓⲥ	ⲉ|ⲩ|ϩⲛ|ⲛ|ⲧⲟⲉⲓⲥ
ⲛⲛⲉϥⲉϣⲁϩⲉⲣⲁⲧϥ	ⲛⲛⲉ|ϥ|ⲉϣ|ⲁϩⲉⲣⲁⲧ|ϥ
ⲉⲱⲛϩ	ⲉ|ⲱⲛϩ
ⲛⲁⲙⲟⲩⲧⲉ	ⲛⲁ|ⲙⲟⲩⲧⲉ
ⲁⲧⲉϥϩⲁⲏ	ⲁ|ⲧⲉϥ|ϩⲁⲏ
·ⲉⲩⲧⲙⲁⲓⲟ	·|ⲉ|ⲩ|ⲧⲙⲁⲓⲟ
[.]ⲛ	[.]ⲛ
ⲁϥϫⲟⲟⲥ	ⲁ|ϥ|ϫⲟⲟ|ⲥ
ⲛⲧⲃⲃⲟ	ⲛ|ⲧⲃⲃⲟ
ⲛⲧⲉⲣⲟⲩⲧⲁⲙⲓⲟ	ⲛⲧⲉⲣ|ⲟⲩ|ⲧⲁⲙⲓⲟ
ⲉⲥϫⲱ	ⲉ|ⲥ|ϫⲱ
ⲛⲧⲛⲡⲓⲥⲧⲉⲩⲉ	ⲛ|ⲧⲛ|ⲡⲓⲥⲧⲉⲩⲉ
ⲛⲁⲗⲉⲝⲁⲛⲇⲣⲟⲥ	ⲛ|ⲁⲗⲉⲝⲁⲛⲇⲣⲟⲥ
ⲉⲩⲕⲟⲗⲁⲍⲉ	ⲉ|ⲩ|ⲕⲟⲗⲁⲍⲉ
ⲉⲥϩⲙⲡⲏⲓ	ⲉ|ⲥ|ϩⲙ|ⲡ|ⲏⲓ
ⲛⲥⲱⲛϩ	ⲛ|ⲥ|ⲱⲛϩ
ⲙⲛⲛⲕⲉⲏⲓ	ⲙⲛ|ⲛ|ⲕⲉ|ⲏⲓ
ⲉⲡⲉⲕϣⲁϫⲉ	ⲉ|ⲡⲉⲕ|ϣⲁϫⲉ
ⲉⲩⲟϣ	ⲉ|ⲩ|ⲟϣ
ⲙⲛⲥⲟⲟⲩⲛ	ⲙⲛ|ⲥⲟⲟⲩⲛ
ⲉϫⲱⲟⲩ	ⲉϫⲱ|ⲟⲩ
ⲟⲩⲡⲟⲣⲛⲟⲥ	ⲟⲩ|ⲡⲟⲣⲛⲟⲥ
ⲛϯⲥⲟⲟⲩⲛ	ⲛ|ϯ|ⲥⲟⲟⲩⲛ
ⲡⲉⲧⲧⲱϭⲉ	ⲡ|ⲉⲧ|ⲧⲱϭⲉ
ⲡⲱⲣϫ	ⲡⲱⲣϫ
ⲉⲧⲧⲁϩⲙ	ⲉⲧ|ⲧⲁϩⲙ
ⲉϥⲓⲧⲥ	ⲉ|ϥⲓⲧ|ⲥ
ⲉⲛⲁϩⲟⲉⲓⲧⲉ	ⲉ|ⲛⲁ|ϩⲟⲉⲓⲧⲉ
ⲛⲓⲙⲧⲉ	ⲛⲓⲙ|ⲧⲉ
ⲉⲡⲁⲣⲁⲛ	ⲉ|ⲡⲁ|ⲣⲁⲛ
ⲛⲕⲗⲁⲇⲟⲥ	ⲛ|ⲕⲗⲁⲇⲟⲥ
ⲛⲛⲉⲕⲉⲓⲟⲧⲉ	ⲛ|ⲛⲉⲕ|ⲉⲓⲟⲧⲉ
ⲉⲧⲃⲉⲧϩⲉ	ⲉⲧⲃⲉ|ⲧ|ϩⲉ
ⲛⲇⲓⲕⲁⲓⲟⲥⲩⲛⲏ	ⲛ|ⲇⲓⲕⲁⲓⲟⲥⲩⲛⲏ
ⲛⲥⲁⲃⲏⲗ	ⲛⲥⲁⲃⲏⲗ
ⲡⲁⲩⲗⲟⲥ	ⲡⲁⲩⲗⲟⲥ
ⲉⲧϩⲁⲉⲟⲟⲩ	ⲉⲧ|ϩⲁ|ⲉⲟⲟⲩ
ⲉⲧⲃⲉⲟⲩ	ⲉⲧⲃⲉ|ⲟⲩ
ⲉⲧⲉⲡⲁⲓⲡⲉ	ⲉⲧⲉ|ⲡⲁⲓ|ⲡⲉ
ϫⲉϩⲏⲗⲉⲓⲁⲥⲡⲉ	ϫⲉ|ϩⲏⲗⲉⲓⲁⲥ|ⲡⲉ
ⲛⲉϥϭⲓϫ	ⲛⲉϥ|ϭⲓϫ
ⲛⲧⲉⲥⲃⲱ	ⲛ|ⲧⲉ|ⲥⲃⲱ
ⲛⲥⲉⲣϩⲙϩⲁⲗ	ⲛ|ⲥⲉ|ⲣ|ϩⲙϩⲁⲗ
ⲙⲛⲁⲛⲧⲓⲭⲣⲓⲥⲧⲟⲥ	ⲙⲛ|ⲁⲛⲧⲓⲭⲣⲓⲥⲧⲟⲥ
ⲙⲛⲑⲱⲙⲁⲥ	ⲙⲛ|ⲑⲱⲙⲁⲥ
ϫⲉϥⲛⲏⲩ	ϫⲉ|ϥ|ⲛⲏⲩ
ⲁⲛⲣϣϥⲉ	ⲁ|ⲛ|ⲣϣϥⲉ
ⲡⲕⲩⲣⲏⲛⲁⲓⲟⲥ	ⲡ|ⲕⲩⲣⲏⲛⲁⲓⲟⲥ
ⲁϩⲣⲟϥ	ⲁϩⲣⲟ|ϥ
ⲙⲛϩⲱⲃ	ⲙⲛ|ϩⲱⲃ
ϫⲉⲛⲧⲕⲟⲩⲣⲙⲙⲙⲉ	ϫⲉ|ⲛⲧⲕ|ⲟⲩ|ⲣⲙⲙⲙⲉ
ⲁϩⲣⲟⲕ	ⲁϩⲣⲟ|ⲕ
ⲧⲉⲓϩⲓⲕⲱⲛ	ⲧⲉⲓ|ϩⲓⲕⲱⲛ
ⲉⲩⲙⲉϩ	ⲉ|ⲩ|ⲙⲉϩ
ⲙⲉⲣⲉⲗⲁⲁⲩ	ⲙⲉⲣⲉ|ⲗⲁⲁⲩ
ⲛⲉϥⲥⲟⲟⲩⲛ	ⲛⲉ|ϥ|ⲥⲟⲟⲩⲛ
ⲉⲥⲥⲟⲟⲩⲛ	ⲉ|ⲥ|ⲥⲟⲟⲩⲛ
ⲛⲇⲁⲩⲉⲓⲇ	ⲛ|ⲇⲁⲩⲉⲓⲇ
ϩⲛⲧⲙⲛⲧϩⲙϩⲁⲗ	ϩⲛ|ⲧ|ⲙⲛⲧϩⲙϩⲁⲗ
ⲕⲛⲁⲧⲃⲃⲟⲉⲓ	ⲕ|ⲛⲁ|ⲧⲃⲃⲟ|ⲉⲓ
ⲉⲩⲙⲟⲟϣⲉ	ⲉ|ⲩ|ⲙⲟⲟϣⲉ
ⲉϩⲟⲩⲉⲡⲱⲛϩ	ⲉϩⲟⲩⲉ|ⲡ|ⲱⲛϩ
ⲛⲧⲉⲣⲉϥϯ	ⲛⲧⲉⲣⲉ|ϥ|ϯ
ⲁϥϣⲱⲡⲉ	ⲁ|ϥ|ϣⲱⲡⲉ
ⲉⲛⲉⲩⲧⲟⲡⲟⲥ	ⲉ|ⲛⲉⲩ|ⲧⲟⲡⲟⲥ
ⲁⲩⲟϭⲧⲟⲩ	ⲁ|ⲩ|ⲟϭⲧ|ⲟⲩ
ⲛⲅϥⲓⲡⲉⲕϭⲗⲟϭ	ⲛ|ⲅ|ϥⲓ|ⲡⲉⲕ|ϭⲗⲟϭ
ⲛⲛⲟⲩⲃ	ⲛ|ⲛⲟⲩⲃ
ⲡⲉⲧⲛⲁϣⲧⲁⲩⲉ	ⲡ|ⲉⲧ|ⲛⲁ|ϣ|ⲧⲁⲩⲉ
ⲙⲛⲑⲁⲇⲇⲁⲓⲟⲥ	ⲙⲛ|ⲑⲁⲇⲇⲁⲓⲟⲥ
ⲙⲛⲙⲡⲁⲣⲑⲉⲛⲟⲥ	ⲙⲛ|ⲙ|ⲡⲁⲣⲑⲉⲛⲟⲥ
ⲙⲡⲟⲩⲛⲟⲉⲓ	ⲙⲡ|ⲟⲩ|ⲛⲟⲉⲓ
ⲉⲧⲡⲟⲗⲓⲥ	ⲉ|ⲧ|ⲡⲟⲗⲓⲥ
ⲛⲁⲓⲧⲉⲓ	ⲛ|ⲁⲓⲧⲉⲓ
ⲛⲕⲱⲧ	ⲛ|ⲕⲱⲧ
ⲙⲛⲛⲉⲣⲱⲟⲩ	ⲙⲛ|ⲛⲉ|ⲣⲱⲟⲩ
ⲉⲁⲛⲅⲟⲩϩⲓⲕⲁⲛⲟⲥ	ⲉ|ⲁⲛⲅ|ⲟⲩ|ϩⲓⲕⲁⲛⲟⲥ
ⲛⲉⲩⲛⲟⲩⲣⲱⲙⲉ	ⲛⲉ|ⲩⲛ|ⲟⲩ|ⲣⲱⲙⲉ
ⲙⲙⲟⲕ	ⲙⲙⲟ|ⲕ
ϫⲉⲁⲡⲧⲉ	ϫⲉ|ⲁ|ⲡ|ⲧⲉ
ⲁⲛⲟⲛϩⲉⲛϣⲃⲣⲣϩⲱⲃ	ⲁⲛⲟⲛ|ϩⲉⲛ|ϣⲃⲣ|ⲣϩⲱⲃ
ϩⲙⲡⲉⲛⲙⲉⲉⲩⲉ	ϩⲙ|ⲡⲉⲛ|ⲙⲉⲉⲩⲉ
ⲙⲛⲛⲉⲥⲟⲟⲩ	ⲙⲛ|ⲛⲉ|ⲥⲟⲟⲩ
ⲉⲣⲛⲧⲕ	ⲉ|ⲣⲛⲧ|ⲕ
ⲛⲟⲩⲟⲛ	ⲛ|ⲟⲩⲟⲛ
ⲛⲟⲩⲧⲙⲏ	ⲛ|ⲟⲩ|ⲧⲙⲏ|·
ⲛⲁⲛⲟⲩⲥ	ⲛⲁⲛⲟⲩ|ⲥ
ⲥⲉⲕⲱⲧⲉ	ⲥⲉ|ⲕⲱⲧⲉ
ⲉⲧⲧⲁⲉⲓⲏⲩ	ⲉⲧ|ⲧⲁⲉⲓⲏⲩ
ⲛⲧⲁϥⲁⲁϥ	ⲛⲧ|ⲁ|ϥ|ⲁⲁ|ϥ
ⲕⲟⲩⲙ	ⲕⲟⲩⲙ
ϩⲛⲁⲃⲣⲁϩⲁⲙ	ϩⲛ|ⲁⲃⲣⲁϩⲁⲙ
ⲁⲙⲁϩⲧⲉ	ⲁⲙⲁϩⲧⲉ
ⲉⲧⲉⲛϩⲏⲧϥ	ⲉⲧⲉ|ⲛ|ϩⲏⲧ|ϥ
ⲛⲁϭⲙϭⲟⲙ	ⲛⲁ|ϭⲙϭⲟⲙ
ⲉϥϭⲏⲡ	ⲉ|ϥ|ϭⲏⲡ
ⲙⲛⲛⲉⲓⲕⲟⲟⲩⲉ	ⲙⲛ|ⲛⲉⲓ|ⲕⲟⲟⲩⲉ
ⲓⲥⲁⲕ	ⲓⲥⲁⲕ
ⲛⲅϫⲓϩⲟ	ⲛ|ⲅ|ϫⲓϩⲟ
ⲁⲩⲕⲁⲡⲉⲩⲉⲓⲱⲧ	ⲁ|ⲩ|ⲕⲁ|ⲡⲉⲩ|ⲉⲓⲱⲧ
ⲡⲉⲧⲥⲙⲁⲙⲁⲁⲧ	ⲡ|ⲉⲧ|ⲥⲙⲁⲙⲁⲁⲧ
ϩⲛⲁⲩ	ϩⲛⲁⲩ
ⲉⲧϩⲁⲣⲟⲟⲩ	ⲉⲧ|ϩⲁⲣⲟ|ⲟⲩ
ⲥⲟⲫⲟⲥ	ⲥⲟⲫⲟⲥ
ⲙⲛⲛϩⲉⲗⲗⲏⲛ	ⲙⲛ|ⲛ|ϩⲉⲗⲗⲏⲛ
ⲁⲅⲱⲛⲓⲍⲉ	ⲁⲅⲱⲛⲓⲍⲉ
ⲛⲧⲉⲣⲟⲩϣⲟϫⲧ	ⲛⲧⲉⲣ|ⲟⲩ|ϣⲟϫⲧ
ϩⲓⲣⲛⲛⲣⲟ	ϩⲓⲣⲛ|ⲛ|ⲣⲟ
ⲉⲧⲉⲧⲛⲁⲛⲁⲅⲕⲁⲍⲉ	ⲉ|ⲧⲉⲧⲛ|ⲁⲛⲁⲅⲕⲁⲍⲉ
ⲁϥϭⲗⲙⲗⲱⲙϥ	ⲁ|ϥ|ϭⲗⲙⲗⲱⲙ|ϥ
ⲥⲉⲛⲁⲛⲁⲩ	ⲥⲉ|ⲛⲁ|ⲛⲁⲩ
ⲛⲧⲁϥⲁⲁⲛ	ⲛⲧ|ⲁ|ϥ|ⲁⲁ|ⲛ
ⲙⲡⲁⲓⲇⲁⲅⲱⲅⲟⲥ	ⲙ|ⲡⲁⲓⲇⲁⲅⲱⲅⲟⲥ
ⲁϥⲟⲩⲱϣⲧ	ⲁ|ϥ|ⲟⲩⲱϣⲧ
ⲛⲧⲉⲣⲉⲣⲟⲩϩⲉ	ⲛⲧⲉⲣⲉ|ⲣⲟⲩϩⲉ
ⲉⲧⲣⲉϩⲉⲛϣⲏⲣⲉ	ⲉ|ⲧⲣⲉ|ϩⲉⲛ|ϣⲏⲣⲉ
ⲉⲛⲉⲙⲡⲉⲕⲱ	ⲉⲛⲉ|ⲙⲡⲉ|ⲕⲱ
ⲡⲉⲛⲥⲱⲧⲏⲣ	ⲡⲉⲛ|ⲥⲱⲧⲏⲣ
ⲡⲉⲧⲙⲟⲧⲛ	ⲡ|ⲉⲧ|ⲙⲟⲧⲛ
ⲁⲗⲗⲁ	ⲁⲗⲗⲁ
ⲛⲧⲉⲩⲛⲟⲩ	ⲛ|ⲧⲉ|ⲩⲛⲟⲩ
ⲉⲧⲧⲉⲧⲛⲧⲁⲩⲟ	ⲉⲧ|ⲧⲉⲧⲛ|ⲧⲁⲩⲟ
ϫⲉⲁⲥⲗⲟ	ϫⲉ|ⲁ|ⲥ|ⲗⲟ
ⲙⲡⲉⲕⲥⲟⲛ	ⲙ|ⲡⲉⲕ|ⲥⲟⲛ
ⲛⲟⲩⲗⲁⲟⲥ	ⲛ|ⲟⲩ|ⲗⲁⲟⲥ
ⲉⲧⲉⲧⲛϣⲓⲧⲉ	ⲉ|ⲧⲉⲧⲛ|ϣⲓⲧⲉ
ⲧⲁⲣⲛϯ	ⲧⲁⲣ|ⲛ|ϯ
ⲙⲛⲁⲛⲇⲣⲉⲁⲥ	ⲙⲛ|ⲁⲛⲇⲣⲉⲁⲥ
ⲙⲛⲧⲁⲧⲥⲱⲧⲙ	ⲙⲛⲧⲁⲧⲥⲱⲧⲙ
ⲁⲩⲕⲁⲡⲙⲏⲏϣⲉ	ⲁ|ⲩ|ⲕⲁ|ⲡ|ⲙⲏⲏϣⲉ
ⲁⲩϣⲟⲟⲩⲉ	ⲁ|ⲩ|ϣⲟⲟⲩⲉ
ⲁϥϯⲟⲩⲣⲁⲛ	ⲁ|ϥ|ϯ|ⲟⲩ|ⲣⲁⲛ
ⲁⲩⲥⲟⲩⲱⲛϥ	ⲁ|ⲩ|ⲥⲟⲩⲱⲛ|ϥ
ⲉϩⲉⲛⲛⲩⲕⲧⲉⲣⲓⲥ	ⲉ|ϩⲉⲛ|ⲛⲩⲕⲧⲉⲣⲓⲥ
ⲛⲥⲟϭⲛ	ⲛ|ⲥⲟϭⲛ
ϩⲙⲡⲧⲟⲟⲩ	ϩⲙ|ⲡ|ⲧⲟⲟⲩ
ⲉⲧ	ⲉⲧ
ⲉⲧϩⲛⲧⲥⲩⲛⲁⲅⲱⲅⲏ	ⲉⲧ|ϩⲛ|ⲧ|ⲥⲩⲛⲁⲅⲱⲅⲏ
ϩⲙⲡⲉⲕⲣⲟ	ϩⲙ|ⲡⲉⲕ|ⲣⲟ
ⲉⲧⲟⲩⲉⲡⲓⲕⲁⲗⲉⲓ	ⲉⲧ|ⲟⲩ|ⲉⲡⲓⲕⲁⲗⲉⲓ
ⲉⲩϣⲟⲩⲱⲟⲩ	ⲉ|ⲩ|ϣⲟⲩⲱ|ⲟⲩ
ⲧⲏⲛⲟⲩ	ⲧⲏⲛⲟⲩ
ⲉϫⲱⲓ	ⲉϫⲱ|ⲓ
ⲉⲩϣⲟⲕϩ	ⲉ|ⲩ|ϣⲟⲕϩ
ϫⲉⲛⲁϣ	ϫⲉ|ⲛ|ⲁϣ
ⲙⲡⲉⲣⲡⲉ	ⲙ|ⲡⲉ|ⲣⲡⲉ
ⲛϩⲙϩⲁⲗ	ⲛ|ϩⲙϩⲁⲗ
ⲡⲃⲁⲣⲃⲁⲣⲟⲥ	ⲡ|ⲃⲁⲣⲃⲁⲣⲟⲥ
ⲛⲉⲧⲙⲟⲟϣⲉ	ⲛ|ⲉⲧ|ⲙⲟⲟϣⲉ
ⲙⲡⲧⲏⲣϥ	ⲙ|ⲡ|ⲧⲏⲣ|ϥ
ⲁϥⲙⲁϩⲟⲩⲥⲡⲟⲅⲅⲟⲥ	ⲁ|ϥ|ⲙⲁϩ|ⲟⲩ|ⲥⲡⲟⲅⲅⲟⲥ
ⲉⲙⲁⲣⲓⲁ	ⲉ|ⲙⲁⲣⲓⲁ
ϫⲉϭⲱ	ϫⲉ|ϭⲱ
ⲙⲡⲉⲧⲣⲟⲥ	ⲙ|ⲡⲉⲧⲣⲟⲥ
ϥϫⲱⲙⲙⲟⲥ	ϥ|ϫⲱ|ⲙⲙⲟ|ⲥ
ϩⲛⲧⲉⲕⲯⲩⲭⲏ	ϩⲛ|ⲧⲉⲕ|ⲯⲩⲭⲏ
ⲉϩⲉⲛⲭⲁⲣⲧⲏⲥ	ⲉ|ϩⲉⲛ|ⲭⲁⲣⲧⲏⲥ
ⲛⲕⲱ	ⲛ|ⲕⲱ
ϫⲉⲟⲩⲉϩⲧⲏⲩⲧⲛ	ϫⲉ|ⲟⲩⲉϩ|ⲧⲏⲩⲧⲛ
ϩⲱ	ϩⲱ
ⲫⲁⲣⲁⲱ	ⲫⲁⲣⲁⲱ
ⲉⲛⲧ	ⲉⲛⲧ
ⲛⲁⲡⲛⲟⲩⲧⲉ	ⲛⲁ|ⲡ|ⲛⲟⲩⲧⲉ
ⲁⲓⲣϣⲡⲏⲣⲉ	ⲁ|ⲓ|ⲣϣⲡⲏⲣⲉ
ⲕⲉⲩⲁ	ⲕⲉⲩⲁ
ⲛⲉⲧⲛϣⲟϫⲛⲉ	ⲛⲉⲧⲛ|ϣⲟϫⲛⲉ
ⲛⲉⲓϩⲁϩⲧⲉⲧⲏⲩⲧⲛ	ⲛⲉ|ⲓ|ϩⲁϩⲧⲉ|ⲧⲏⲩⲧⲛ
ⲛⲧⲉⲡⲓⲗⲁⲧⲟⲥ	ⲛⲧⲉ|ⲡⲓⲗⲁⲧⲟⲥ
ϩⲁⲧⲛⲧⲑⲁⲗⲁⲥⲥⲁ	ϩⲁⲧⲛ|ⲧ|ⲑⲁⲗⲁⲥⲥⲁ
ⲗⲟ	ⲗⲟ
ϩⲛⲛⲉⲩⲏⲓ	ϩⲛ|ⲛⲉⲩ|ⲏⲓ
ⲉⲛⲟⲩⲱⲛϩ	ⲉ|ⲛ|ⲟⲩⲱⲛϩ
ⲛⲁϯϩⲏⲩ	ⲛⲁ|ϯ|ϩⲏⲩ
ⲛⲧⲁϥⲧⲱϭⲉ	ⲛⲧ|ⲁ|ϥ|ⲧⲱϭⲉ
ⲛⲁϥ	ⲛⲁ|ϥ
ϣⲉ	ϣⲉ
ⲛⲥⲟⲩⲁ	ⲛ|ⲥⲟⲩⲁ
ⲙⲡⲧⲱϩⲙ	ⲙ|ⲡ|ⲧⲱϩⲙ
ⲛⲥⲧⲁⲩⲟ	ⲛ|ⲥ|ⲧⲁⲩⲟ
ⲛⲧⲉⲣⲉϥϣⲣⲡⲉⲓⲙⲉ	ⲛⲧⲉⲣⲉ|ϥ|ϣⲣⲡ|ⲉⲓⲙⲉ
ⲛⲉⲧⲧⲃⲃⲏⲩ	ⲛ|ⲉⲧ|ⲧⲃⲃⲏⲩ
ⲛⲧⲁϥϣⲱⲡⲉ	ⲛⲧ|ⲁ|ϥ|ϣⲱⲡⲉ
ⲛⲉⲥⲛⲏϫ	ⲛⲉ|ⲥ|ⲛⲏϫ
ϩⲛⲧⲟⲩⲧⲁⲡⲣⲟ	ϩⲛ|ⲧⲟⲩ|ⲧⲁⲡⲣⲟ
ⲛⲧⲁⲩϣⲱⲱⲧ	ⲛⲧ|ⲁ|ⲩ|ϣⲱⲱⲧ
ⲛϭⲟⲡϥ	ⲛ|ϭⲟⲡ|ϥ
ⲁⲩⲉⲓ	ⲁ|ⲩ|ⲉⲓ
ⲛϫⲁⲓⲉ	ⲛ|ϫⲁⲓⲉ
ϫⲉⲥⲟⲩⲧⲛⲧⲉⲕϭⲓϫ	ϫⲉ|ⲥⲟⲩⲧⲛ|ⲧⲉⲕ|ϭⲓϫ
ⲉⲥⲟⲛϩ	ⲉ|ⲥ|ⲟⲛϩ
ϣⲙⲟⲩⲛ	ϣⲙⲟⲩⲛ
ⲙⲡⲅⲁⲙⲟⲥ	ⲙ|ⲡ|ⲅⲁⲙⲟⲥ
ⲛⲥⲁ	ⲛ|ⲥⲁ
ⲉϩⲉⲛⲕⲟⲟⲩⲉ	ⲉ|ϩⲉⲛ|ⲕⲟⲟⲩⲉ
ϩⲛⲛⲉϥⲛⲟⲃⲉ	ϩⲛ|ⲛⲉϥ|ⲛⲟⲃⲉ
ⲛϩⲉⲛϣⲁϫⲉ	ⲛ|ϩⲉⲛ|ϣⲁϫⲉ
ⲕⲁⲗⲱⲥ	ⲕⲁⲗⲱⲥ
[	[
ⲉⲣⲉⲟⲩⲙⲏⲏϣⲉ	ⲉⲣⲉ|ⲟⲩ|ⲙⲏⲏϣⲉ
ⲁⲣⲧⲁⲓⲉⲡⲙⲁ	ⲁⲣ|ⲧⲁⲓⲉ|ⲡ|ⲙⲁ
ⲛⲛⲁϩⲣⲛ	ⲛ|ⲛⲁϩⲣⲛ
ⲉⲣⲉⲡⲣⲏ	ⲉⲣⲉ|ⲡ|ⲣⲏ
ⲁⲓϣⲣⲡϫⲱ	ⲁ|ⲓ|ϣⲣⲡ|ϫⲱ
ⲛⲉⲧⲟⲩⲱϣ	ⲛ|ⲉⲧ|ⲟⲩⲱϣ
ⲁϥⲙⲟⲩϩ	ⲁ|ϥ|ⲙⲟⲩϩ
ⲙⲛⲛⲉⲧⲛϩⲓⲥⲉ	ⲙⲛ|ⲛⲉⲧⲛ|ϩⲓⲥⲉ
ⲛⲧⲉⲣⲉϥϩⲙⲟⲟⲥ	ⲛⲧⲉⲣⲉ|ϥ|ϩⲙⲟⲟⲥ
ⲛⲧⲁⲓⲕⲟⲛⲥⲟⲩ	ⲛⲧ|ⲁ|ⲓ|ⲕⲟⲛⲥ|ⲟⲩ
ϫⲉⲙ[.....]ⲟⲓ	ϫⲉ|ⲙ[.....]ⲟⲓ
ⲉⲓⲧⲉ	ⲉⲓⲧⲉ
ⲉⲧϩⲏⲩ	ⲉⲧ|ϩⲏⲩ
ⲕⲁⲧⲁⲡⲉϥϩⲓⲥⲉ	ⲕⲁⲧⲁ|ⲡⲉϥ|ϩⲓⲥⲉ
ⲉϫⲛⲟⲩⲙⲛⲧⲣⲣⲟ	ⲉϫⲛ|ⲟⲩ|ⲙⲛⲧⲣⲣⲟ
ⲉⲡⲉϩⲟⲩⲟ	ⲉ|ⲡⲉ|ϩⲟⲩⲟ
ϩⲛⲧⲡⲁⲣⲣⲏⲥⲓⲁ	ϩⲛ|ⲧ|ⲡⲁⲣⲣⲏⲥⲓⲁ
ⲁⲩϣⲧⲟⲣⲧⲣ	ⲁ|ⲩ|ϣⲧⲟⲣⲧⲣ
ⲛⲛⲉϣⲡⲏⲓ	ⲛⲛⲉ|ϣ|ⲡ|ⲏⲓ
ⲁⲩⲥⲟⲩⲱⲛⲟⲩ	ⲁ|ⲩ|ⲥⲟⲩⲱⲛ|ⲟⲩ
ϩⲉⲛⲕⲟⲩⲓ	ϩⲉⲛ|ⲕⲟⲩⲓ
ⲛϩⲩⲡⲏⲣⲉⲧⲏⲥ	ⲛ|ϩⲩⲡⲏⲣⲉⲧⲏⲥ
ⲛⲧⲙⲛⲧⲣⲙⲙⲁⲟ	ⲛ|ⲧ|ⲙⲛⲧⲣⲙⲙⲁⲟ
ⲛⲧⲛⲥⲱⲧⲙ	ⲛ|ⲧⲛ|ⲥⲱⲧⲙ
ⲟⲩϩⲣϣⲓⲣⲉ	ⲟⲩ|ϩⲣϣⲓⲣⲉ
ⲉⲧⲉϩⲥⲡⲁⲥⲱⲙⲁ	ⲉ|ⲧⲉϩⲥ|ⲡⲁ|ⲥⲱⲙⲁ
ⲧⲱⲱⲃⲉ	ⲧⲱⲱⲃⲉ
ⲉⲁⲣϫⲟⲟⲩ	ⲉ|ⲁⲣ|ϫⲟⲟⲩ
ⲟⲩϭⲉⲡⲏ	ⲟⲩ|ϭⲉⲡⲏ
ⲧⲙⲉ	ⲧ|ⲙⲉ
ⲡⲣⲣⲟ	ⲡ|ⲣⲣⲟ
ⲛⲅⲙⲟⲟϣⲉ	ⲛ|ⲅ|ⲙⲟⲟϣⲉ
ⲻ	ⲻ
ϥⲓ	ϥⲓ
ⲉⲧⲉⲧⲛⲟ	ⲉ|ⲧⲉⲧⲛ|ⲟ
ⲛⲙⲙⲉ	ⲛⲙⲙ|ⲉ
ⲥⲁⲣⲝ	ⲥⲁⲣⲝ
ⲛⲉⲧϩⲓϫⲱⲟⲩ	ⲛ|ⲉⲧ|ϩⲓϫⲱ|ⲟⲩ
ⲛϩⲉⲛⲛⲟϭ	ⲛ|ϩⲉⲛ|ⲛⲟϭ
ⲛⲥⲁⲉⲓⲛ	ⲛ|ⲥⲁⲉⲓⲛ
ϫⲉⲛⲉⲩⲑⲗⲓⲃⲉ	ϫⲉ|ⲛ|ⲉ|ⲩ|ⲑⲗⲓⲃⲉ
ⲍⲉⲃⲉⲇⲁⲓⲟⲥ	ⲍⲉⲃⲉⲇⲁⲓⲟⲥ
ⲧⲁⲉⲓⲟⲩ	ⲧⲁⲉⲓⲟ|ⲩ
ⲙⲛⲛϫⲁⲓⲃⲉⲕⲉ	ⲙⲛ|ⲛ|ϫⲁⲓⲃⲉⲕⲉ
ⲛⲣⲟⲩϩⲉ	ⲛ|ⲣⲟⲩϩⲉ
ⲉⲧϥⲛϩⲏⲧϥ	ⲉⲧ|ϥ|ⲛϩⲏⲧ|ϥ
..	..
ⲁⲙⲱⲛⲁ	ⲁⲙⲱⲛⲁ
ⲙⲛⲓⲁⲕⲱⲃ	ⲙⲛ|ⲓⲁⲕⲱⲃ
ⲙⲡⲙⲛⲧⲥⲛⲟⲟⲩⲥ	ⲙ|ⲡ|ⲙⲛⲧⲥⲛⲟⲟⲩⲥ
ⲛⲛⲉϥⲙⲩⲥⲧⲏⲣⲓⲟⲛ	ⲛ|ⲛⲉϥ|ⲙⲩⲥⲧⲏⲣⲓⲟⲛ
ⲡⲉⲕⲛⲟⲩⲧⲉ	ⲡⲉⲕ|ⲛⲟⲩⲧⲉ
ⲡⲉⲧϩⲛⲧⲥⲱϣⲉ	ⲡ|ⲉⲧ|ϩⲛ|ⲧ|ⲥⲱϣⲉ
ⲡϩⲗⲗⲟ	ⲡ|ϩⲗⲗⲟ
ϫⲉⲡⲙⲁ	ϫⲉ|ⲡ|ⲙⲁ
ϫⲉⲁⲃⲃⲁ	ϫⲉ|ⲁⲃⲃⲁ
ⲟⲩⲡⲟⲣⲛⲉⲓⲁ	ⲟⲩ|ⲡⲟⲣⲛⲉⲓⲁ
ϩⲓⲁⲃⲓⲁⲑⲁⲣ	ϩⲓ|ⲁⲃⲓⲁⲑⲁⲣ
ⲛⲧⲁⲡϫⲟⲉⲓⲥ	ⲛⲧ|ⲁ|ⲡ|ϫⲟⲉⲓⲥ
ⲉⲧⲃⲉⲡⲁⲓ	ⲉⲧⲃⲉ|ⲡⲁⲓ
ⲛⲧⲁϥⲕⲁⲧⲁⲫⲣⲟⲛⲉⲓ	ⲛ|ⲧⲁ|ϥ|ⲕⲁⲧⲁⲫⲣⲟⲛⲉⲓ
ⲙⲡⲉϥⲥⲁϩⲟⲩ	ⲙ|ⲡⲉ|ϥ|ⲥⲁϩⲟⲩ
ⲧϩⲓⲉⲣⲟⲥⲟⲗⲩⲙⲁ	ⲧ|ϩⲓⲉⲣⲟⲥⲟⲗⲩⲙⲁ
ⲛⲧⲉϣⲧⲙⲣⲱ	ⲛⲧⲉ|ϣⲧⲙ|ⲣⲱ
ⲙⲙⲛⲧⲉⲣⲱⲙⲉ	ⲙⲙⲛⲧⲉ|ⲣⲱⲙⲉ
ⲛϭⲓⲛⲣⲱⲙⲉ	ⲛϭⲓ|ⲛ|ⲣⲱⲙⲉ
ⲛϭⲓⲧⲁⲅⲉⲗⲏ	ⲛϭⲓ|ⲧ|ⲁⲅⲉⲗⲏ
ϯⲛⲁⲙⲟⲩ	ϯ|ⲛⲁ|ⲙⲟⲩ
ⲛⲕⲉⲡⲛⲉⲩⲙⲁ	ⲛ|ⲕⲉ|ⲡⲛⲉⲩⲙⲁ
ⲡⲣⲁⲛ	ⲡ|ⲣⲁⲛ
ⲉⲩⲛⲕⲟⲧⲕ	ⲉ|ⲩ|ⲛⲕⲟⲧⲕ
ⲛⲉⲛⲧⲁⲩⲡⲗⲁⲥⲥⲉ	ⲛⲉ|ⲛⲧ|ⲁ|ⲩ|ⲡⲗⲁⲥⲥⲉ
ϫⲛⲙⲡⲱⲣ	ϫⲛ|ⲙⲡⲱⲣ
ϩⲛⲛⲉϥⲙⲁⲑⲏⲧⲏⲥ	ϩⲛ|ⲛⲉϥ|ⲙⲁⲑⲏⲧⲏⲥ
ⲛⲙⲧⲉⲑⲁⲗⲁⲥⲥⲁ	ⲛⲙ|ⲧⲉ|ⲑⲁⲗⲁⲥⲥⲁ
ⲛⲧⲉⲧⲛⲥⲟⲟⲩⲛ	ⲛ|ⲧⲉⲧⲛ|ⲥⲟⲟⲩⲛ
ϩⲓⲧⲛⲧⲥⲟⲫⲓⲁ	ϩⲓⲧⲛ|ⲧ|ⲥⲟⲫⲓⲁ
ⲁⲛⲟⲕⲡⲉ	ⲁⲛⲟⲕ|ⲡⲉ
ⲕⲁⲧⲁϣⲁ	ⲕⲁⲧⲁ|ϣⲁ
ⲇⲉ	ⲇⲉ
ⲁⲩⲧⲁⲗϭⲟⲟⲩ	ⲁ|ⲩ|ⲧⲁⲗϭⲟ|ⲟⲩ
ⲉⲛⲧⲁⲩϫⲟⲟⲥ	ⲉⲛⲧ|ⲁ|ⲩ|ϫⲟⲟ|ⲥ
ⲙⲡⲓⲁⲛⲟⲙⲟⲥ	ⲙ|ⲡⲓ|ⲁⲛⲟⲙⲟⲥ
ⲧⲁⲓⲱⲥⲏ	ⲧⲁ|ⲓⲱⲥⲏ
ⲡⲏⲧ	ⲡⲏⲧ
ⲉⲩⲣⲟⲩⲟⲉⲓⲛ	ⲉ|ⲩ|ⲣⲟⲩⲟⲉⲓⲛ
ϣⲧⲁⲙ	ϣⲧⲁⲙ
ⲉⲟⲩⲟⲙⲟⲩ	ⲉ|ⲟⲩⲟⲙ|ⲟⲩ
ϩⲙⲡⲓⲥⲣⲁⲏⲗ	ϩⲙ|ⲡ|ⲓⲥⲣⲁⲏⲗ
ⲙⲡⲉϥⲧⲟⲟⲩⲉ	ⲙ|ⲡⲉϥ|ⲧⲟⲟⲩⲉ
ⲉⲧⲣⲉⲛϩⲱ	ⲉ|ⲧⲣⲉ|ⲛ|ϩⲱ
ⲛⲉⲩϩⲁ	ⲛ|ⲉⲩϩⲁ
ⲟⲩⲏⲩ	ⲟⲩⲏⲩ
ⲡⲉⲧⲛⲏⲩ	ⲡ|ⲉⲧ|ⲛⲏⲩ
ⲉⲧⲣⲉⲩϭⲟⲡϥ	ⲉ|ⲧⲣⲉ|ⲩ|ϭⲟⲡ|ϥ
ϫⲉⲛⲥⲉⲣⲭⲣⲉⲓⲁ	ϫⲉ|ⲛ|ⲥⲉ|ⲣⲭⲣⲉⲓⲁ
ⲛⲣⲁⲛ	ⲛ|ⲣⲁⲛ
ⲙⲡⲥⲁⲓⲛ	ⲙ|ⲡ|ⲥⲁⲓⲛ
ⲛϭⲓⲓⲟⲩⲇⲁⲥ	ⲛϭⲓ|ⲓⲟⲩⲇⲁⲥ
ⲙⲙⲛⲧⲥⲁⲃⲉ	ⲙ|ⲙⲛⲧⲥⲁⲃⲉ
ⲉⲩϣⲗⲏⲗ	ⲉ|ⲩ|ϣⲗⲏⲗ
ⲉⲛⲧⲁⲥⲉⲓ	ⲉ|ⲛⲧ|ⲁ|ⲥ|ⲉⲓ
ⲉⲧⲉⲧⲛϣⲁⲛϩⲱⲡ	ⲉⲧⲉⲧⲛϣⲁⲛ|ϩⲱⲡ
ϥϭⲏⲡ	ϥ|ϭⲏⲡ
ϫⲉϥⲛⲁⲣϣⲟⲣⲡ	ϫⲉ|ϥ|ⲛⲁ|ⲣϣⲟⲣⲡ
ⲡⲁⲥⲛⲟϥ	ⲡⲁ|ⲥⲛⲟϥ
ⲛⲛⲁⲣⲭⲓⲉⲣⲉⲩⲥ	ⲛ|ⲛ|ⲁⲣⲭⲓⲉⲣⲉⲩⲥ
ⲙⲛⲛⲁⲧⲛⲟⲩⲧⲉ	ⲙⲛ|ⲛ|ⲁⲧ|ⲛⲟⲩⲧⲉ
ⲟⲛⲧⲉ	ⲟⲛⲧⲉ
ⲉϫⲙⲡⲉⲩⲟⲩⲱϣ	ⲉϫⲙ|ⲡⲉⲩ|ⲟⲩⲱϣ
ⲡⲥⲁϩ	ⲡ|ⲥⲁϩ
ⲛⲁⲁⲁϥ	ⲛⲁ|ⲁⲁ|ϥ
ⲉⲩϩⲙⲡϫⲟⲉⲓ	ⲉ|ⲩ|ϩⲙ|ⲡ|ϫⲟⲉⲓ
ⲛⲉⲩⲫⲟⲣⲉⲓ	ⲛⲉ|ⲩ|ⲫⲟⲣⲉⲓ
ⲛⲧϭⲓϫ	ⲛ|ⲧ|ϭⲓϫ
ϩⲁϩⲟⲩⲟ	ϩⲁ|ϩⲟⲩⲟ
ⲧⲁⲉⲓⲃⲉ	ⲧⲁ|ⲉⲓⲃⲉ
ⲉⲓⲥⲱⲟⲩ	ⲉ|ⲓ|ⲥⲱⲟⲩ
ϫⲉⲥⲟⲩⲧⲛ	ϫⲉ|ⲥⲟⲩⲧⲛ
ⲁⲥⲃⲱⲕ	ⲁ|ⲥ|ⲃⲱⲕ
ⲉⲥⲉⲙⲧⲟⲛ	ⲉ|ⲥⲉ|ⲙⲧⲟⲛ
ⲉⲁⲩⲟⲩⲱⲛ	ⲉ|ⲁ|ⲩ|ⲟⲩⲱⲛ
ⲛⲥⲉⲛⲏⲥⲧⲉⲩⲉ	ⲛ|ⲥⲉ|ⲛⲏⲥⲧⲉⲩⲉ
ⲉⲡⲉⲧⲣⲟⲥ	ⲉ|ⲡⲉⲧⲣⲟⲥ
ⲛⲕⲁⲃⲟⲗ	ⲛ|ⲕⲁ|ⲃⲟⲗ
ⲛⲉⲥⲟⲩⲱϣ	ⲛⲉ|ⲥ|ⲟⲩⲱϣ
ⲉⲑⲁⲉⲓⲧ	ⲉ|ⲑ|ⲁⲉⲓⲧ
ⲉⲣⲟⲩⲱϣ	ⲉⲣ|ⲟⲩⲱϣ
ⲧⲁⲓⲟⲥ	ⲧⲁⲓⲟ|ⲥ
ⲡⲉⲧⲛⲁϩⲩⲡⲟⲙⲓⲛⲉ	ⲡ|ⲉⲧ|ⲛⲁ|ϩⲩⲡⲟⲙⲓⲛⲉ
ⲉⲣⲉⲟⲩⲙⲟϫ	ⲉⲣⲉ|ⲟⲩ|ⲙⲟϫ
ⲛⲉⲙⲡⲁⲧⲉⲧⲛⲉϣϭⲙϭⲟⲙ	ⲛⲉ|ⲙⲡⲁⲧ|ⲉⲧⲛ|ⲉϣ|ϭⲙϭⲟⲙ
ⲡⲉⲛⲧⲁϥⲁⲩⲝⲁⲛⲉ	ⲡ|ⲉⲛⲧ|ⲁ|ϥ|ⲁⲩⲝⲁⲛⲉ
ⲛⲧⲁⲧⲉⲧⲛⲣϩⲏⲃⲉ	ⲛⲧ|ⲁ|ⲧⲉⲧⲛ|ⲣϩⲏⲃⲉ
ⲛⲛϩⲉⲑⲛⲟⲥ	ⲛ|ⲛ|ϩⲉⲑⲛⲟⲥ
ⲁⲩⲁⲣⲭⲓⲧⲗⲕ	ⲁ|ⲩ|ⲁⲣⲭⲓⲧⲗⲕ
ⲟⲩϩⲟⲩⲟ	ⲟⲩ|ϩⲟⲩⲟ
ⲁⲩⲛⲟϫϥ	ⲁ|ⲩ|ⲛⲟϫ|ϥ
ϣⲁⲩϫⲓⲧϥ	ϣⲁ|ⲩ|ϫⲓⲧ|ϥ
ⲙⲡⲉⲧⲥⲏϭ	ⲙ|ⲡ|ⲉⲧ|ⲥⲏϭ
ⲙⲛⲛⲥⲁ	ⲙⲛⲛⲥⲁ
ⲙⲡⲥⲁⲃⲃⲁⲧⲟⲛ	ⲙ|ⲡ|ⲥⲁⲃⲃⲁⲧⲟⲛ
ⲉϥϭⲟⲟⲗⲉ	ⲉ|ϥ|ϭⲟⲟⲗⲉ
ⲉⲣⲉⲡⲟⲩϩⲏⲧ	ⲉⲣⲉ|ⲡⲟⲩ|ϩⲏⲧ
ⲛϭⲓⲡⲛⲟⲩⲧⲉ	ⲛϭⲓ|ⲡ|ⲛⲟⲩⲧⲉ
ϩⲉⲛϯⲧⲱⲛ	ϩⲉⲛ|ϯⲧⲱⲛ
ⲛⲧⲁⲧⲉⲧⲛϫⲟⲟⲥ	ⲛⲧⲁ|ⲧⲉⲧⲛ|ϫⲟⲟ|ⲥ
ⲉⲙⲡⲁⲧⲉⲧⲛⲉϣϭⲙϭⲟⲙ	ⲉ|ⲙⲡⲁⲧ|ⲉⲧⲛ|ⲉϣ|ϭⲙϭⲟⲙ
ⲛⲛⲣⲉϥϫⲓⲛϭⲟⲛⲥ	ⲛ|ⲛ|ⲣⲉϥϫⲓⲛϭⲟⲛⲥ
ⲣⲁϩⲧϥ	ⲣⲁϩⲧ|ϥ
ϣⲁⲩⲥⲕⲁⲛⲇⲁⲗⲓⲍⲉ	ϣⲁ|ⲩ|ⲥⲕⲁⲛⲇⲁⲗⲓⲍⲉ
ⲣⲟⲟⲩϣ	ⲣⲟⲟⲩϣ
ⲛⲉϥⲟⲩⲱϣ	ⲛⲉ|ϥ|ⲟⲩⲱϣ
ⲕⲛⲁⲣⲁϣⲉ	ⲕ|ⲛⲁ|ⲣⲁϣⲉ
ⲛⲟⲩⲱⲛⲉ	ⲛ|ⲟⲩ|ⲱⲛⲉ
ⲛⲧⲑⲁⲗⲁⲥⲥⲁ	ⲛ|ⲧ|ⲑⲁⲗⲁⲥⲥⲁ
ⲛⲕⲣⲟϥ	ⲛ|ⲕⲣⲟϥ
ϫⲉⲕⲡⲁⲣⲁⲃⲁ	ϫⲉ|ⲕ|ⲡⲁⲣⲁⲃⲁ
ⲙⲡⲉⲧⲛⲙⲁⲥⲉ	ⲙ|ⲡⲉⲧⲛ|ⲙⲁⲥⲉ
ⲛⲧⲙⲁⲁⲩ	ⲛ|ⲧ|ⲙⲁⲁⲩ
ⲛⲧⲛⲛⲁⲩ	ⲛ|ⲧⲛ|ⲛⲁⲩ
ⲉⲩϯⲉⲟⲟⲩ	ⲉ|ⲩ|ϯ|ⲉⲟⲟⲩ
ⲧⲉⲟ	ⲧⲉ|ⲟ
ⲉⲧⲣⲉⲛⲙⲉⲧⲁⲛⲟⲓ	ⲉ|ⲧⲣⲉ|ⲛ|ⲙⲉⲧⲁⲛⲟⲓ
ϩⲛⲧⲉⲓⲟⲩϣⲏ	ϩⲛ|ⲧⲉⲓ|ⲟⲩϣⲏ
ⲛⲧⲟϥ	ⲛⲧⲟϥ
ⲉⲧⲣⲉⲩⲛⲟϫⲟⲩ	ⲉ|ⲧⲣⲉ|ⲩ|ⲛⲟϫ|ⲟⲩ
ⲁⲧⲉⲧⲛⲣⲣⲣⲟ	ⲁ|ⲧⲉⲧⲛ|ⲣⲣⲣⲟ
ⲛⲧⲁⲁⲛⲉⲡⲣⲟⲫⲏⲧⲏⲥ	ⲛⲧⲁ|ⲁ|ⲛⲉ|ⲡⲣⲟⲫⲏⲧⲏⲥ
ⲉⲙⲟⲟϣⲉ	ⲉ|ⲙⲟⲟϣⲉ
ϩⲙⲡⲟⲩⲣⲁⲛ	ϩⲙ|ⲡⲟⲩ|ⲣⲁⲛ
ϩⲓⲉⲣⲟⲩⲥⲁⲗⲏⲙ	ϩⲓⲉⲣⲟⲩⲥⲁⲗⲏⲙ
ⲁⲑⲉⲧⲓ	ⲁⲑⲉⲧⲓ
ⲡⲉⲧⲁⲛⲁⲕⲣⲓⲛⲉ	ⲡ|ⲉⲧ|ⲁⲛⲁⲕⲣⲓⲛⲉ
ⲉⲩⲙⲟⲕϩ	ⲉ|ⲩ|ⲙⲟⲕϩ
ⲛⲧⲉⲥⲉⲓ	ⲛ|ⲧⲉ|ⲥⲉⲓ
ϩⲛⲧⲃⲱⲛⲉⲗⲟⲟⲗⲉ	ϩⲛ|ⲧ|ⲃⲱ|ⲛ|ⲉⲗⲟⲟⲗⲉ
ϫⲉϥϩⲛⲟⲩⲏⲓ	ϫⲉ|ϥ|ϩⲛ|ⲟⲩ|ⲏⲓ
ⲛϥⲛⲕⲟⲧⲕ	ⲛ|ϥ|ⲛⲕⲟⲧⲕ
ⲉⲧⲉⲧⲛⲙⲟⲟϣⲉ	ⲉ|ⲧⲉⲧⲛ|ⲙⲟⲟϣⲉ
ϩⲓⲕⲟⲧⲥ	ϩⲓ|ⲕⲟⲧⲥ
ϣⲁⲩⲗⲟ	ϣⲁ|ⲩ|ⲗⲟ
ⲡⲉϫⲉⲟⲩⲁ	ⲡⲉϫⲉ|ⲟⲩⲁ
ⲟⲩⲟⲉⲓϣ	ⲟⲩⲟⲉⲓϣ
ⲉⲥⲉⲏⲣⲡ	ⲉ|ⲥⲉ|ⲏⲣⲡ
ⲉϫⲛϩⲁϩ	ⲉϫⲛ|ϩⲁϩ
ⲁⲩⲧⲱⲟⲩⲛ	ⲁ|ⲩ|ⲧⲱⲟⲩⲛ
ⲛϩⲉⲛⲣⲉϥϣⲙϣⲉ	ⲛ|ϩⲉⲛ|ⲣⲉϥϣⲙϣⲉ
ϫⲉⲉⲩⲉⲙⲉⲧⲁⲛⲟⲉⲓ	ϫⲉ|ⲉⲩⲉ|ⲙⲉⲧⲁⲛⲟⲉⲓ
ⲧⲉⲛⲁⲅⲁⲡⲏ	ⲧⲉ|ⲛ|ⲁⲅⲁⲡⲏ
ⲉⲧⲛⲁⲣⲛⲟⲃⲉ	ⲉⲧ|ⲛⲁ|ⲣ|ⲛⲟⲃⲉ
ⲛⲛⲉⲧⲑⲗⲓⲃⲉ	ⲛ|ⲛ|ⲉⲧ|ⲑⲗⲓⲃⲉ
ⲙⲏⲡⲱⲥ	ⲙⲏⲡⲱⲥ
ϩⲛⲛⲱⲛⲉ	ϩⲛ|ⲛ|ⲱⲛⲉ
ⲛⲥⲉⲧⲙⲥⲱⲧⲙ	ⲛ|ⲥⲉ|ⲧⲙ|ⲥⲱⲧⲙ
ⲧⲱⲙ	ⲧⲱⲙ
ϩⲙⲡⲉϩⲟⲩⲟ	ϩⲙ|ⲡⲉ|ϩⲟⲩⲟ
ϣⲁⲡⲉϩⲟⲟⲩ	ϣⲁ|ⲡⲉ|ϩⲟⲟⲩ
ⲟⲩⲛ	ⲟⲩⲛ
ⲉⲧⲃⲏⲏⲧⲟⲩ·	ⲉⲧⲃⲏⲏⲧ|ⲟⲩ|·
ⲙⲛⲛⲛⲟϭ	ⲙⲛ|ⲛ|ⲛⲟϭ
ⲉⲧⲛⲁⲧⲁϫⲣⲉⲧⲏⲩⲧⲛ	ⲉⲧ|ⲛⲁ|ⲧⲁϫⲣⲉ|ⲧⲏⲩⲧⲛ
ⲁϥϫⲓⲧϥ	ⲁ|ϥ|ϫⲓⲧ|ϥ
ϩⲓⲙⲉ	ϩⲓ|ⲙⲉ
ⲕⲁⲧⲁⲡϣⲁϫⲉ	ⲕⲁⲧⲁ|ⲡ|ϣⲁϫⲉ
ⲁⲩⲧⲁⲟⲩⲟ	ⲁ|ⲩ|ⲧⲁⲟⲩⲟ
ⲛϣⲱⲡⲉ	ⲛ|ϣⲱⲡⲉ
ⲁϥⲁⲛⲁⲭⲱⲣⲉⲓ	ⲁ|ϥ|ⲁⲛⲁⲭⲱⲣⲉⲓ
ϩⲛϩⲱⲃ	ϩⲛ|ϩⲱⲃ
ⲣⲟⲟⲩⲧ	ⲣⲟⲟⲩⲧ
ⲛⲧⲉⲣⲉϥϫⲓ	ⲛⲧⲉⲣⲉ|ϥ|ϫⲓ
ⲣϣⲡⲏⲣⲉ	ⲣϣⲡⲏⲣⲉ
ϩⲓϫⲛⲧⲙⲏⲧⲉ	ϩⲓϫⲛ|ⲧ|ⲙⲏⲧⲉ
ⲛⲧⲛϣⲱⲡⲉ	ⲛ|ⲧⲛ|ϣⲱⲡⲉ
ϫⲉⲟⲩⲛ	ϫⲉ|ⲟⲩⲛ
ϩⲱⲃ	ϩⲱⲃ
ϫⲉϯⲛⲁⲧⲁⲕⲟ	ϫⲉ|ϯ|ⲛⲁ|ⲧⲁⲕⲟ
ⲧⲛϩⲟⲥⲉ	ⲧⲛ|ϩⲟⲥⲉ
ⲙⲛϩⲣⲟⲩⲫⲟⲥ	ⲙⲛ|ϩⲣⲟⲩⲫⲟⲥ
ⲉϫⲛⲛⲉⲧⲡⲏⲧ	ⲉϫⲛ|ⲛ|ⲉⲧ|ⲡⲏⲧ
ⲛⲧⲣⲉⲩⲣϩⲏⲃⲉ	ⲛ|ⲧⲣⲉ|ⲩ|ⲣϩⲏⲃⲉ
ϫⲉⲁⲩⲛⲁⲩ	ϫⲉ|ⲁ|ⲩ|ⲛⲁⲩ
ⲉⲡⲥⲱⲧⲉ	ⲉ|ⲡ|ⲥⲱⲧⲉ
ⲟⲩⲙⲛⲧⲥⲁⲃⲉ	ⲟⲩ|ⲙⲛⲧⲥⲁⲃⲉ
ⲡⲉϥⲭⲣⲓⲥⲧⲟⲥ	ⲡⲉϥ|ⲭⲣⲓⲥⲧⲟⲥ
ⲙⲙⲟⲛ	ⲙⲙⲟ|ⲛ
ϫⲉⲁⲙⲟⲩ	ϫⲉ|ⲁⲙⲟⲩ
ⲉⲧⲃⲉⲡⲉⲛϫⲟⲉⲓⲥ	ⲉⲧⲃⲉ|ⲡⲉⲛ|ϫⲟⲉⲓⲥ
ϫⲉⲙⲁⲣⲉⲛⲧⲁⲙⲓⲟ	ϫⲉ|ⲙⲁⲣⲉ|ⲛ|ⲧⲁⲙⲓⲟ
ⲙⲡⲡⲟⲛⲏⲣⲟⲥ	ⲙ|ⲡ|ⲡⲟⲛⲏⲣⲟⲥ
ⲉⲩⲥⲟⲃⲧⲉ	ⲉ|ⲩ|ⲥⲟⲃⲧⲉ
ⲉⲁⲧⲉⲧⲛⲕⲱ	ⲉ|ⲁ|ⲧⲉⲧⲛ|ⲕⲱ
ⲉⲁⲧⲉⲧⲛⲉⲡ	ⲉ|ⲁ|ⲧⲉⲧⲛ|ⲉⲡ
ⲧⲁⲧⲙⲁⲡⲁⲛⲧⲁ	ⲧⲁ|ⲧⲙ|ⲁⲡⲁⲛⲧⲁ
ⲉⲥⲛⲕⲟⲧⲕ	ⲉ|ⲥ|ⲛⲕⲟⲧⲕ
ⲙⲛⲛϩⲉⲑⲛⲟⲥ	ⲙⲛ|ⲛ|ϩⲉⲑⲛⲟⲥ
ⲛⲥⲁⲧⲙⲉ	ⲛⲥⲁ|ⲧ|ⲙⲉ
ⲟⲩⲙⲁⲁⲩ	ⲟⲩ|ⲙⲁⲁⲩ
ⲉⲛⲁϣⲉⲥⲟⲩⲛⲧⲥ	ⲉ|ⲛⲁϣⲉ|ⲥⲟⲩⲛⲧ|ⲥ
ⲉϫⲛⲛⲉⲧϣⲱⲛⲉ	ⲉϫⲛ|ⲛ|ⲉⲧ|ϣⲱⲛⲉ
ⲛϩⲟⲩⲟ	ⲛϩⲟⲩⲟ
ⲉⲣⲏⲩ	ⲉⲣⲏⲩ
ϩⲓⲧⲁⲉⲓⲟ	ϩⲓ|ⲧⲁⲉⲓⲟ
ϫⲉⲟⲩⲡⲣⲟⲫⲏⲧⲏⲥⲡⲉ	ϫⲉ|ⲟⲩ|ⲡⲣⲟⲫⲏⲧⲏⲥ|ⲡⲉ
ϩⲛⲧⲉⲧⲛⲙⲏⲧⲉ	ϩⲛ|ⲧⲉⲧⲛ|ⲙⲏⲧⲉ
ⲉϥϣⲁⲛⲉⲓⲃⲉ	ⲉ|ϥ|ϣⲁⲛ|ⲉⲓⲃⲉ
ⲁⲩⲧⲁⲗⲟϥ	ⲁ|ⲩ|ⲧⲁⲗⲟ|ϥ
ⲛⲧⲁⲩⲉⲓⲣⲉ	ⲛⲧ|ⲁ|ⲩ|ⲉⲓⲣⲉ
ⲛⲧⲉⲧⲁⲙⲉⲧⲟⲩⲙⲁⲁⲩ	ⲛ|ⲧⲉ|ⲧⲁⲙⲉ|ⲧⲟⲩ|ⲙⲁⲁⲩ
ⲛϣⲗⲧⲙ	ⲛ|ϣⲗⲧⲙ
ϩⲙⲡⲉⲙϩⲁⲟⲩ	ϩⲙ|ⲡⲉ|ⲙϩⲁⲟⲩ
ⲛⲧⲉⲧⲛⲣⲗⲁⲁⲩ	ⲛ|ⲧⲉⲧⲛ|ⲣ|ⲗⲁⲁⲩ
ⲙⲉϥϫⲓϫⲣⲟⲡ	ⲙⲉ|ϥ|ϫⲓ|ϫⲣⲟⲡ
ⲉⲧϩⲁⲧⲛⲧⲏⲩⲧⲛ	ⲉⲧ|ϩⲁⲧⲛ|ⲧⲏⲩⲧⲛ
ⲉⲓⲏⲥⲟⲩⲥ	ⲉ|ⲓⲏⲥⲟⲩⲥ
ⲛⲛⲉⲧⲕⲱ	ⲛ|ⲛ|ⲉⲧ|ⲕⲱ
ⲉⲩⲉⲓⲣⲉ	ⲉ|ⲩ|ⲉⲓⲣⲉ
ⲛⲥⲁⲟⲩⲙⲛⲧⲙⲛⲧⲣⲉ	ⲛⲥⲁ|ⲟⲩ|ⲙⲛⲧⲙⲛⲧⲣⲉ
ⲉⲩⲯⲩⲭⲏ	ⲉ|ⲩ|ⲯⲩⲭⲏ
ⲉⲧⲃⲉⲛⲉⲧⲙⲟⲟⲩⲧ	ⲉⲧⲃⲉ|ⲛ|ⲉⲧ|ⲙⲟⲟⲩⲧ
ⲛⲧⲁⲥⲛⲁϩⲙⲉ	ⲛⲧ|ⲁ|ⲥ|ⲛⲁϩⲙⲉ
ⲙⲡϣⲟⲙⲛⲧ	ⲙ|ⲡ|ϣⲟⲙⲛⲧ
ⲛⲏⲧⲛⲛⲧⲉⲓϩⲉ	ⲛⲏ|ⲧⲛ|ⲛ|ⲧⲉⲓ|ϩⲉ
ⲉⲣⲡⲉⲧⲛⲁⲛⲟⲩϥ	ⲉⲣ|ⲡ|ⲉⲧ|ⲛⲁⲛⲟⲩ|ϥ
ⲛⲃⲁⲣⲟⲥ	ⲛ|ⲃⲁⲣⲟⲥ
ⲁϥⲣϩⲁϩ	ⲁ|ϥ|ⲣϩⲁϩ
ⲧⲉⲛϩⲩⲡⲟⲙⲟⲛⲏ	ⲧⲉⲛ|ϩⲩⲡⲟⲙⲟⲛⲏ
ϫⲉⲡⲁⲛⲟⲩⲧⲉ	ϫⲉ|ⲡⲁ|ⲛⲟⲩⲧⲉ
ⲙⲛⲟⲩⲗⲱϫϩ	ⲙⲛ|ⲟⲩ|ⲗⲱϫϩ
ⲛⲉⲩⲣϣⲡⲏⲣⲉ	ⲛⲉ|ⲩ|ⲣϣⲡⲏⲣⲉ
ⲧⲉⲧⲛⲡⲗⲁⲛⲁ	ⲧⲉⲧⲛ|ⲡⲗⲁⲛⲁ
ϣⲉⲉⲣⲉ	ϣⲉⲉⲣⲉ
ⲛⲧⲉϥⲙⲁⲁⲩ	ⲛ|ⲧⲉϥ|ⲙⲁⲁⲩ
ⲉⲡⲉⲓⲕⲣⲟ	ⲉ|ⲡⲉⲓ|ⲕⲣⲟ
ϫⲉⲁϩⲣⲱⲧⲛ	ϫⲉ|ⲁϩⲣⲱ|ⲧⲛ
ⲁⲩⲙⲟⲟⲩⲧϥ	ⲁ|ⲩ|ⲙⲟⲟⲩⲧ|ϥ
ⲙⲛⲧϩⲓⲉⲣⲟⲥⲟⲗⲩⲙⲁ	ⲙⲛ|ⲧ|ϩⲓⲉⲣⲟⲥⲟⲗⲩⲙⲁ
ϩⲣⲁⲓ	ϩⲣⲁⲓ
ⲉⲧⲥϩⲙⲟⲟⲥ	ⲉⲧ|ⲥ|ϩⲙⲟⲟⲥ
ⲁⲩⲙⲉⲉⲩⲉ	ⲁ|ⲩ|ⲙⲉⲉⲩⲉ
ⲟⲩⲛϭⲉ	ⲟⲩⲛ|ϭⲉ
ⲣϩⲛⲁϥ	ⲣϩⲛⲁ|ϥ
ⲛⲛⲉϩⲃⲏⲩⲉ	ⲛ|ⲛⲉ|ϩⲃⲏⲩⲉ
ⲛⲧϣⲁϥⲁⲁⲥ	ⲛⲧ|ϣⲁ|ϥ|ⲁⲁ|ⲥ
ϩⲛⲉⲇⲉⲙ	ϩⲛ|ⲉⲇⲉⲙ
ϩⲉⲛⲣⲱⲙⲉ	ϩⲉⲛ|ⲣⲱⲙⲉ
ⲉⲙⲁⲩ	ⲉⲙⲁⲩ
ϫⲉⲉⲣⲉϫⲉⲙⲉ	ϫⲉ|ⲉⲣⲉ|ϫⲉ|ⲙⲉ
ⲉⲧⲣⲉⲛⲡⲗⲁⲛⲁ	ⲉ|ⲧⲣⲉ|ⲛ|ⲡⲗⲁⲛⲁ
ⲥϫⲟⲟⲣ	ⲥ|ϫⲟⲟⲣ
ⲉⲓⲛⲁⲕⲱⲧ	ⲉ|ⲓ|ⲛⲁ|ⲕⲱⲧ
ⲉⲛⲉⲧⲛϭⲟⲟⲙ	ⲉ|ⲛⲉⲧⲛ|ϭⲟⲟⲙ
ϫⲉⲉϥⲉϥⲓ	ϫⲉ|ⲉ|ϥ|ⲉ|ϥⲓ
ϫⲡⲟ	ϫⲡⲟ
ⲛⲛⲉ	ⲛⲛⲉ
ⲙⲛⲁⲡⲁ	ⲙⲛ|ⲁⲡⲁ
ⲁϥϫⲓⲧⲥ	ⲁ|ϥ|ϫⲓⲧ|ⲥ
ⲛⲉϥⲥⲱⲛⲉ	ⲛⲉϥ|ⲥⲱⲛⲉ
ϩⲛⲕⲟⲣⲓⲛⲑⲟⲥ	ϩⲛ|ⲕⲟⲣⲓⲛⲑⲟⲥ
ⲙⲡⲓⲗⲁⲧⲟⲥ	ⲙ|ⲡⲓⲗⲁⲧⲟⲥ
ⲡⲃⲁⲡⲧⲓⲥⲧⲏⲥ	ⲡ|ⲃⲁⲡⲧⲓⲥⲧⲏⲥ
ⲉϯ	ⲉ|ϯ
ⲥⲉⲙⲟⲩⲧⲉ	ⲥⲉ|ⲙⲟⲩⲧⲉ
ⲉⲛⲕⲉⲧⲙⲙⲟ	ⲉ|ⲛ|ⲕⲉ|ⲧⲙⲙⲟ
ⲛϣⲁⲧⲉⲧⲛⲉⲓⲙⲉ	ⲛ|ϣⲁ|ⲧⲉⲧⲛ|ⲉⲓⲙⲉ
ⲟⲩⲛⲧⲁⲛ	ⲟⲩⲛⲧⲁ|ⲛ
ⲛⲁϣⲱⲟⲩ	ⲛⲁϣⲱ|ⲟⲩ
ⲉϥϩⲣⲁⲓ	ⲉ|ϥ|ϩⲣⲁⲓ
ⲙⲡⲉⲡⲕⲟⲥⲙⲟⲥ	ⲙⲡⲉ|ⲡ|ⲕⲟⲥⲙⲟⲥ
ⲟⲩⲉϩⲧⲏⲩⲧⲛ	ⲟⲩⲉϩ|ⲧⲏⲩⲧⲛ
ϩⲏⲧ	ϩⲏⲧ
ⲛⲧⲁⲩϣⲱⲡⲉ	ⲛⲧ|ⲁ|ⲩ|ϣⲱⲡⲉ
ⲉⲁϥⲁⲡⲟⲧⲁⲥⲥⲉ	ⲉ|ⲁ|ϥ|ⲁⲡⲟⲧⲁⲥⲥⲉ
ⲉϥⲥⲟⲟⲩⲛ	ⲉ|ϥ|ⲥⲟⲟⲩⲛ
ⲉϩⲉⲛⲣⲱⲙⲉ	ⲉ|ϩⲉⲛ|ⲣⲱⲙⲉ
ⲉⲧⲣⲉⲧⲛⲁⲁⲩ	ⲉ|ⲧⲣⲉ|ⲧⲛ|ⲁⲁ|ⲩ
ⲙⲡⲣⲧⲣⲉⲗⲁⲁⲩ	ⲙⲡⲣ|ⲧⲣⲉ|ⲗⲁⲁⲩ
ⲛⲉⲩⲛⲏⲥⲧⲉⲩⲉ	ⲛⲉ|ⲩ|ⲛⲏⲥⲧⲉⲩⲉ
ⲛⲧⲁⲟⲩⲉ	ⲛ|ⲧⲁ|ⲟⲩⲉ
ⲛⲧⲁⲉⲓⲙⲉ	ⲛⲧⲁ|ⲉⲓⲙⲉ
ⲉϥⲕⲏⲣⲩⲥⲥⲉ	ⲉ|ϥ|ⲕⲏⲣⲩⲥⲥⲉ
ⲉⲧⲛⲁⲧⲥⲉⲃⲉⲉⲓⲁⲧϥ	ⲉⲧ|ⲛⲁ|ⲧⲥⲉⲃⲉ|ⲉⲓⲁⲧ|ϥ
ϣⲡϩⲓⲥⲉ	ϣⲡ|ϩⲓⲥⲉ
ϩⲙⲟⲟⲥ	ϩⲙⲟⲟⲥ
ⲛⲉⲛⲥⲛⲏⲩ	ⲛⲉⲛ|ⲥⲛⲏⲩ
ⲛⲅⲛⲁⲙⲧⲟⲛ	ⲛ|ⲅ|ⲛⲁ|ⲙⲧⲟⲛ
ϩⲱⲱ	ϩⲱⲱ
ϩⲛⲛⲉⲕϣⲁϫⲉ	ϩⲛ|ⲛⲉⲕ|ϣⲁϫⲉ
ⲛⲥⲉⲣϣⲡⲏⲣⲉ	ⲛ|ⲥⲉ|ⲣϣⲡⲏⲣⲉ
ⲛⲧⲉⲣⲟⲩϯ	ⲛⲧⲉⲣ|ⲟⲩ|ϯ
ⲁⲥⲧⲁⲟⲩⲟ	ⲁ|ⲥ|ⲧⲁⲟⲩⲟ
ⲉⲧⲉⲧⲛⲉⲛⲁⲩ	ⲉ|ⲧⲉⲧⲛ|ⲉ|ⲛⲁⲩ
ⲛⲥⲛⲁⲣⲃⲟⲟⲛⲉ	ⲛ|ⲥ|ⲛⲁ|ⲣⲃⲟⲟⲛⲉ
ⲙⲡⲕⲱⲧⲉ	ⲙ|ⲡ|ⲕⲱⲧⲉ
ⲡϩⲗ̅ⲗⲟ	ⲡ|ϩⲗⲗⲟ
ϩⲛⲧⲉⲕϭⲟⲙ	ϩⲛ|ⲧⲉⲕ|ϭⲟⲙ
ϫⲉⲁⲓϯϩⲓⲥⲉ	ϫⲉ|ⲁ|ⲓ|ϯ|ϩⲓⲥⲉ
ⲉⲛⲉϥϩⲟⲉⲓⲧⲉ	ⲉ|ⲛⲉϥ|ϩⲟⲉⲓⲧⲉ
ⲛⲙϩⲉⲛϣⲡⲏⲣⲉ	ⲛⲙ|ϩⲉⲛ|ϣⲡⲏⲣⲉ
ⲧⲛⲁⲛⲉⲭⲉ	ⲧⲛ|ⲁⲛⲉⲭⲉ
ⲉⲧⲟⲩⲛⲁⲧⲁϣⲉⲟⲉⲓϣ	ⲉⲧ|ⲟⲩ|ⲛⲁ|ⲧⲁϣⲉⲟⲉⲓϣ
ⲉⲛⲧⲁⲩϣⲱⲡⲉ	ⲉⲛⲧ|ⲁ|ⲩ|ϣⲱⲡⲉ
ⲛϩⲣⲉⲃⲉⲕⲕⲁ	ⲛ|ϩⲣⲉⲃⲉⲕⲕⲁ
ϩⲛⲟⲩⲙⲛⲧⲛⲟⲩϫ	ϩⲛ|ⲟⲩ|ⲙⲛⲧⲛⲟⲩϫ
ⲁⲩⲥⲱ	ⲁ|ⲩ|ⲥⲱ
ⲉⲛⲧⲁⲩⲟⲩⲁϩϥ	ⲉⲛⲧ|ⲁ|ⲩ|ⲟⲩⲁϩ|ϥ
ⲉⲙⲡⲉϣⲗⲁⲁⲩ	ⲉ|ⲙⲡⲉ|ϣ|ⲗⲁⲁⲩ
ϩⲛⲛⲉⲩϭⲓϫ	ϩⲛ|ⲛⲉⲩ|ϭⲓϫ
ⲛϫⲟⲉⲓⲥ	ⲛ|ϫⲟⲉⲓⲥ
ⲉⲓϫⲱ	ⲉ|ⲓ|ϫⲱ
ⲛⲧⲉⲣⲓⲉⲓ	ⲛⲧⲉⲣ|ⲓ|ⲉⲓ
ⲧⲟⲩⲉⲓ	ⲧ|ⲟⲩⲉⲓ
ⲛⲁⲧⲛⲟⲩⲧⲉ	ⲛ|ⲁⲧⲛⲟⲩⲧⲉ
ⲉⲧⲃⲉⲡⲉⲓⲁⲡⲟⲧ	ⲉⲧⲃⲉ|ⲡⲉⲓ|ⲁⲡⲟⲧ
ⲛⲛⲓⲉⲡⲓⲑⲁⲛⲁⲧⲏⲥ	ⲛ|ⲛⲓ|ⲉⲡⲓⲑⲁⲛⲁⲧⲏⲥ
ⲙⲡⲉϥⲥⲙⲟⲩ	ⲙ|ⲡⲉϥ|ⲥⲙⲟⲩ
ⲛⲉⲩⲣϩⲟⲧⲉ	ⲛⲉ|ⲩ|ⲣϩⲟⲧⲉ
ⲁⲩϯⲡⲉⲩⲟⲩⲟⲉⲓ	ⲁ|ⲩ|ϯ|ⲡⲉ|ⲩⲟⲩⲟⲉⲓ
ⲁϥⲧⲁⲁⲩ	ⲁ|ϥ|ⲧⲁⲁ|ⲩ
ⲉⲙⲙⲛⲧⲟⲩ	ⲉ|ⲙⲙⲛⲧ|ⲟⲩ
ϫⲉⲧⲁⲛⲓⲙ	ϫⲉ|ⲧⲁ|ⲛⲓⲙ
ϩⲁⲛⲁⲓ	ϩⲁ|ⲛⲁⲓ
ⲛⲛⲟⲩϫ	ⲛ|ⲛⲟⲩϫ
ⲙⲛⲧⲟⲩϣⲏⲣⲉ	ⲙⲛⲧ|ⲟⲩ|ϣⲏⲣⲉ
ⲉⲁϥⲥⲱⲧⲙ	ⲉ|ⲁ|ϥ|ⲥⲱⲧⲙ
ϩⲙⲡⲙⲛⲧⲥⲛⲟⲟⲩⲥ	ϩⲙ|ⲡ|ⲙⲛⲧⲥⲛⲟⲟⲩⲥ
ⲧⲏⲩⲧⲛ	ⲧⲏⲩⲧⲛ
ⲛⲧⲙⲉ	ⲛ|ⲧ|ⲙⲉ
ⲛⲁⲃⲱⲕ	ⲛⲁ|ⲃⲱⲕ
ⲁϥⲛⲧⲥ	ⲁ|ϥ|ⲛⲧ|ⲥ
ⲛⲟⲉⲓⲕ	ⲛ|ⲟⲉⲓⲕ
ⲡⲙⲁ	ⲡ|ⲙⲁ
ⲙⲡⲉⲥϣⲱⲱⲧ	ⲙⲡⲉ|ⲥ|ϣⲱⲱⲧ
ⲉϩⲱⲧ	ⲉ|ϩⲱⲧ
ⲣⲟⲉⲓⲥ	ⲣⲟⲉⲓⲥ
ⲡⲉϫⲁⲥ	ⲡⲉϫⲁ|ⲥ
ⲛⲁ	ⲛⲁ
ⲉⲛⲉⲧⲥⲁϩⲟⲩ	ⲉ|ⲛ|ⲉⲧ|ⲥⲁϩⲟⲩ
ⲉⲕⲁⲫⲁⲣⲛⲁⲟⲩⲙ	ⲉ|ⲕⲁⲫⲁⲣⲛⲁⲟⲩⲙ
ⲉⲡⲕⲟⲥⲙⲟⲥ	ⲉ|ⲡ|ⲕⲟⲥⲙⲟⲥ
ⲉⲧⲟⲩⲟ	ⲉⲧ|ⲟⲩ|ⲟ
ⲙⲡⲉϩⲟⲟⲩ	ⲙ|ⲡⲉ|ϩⲟⲟⲩ
ⲙⲡⲓⲉⲣⲟ	ⲙ|ⲡ|ⲓⲉⲣⲟ
ϩⲓⲧⲱϩ	ϩⲓ|ⲧⲱϩ
ⲓⲱϩⲁⲛⲛⲏⲥ	ⲓⲱϩⲁⲛⲛⲏⲥ
ⲛⲧⲉⲥⲱⲧⲙ	ⲛ|ⲧⲉ|ⲥⲱⲧⲙ
ⲙⲛⲥⲱⲥⲑⲉⲛⲏⲥ	ⲙⲛ|ⲥⲱⲥⲑⲉⲛⲏⲥ
ϫⲉⲓⲱϩⲁⲛⲛⲏⲥⲡⲉ	ϫⲉ|ⲓⲱϩⲁⲛⲛⲏⲥ|ⲡⲉ
ϩⲏⲣⲱⲇⲏⲥ	ϩⲏⲣⲱⲇⲏⲥ
ⲉϥϯⲥⲃⲱ	ⲉ|ϥ|ϯⲥⲃⲱ
ⲉⲡⲉⲛϫⲟⲉⲓⲥ	ⲉ|ⲡⲉⲛ|ϫⲟⲉⲓⲥ
ⲛϫⲡⲥⲓⲧⲉ	ⲛ|ϫⲡ|ⲥⲓⲧⲉ
ϫⲉⲡⲉⲧϭⲱⲡⲉ	ϫⲉ|ⲡ|ⲉⲧ|ϭⲱⲡⲉ
ϫⲉⲥⲉϥⲓ	ϫⲉ|ⲥⲉ|ϥⲓ
ⲉϯⲟⲩⲁϣⲥ	ⲉ|ϯ|ⲟⲩⲁϣ|ⲥ
ⲡⲉⲛⲣⲟⲟⲩϣ	ⲡⲉⲛ|ⲣⲟⲟⲩϣ
ⲙⲡⲛⲥⲁϩⲟⲩ	ⲙⲡ|ⲛ|ⲥⲁϩⲟⲩ
ϫⲉⲉϥⲉⲡⲁⲣⲁⲇⲓⲇⲟⲩ	ϫⲉ|ⲉ|ϥ|ⲉ|ⲡⲁⲣⲁⲇⲓⲇⲟⲩ
ⲉⲧⲃⲉⲁⲡⲁ	ⲉⲧⲃⲉ|ⲁⲡⲁ
ϩⲓϫⲛⲛⲉⲩⲧⲃⲛⲟⲟⲩⲉ	ϩⲓϫⲛ|ⲛⲉⲩ|ⲧⲃⲛⲟⲟⲩⲉ
ⲙⲙⲏⲛⲉ	ⲙⲙⲏⲛⲉ
ⲛⲛⲉⲩⲕⲱ	ⲛⲛⲉ|ⲩ|ⲕⲱ
ⲛⲧⲉⲣⲉϥⲛⲟⲩϫ	ⲛⲧⲉⲣⲉ|ϥ|ⲛⲟⲩϫ
ⲉⲡⲉⲥⲏⲧ	ⲉ|ⲡⲉ|ⲥⲏⲧ
ⲉⲣⲟⲉⲓⲥ	ⲉ|ⲣⲟⲉⲓⲥ
ⲁⲛⲧⲱⲛⲓⲟⲥ	ⲁⲛⲧⲱⲛⲓⲟⲥ
ⲛⲑⲁⲃ	ⲛ|ⲑⲁⲃ
ϩⲣⲁⲓϩⲛⲁⲛⲟⲙⲓⲁ	ϩⲣⲁⲓ|ϩⲛ|ⲁⲛⲟⲙⲓⲁ
ⲉⲩⲣϩⲃⲃⲉ	ⲉ|ⲩ|ⲣϩⲃⲃⲉ
ϩⲛⲟⲩⲥⲙⲟⲧ	ϩⲛ|ⲟⲩ|ⲥⲙⲟⲧ
ⲡⲕⲁⲕⲉ	ⲡ|ⲕⲁⲕⲉ
ⲛⲣⲉϥϫⲓⲟⲩⲉ	ⲛ|ⲣⲉϥϫⲓⲟⲩⲉ
ⲛϭⲓⲡϫⲟⲉⲓⲥ	ⲛϭⲓ|ⲡ|ϫⲟⲉⲓⲥ
ⲉⲛⲉⲧⲥⲏϩ	ⲉ|ⲛ|ⲉⲧ|ⲥⲏϩ
ⲛⲁⲧⲱⲟⲩⲛ	ⲛⲁ|ⲧⲱⲟⲩⲛ
ⲅⲣⲁⲙⲙⲁⲧⲉⲩⲥ	ⲅⲣⲁⲙⲙⲁⲧⲉⲩⲥ
ⲉϩⲉⲛⲡⲁⲑⲟⲥ	ⲉ|ϩⲉⲛ|ⲡⲁⲑⲟⲥ
ⲥⲉⲛⲁϫⲡⲓⲕⲏⲣⲩⲥⲥⲉ	ⲥⲉ|ⲛⲁ|ϫⲡⲓ|ⲕⲏⲣⲩⲥⲥⲉ
ⲛⲧⲙⲡⲁⲛⲟⲩⲧⲉ	ⲛⲧⲙ|ⲡⲁ|ⲛⲟⲩⲧⲉ
ϫⲉⲛⲛⲉⲟⲩⲁ	ϫⲉ|ⲛⲛⲉ|ⲟⲩⲁ
ⲉⲧⲃⲉϩⲁϩ	ⲉⲧⲃⲉ|ϩⲁϩ
ⲙⲡⲉϥⲃⲉⲕⲉ	ⲙ|ⲡⲉϥ|ⲃⲉⲕⲉ
ⲉϣⲁϥϫⲟⲟⲥ	ⲉ|ϣⲁ|ϥ|ϫⲟⲟ|ⲥ
ⲧⲁⲗⲁⲃⲁⲥⲧⲣⲟⲛ	ⲧ|ⲁⲗⲁⲃⲁⲥⲧⲣⲟⲛ
ⲧϩⲉ	ⲧ|ϩⲉ
ϩⲱⲱⲕ	ϩⲱⲱ|ⲕ
ⲉⲧⲟⲟⲧϥ	ⲉⲧⲟⲟⲧ|ϥ
ⲙⲡⲱϩⲥ	ⲙ|ⲡⲱϩⲥ
ⲟⲩⲉϣ	ⲟⲩⲉϣ
ⲉⲣⲉⲧⲙⲕⲁⲉⲡⲓⲥⲧⲏⲙⲏ	ⲉⲣⲉ|ⲧⲙ|ⲕⲁ|ⲉⲡⲓⲥⲧⲏⲙⲏ
ⲕⲁⲧⲁⲛⲉⲧⲥⲏϩ	ⲕⲁⲧⲁ|ⲛ|ⲉⲧ|ⲥⲏϩ
ϩⲛϣⲟⲙⲛⲧ	ϩⲛ|ϣⲟⲙⲛⲧ
ⲙⲛⲡⲧⲃⲃⲟ	ⲙⲛ|ⲡ|ⲧⲃⲃⲟ
ⲛⲛⲓϣⲁϫⲉ	ⲛ|ⲛⲓ|ϣⲁϫⲉ
ϫⲉⲁϥϫⲟⲟⲥ	ϫⲉ|ⲁ|ϥ|ϫⲟⲟ|ⲥ
ⲛⲧⲉⲧⲛⲉⲓⲙⲉ	ⲛ|ⲧⲉⲧⲛ|ⲉⲓⲙⲉ
ⲉϥⲉϯϣⲓⲡⲉ	ⲉ|ϥ|ⲉ|ϯϣⲓⲡⲉ
ⲁⲩⲙⲏⲏϣⲉ	ⲁ|ⲩ|ⲙⲏⲏϣⲉ
ⲛⲛⲣⲱⲙⲉ	ⲛ|ⲛ|ⲣⲱⲙⲉ
ⲉϥⲥⲏϭ	ⲉ|ϥ|ⲥⲏϭ
ⲕⲁⲧⲁⲧϩⲉ	ⲕⲁⲧⲁ|ⲧ|ϩⲉ
ⲁϥⲣⲓⲙⲉ	ⲁ|ϥ|ⲣⲓⲙⲉ
ϩⲛⲟⲩⲙⲛⲧⲁⲧⲥⲟⲟⲩⲛ	ϩⲛ|ⲟⲩ|ⲙⲛⲧⲁⲧⲥⲟⲟⲩⲛ
ⲛⲛⲉⲧⲉⲉⲧ	ⲛ|ⲛ|ⲉⲧ|ⲉⲉⲧ
ϫⲉⲙⲙⲉⲉⲩⲉ	ϫⲉ|ⲙ|ⲙⲉⲉⲩⲉ
ⲁⲡⲉϥⲥⲱⲃⲁϩ	ⲁ|ⲡⲉϥ|ⲥⲱⲃⲁϩ
ϩⲛⲗⲓⲁ	ϩⲛ|ⲗⲓⲁ
ⲁⲥϫⲱϩ	ⲁ|ⲥ|ϫⲱϩ
ⲉⲛⲥⲁⲙⲡⲉⲙⲛⲧ	ⲉ|ⲛⲥⲁ|ⲙ|ⲡ|ⲉⲙⲛⲧ
ⲁⲓⲧⲛⲛⲟⲟⲩϥ	ⲁ|ⲓ|ⲧⲛⲛⲟⲟⲩ|ϥ
ⲛⲁⲧⲑⲁⲃ	ⲛ|ⲁⲧⲑⲁⲃ
ⲥⲉⲛⲁⲛⲟⲓⲛ	ⲥⲉ|ⲛⲁ|ⲛⲟⲉⲓⲛ
ⲧⲁⲓⲁⲕⲱⲃⲟⲥ	ⲧⲁ|ⲓⲁⲕⲱⲃⲟⲥ
ⲉⲧⲃⲏⲏⲧϥ	ⲉⲧⲃⲏⲏⲧ|ϥ
ⲥⲁⲣⲁ	ⲥⲁⲣⲁ
ϫⲉⲕⲁⲛ	ϫⲉ|ⲕⲁⲛ
ⲙⲙⲟϥ	ⲙⲙⲟ|ϥ
ϫⲉⲁⲣⲕⲁⲡⲙⲁ	ϫⲉ|ⲁⲣ|ⲕⲁ|ⲡ|ⲙⲁ
ⲧⲉⲡⲣⲟⲫⲏⲧⲏⲥ	ⲧⲉ|ⲡⲣⲟⲫⲏⲧⲏⲥ
ϣⲁⲃⲟⲗ	ϣⲁⲃⲟⲗ
ⲉⲧⲣⲉⲩⲕⲱⲧⲉ	ⲉ|ⲧⲣⲉ|ⲩ|ⲕⲱⲧⲉ
ϩⲃⲏⲩⲉ	ϩⲃⲏⲩⲉ
ⲙⲛⲡⲉϩⲟⲟⲩ	ⲙⲛ|ⲡⲉ|ϩⲟⲟⲩ
ϫⲉϯⲛⲁⲡⲁⲧⲁⲥⲥⲉⲓ	ϫⲉ|ϯ|ⲛⲁ|ⲡⲁⲧⲁⲥⲥⲉⲓ
ϫⲉⲛⲉⲃⲟⲗ	ϫⲉ|ⲛ|ⲉⲃⲟⲗ
ⲁⲓⲃⲁⲡⲧⲓⲍⲉ	ⲁ|ⲓ|ⲃⲁⲡⲧⲓⲍⲉ
ⲁⲩϩⲉ	ⲁ|ⲩ|ϩⲉ
ⲛⲧⲁⲧⲉⲧⲛⲧⲟϣⲥ	ⲛⲧ|ⲁ|ⲧⲉⲧⲛ|ⲧⲟϣ|ⲥ
ⲛⲉⲛⲉⲓⲟⲧⲉ	ⲛⲉⲛ|ⲉⲓⲟⲧⲉ
ⲛⲉⲩⲛⲁⲥⲧⲁⲩⲣⲟⲩ	ⲛⲉ|ⲩ|ⲛⲁ|ⲥⲧⲁⲩⲣⲟⲩ
ⲉⲝⲉⲥⲧⲉⲓ	ⲉⲝⲉⲥⲧⲉⲓ
ⲕⲁⲧⲁⲡⲉⲩⲉⲓⲛⲉ	ⲕⲁⲧⲁ|ⲡⲉⲩ|ⲉⲓⲛⲉ
ⲉⲧⲣⲉϥⲟⲩⲁϩϥ	ⲉ|ⲧⲣⲉ|ϥ|ⲟⲩⲁϩ|ϥ
ⲛⲧⲁϥ	ⲛⲧ|ⲁ|ϥ
ⲛⲙⲡⲏⲩ̣ⲉ	ⲛ|ⲙ|ⲡⲏⲩ̣ⲉ
ϩⲁⲟⲩϭⲗⲟϭ	ϩⲁ|ⲟⲩ|ϭⲗⲟϭ
ⲉⲧⲁⲛϩⲉⲟⲩⲯⲩⲭⲏ	ⲉ|ⲧⲁⲛϩⲉ|ⲟⲩ|ⲯⲩⲭⲏ
ⲛⲉⲛⲧⲁⲩⲛⲁⲩ	ⲛ|ⲉⲛⲧ|ⲁ|ⲩ|ⲛⲁⲩ
ⲙⲡⲓⲛⲟϭ	ⲙ|ⲡⲓ|ⲛⲟϭ
ⲁⲓⲧⲁⲙⲱⲧⲛ	ⲁ|ⲓ|ⲧⲁⲙⲱ|ⲧⲛ
ⲉⲩⲙⲁ	ⲉ|ⲩ|ⲙⲁ
ϫⲉⲙⲛϭⲟⲙ	ϫⲉ|ⲙⲛ|ϭⲟⲙ
ⲉϣⲁⲧⲉⲧⲛⲡⲱⲧ	ⲉ|ϣⲁ|ⲧⲉⲧⲛ|ⲡⲱⲧ
ⲛⲟⲩⲥⲟⲫⲓⲁ	ⲛ|ⲟⲩ|ⲥⲟⲫⲓⲁ
ⲛⲙⲡⲕⲁϩ	ⲛⲙ|ⲡ|ⲕⲁϩ
ϣⲁϥⲁⲛⲁⲕⲣⲓⲛⲉ	ϣⲁ|ϥ|ⲁⲛⲁⲕⲣⲓⲛⲉ
ⲁⲩⲥⲉⲡⲥⲱⲡϥ	ⲁ|ⲩ|ⲥⲉⲡⲥⲱⲡ|ϥ
ⲟⲩⲥⲓⲛⲇⲱⲛ	ⲟⲩ|ⲥⲓⲛⲇⲱⲛ
ⲉⲧⲣϩⲟⲩⲟ	ⲉⲧ|ⲣϩⲟⲩⲟ
ϫⲉϥⲥⲏϩ	ϫⲉ|ϥ|ⲥⲏϩ
ⲁϥⲫⲣⲁⲅⲉⲗⲗⲟⲩ	ⲁ|ϥ|ⲫⲣⲁⲅⲉⲗⲗⲟⲩ
ⲛⲉⲩϫⲱ	ⲛⲉ|ⲩ|ϫⲱ
ⲛⲥⲕⲁⲛⲇⲁⲗⲟⲛ	ⲛ|ⲥⲕⲁⲛⲇⲁⲗⲟⲛ
ⲡⲉⲧϩⲓϫⲉⲛⲉⲡⲱⲣ	ⲡ|ⲉⲧ|ϩⲓ|ϫⲉⲛⲉⲡⲱⲣ
ϯⲛⲁⲃⲱⲗ	ϯ|ⲛⲁ|ⲃⲱⲗ
ϫⲓⲛⲁϥⲙⲟⲩ	ϫⲓⲛ|ⲁ|ϥ|ⲙⲟⲩ
ⲉⲧⲥⲏϩ	ⲉⲧ|ⲥⲏϩ
ϫⲉⲙⲡⲟⲩϫⲉⲛⲟⲩⲛⲉ	ϫⲉ|ⲙⲡ|ⲟⲩ|ϫⲉⲛⲟⲩ|ⲛⲉ
ⲉϩⲉⲛⲁϩⲟ	ⲉ|ϩⲉⲛ|ⲁϩⲟ
ⲙⲙⲓⲥⲉ	ⲙ|ⲙⲓⲥⲉ
ϫⲉⲙⲡⲁⲧⲉ	ϫⲉ|ⲙⲡⲁⲧⲉ
ⲁⲩⲉⲣⲏⲧ	ⲁ|ⲩ|ⲉⲣⲏⲧ
ϩⲁⲣⲱⲧⲛ	ϩⲁⲣⲱ|ⲧⲛ
ϫⲉϩⲏⲗⲉⲓⲁⲥ	ϫⲉ|ϩⲏⲗⲉⲓⲁⲥ
ⲙⲛⲛⲉⲩⲥⲛⲏⲩ	ⲙⲛ|ⲛⲉⲩ|ⲥⲛⲏⲩ
ϩⲧⲏ	ϩⲧⲏ
ⲙⲡⲉⲩⲣⲟⲟⲩϣ	ⲙ|ⲡⲉⲩ|ⲣⲟⲟⲩϣ
ⲡⲓⲥⲕⲁⲣⲓⲱⲧⲏⲥ	ⲡ|ⲓⲥⲕⲁⲣⲓⲱⲧⲏⲥ
ⲉⲩϣⲁⲛϫⲓ	ⲉ|ⲩ|ϣⲁⲛ|ϫⲓ
ⲙⲡⲉⲛⲟⲩⲣⲟⲧ	ⲙ|ⲡⲉⲛ|ⲟⲩⲣⲟⲧ
ⲛⲉϥⲧⲁϣⲉⲟⲉⲓϣ	ⲛⲉ|ϥ|ⲧⲁϣⲉⲟⲉⲓϣ
ⲛϭⲓⲓⲱϩⲁⲛⲛⲏⲥ	ⲛϭⲓ|ⲓⲱϩⲁⲛⲛⲏⲥ
ϫⲉⲛⲧⲉⲧⲛⲡⲣⲡⲉ	ϫⲉ|ⲛⲧⲉⲧⲛ|ⲡ|ⲣⲡⲉ
ⲉⲧⲉⲣⲉⲟⲩⲟⲛ	ⲉⲧⲉⲣⲉ|ⲟⲩⲟⲛ
ϫⲉⲧⲱⲕ	ϫⲉ|ⲧⲱⲕ
ⲟⲩⲛϩⲉⲛϩⲉⲃⲱⲱⲛ	ⲟⲩⲛ|ϩⲉⲛ|ϩⲉⲃⲱⲱⲛ
ⲧⲉⲕⲗⲏⲣⲟⲛⲟⲙⲓⲁ	ⲧⲉ|ⲕⲗⲏⲣⲟⲛⲟⲙⲓⲁ
ⲁⲗⲁⲥⲥⲁ	ϩⲁⲗⲁⲥⲥⲁ
ⲛⲥⲱⲧⲉ	ⲛ|ⲥⲱⲧⲉ
ⲉⲧⲉⲡⲁⲓ	ⲉⲧⲉ|ⲡⲁⲓ
ⲛⲥⲁϩⲟⲩ	ⲛ|ⲥⲁϩⲟⲩ
ⲙⲛⲧⲉⲥⲙⲁⲁⲩ	ⲙⲛ|ⲧⲉⲥ|ⲙⲁⲁⲩ
ⲉⲣϣⲁⲛⲡⲕⲁⲣⲡⲟⲥ	ⲉⲣϣⲁⲛ|ⲡ|ⲕⲁⲣⲡⲟⲥ
ⲉⲣⲟⲥ	ⲉⲣⲟ|ⲥ
ϩⲛⲁ	ϩⲛⲁ
ϩⲉⲛⲇⲓⲁⲕⲱⲛ	ϩⲉⲛ|ⲇⲓⲁⲕⲱⲛ
ⲛⲥⲟⲟⲛⲉ	ⲛ|ⲥⲟⲟⲛⲉ
ⲛϭⲓⲡⲉⲧⲣⲟⲥ	ⲛϭⲓ|ⲡⲉⲧⲣⲟⲥ
ⲡⲛⲉⲩⲙⲁⲧⲓⲕⲱⲥ	ⲡⲛⲉⲩⲙⲁⲧⲓⲕⲱⲥ
ⲁϥⲁⲛⲁⲅⲕⲁⲍⲉ	ⲁ|ϥ|ⲁⲛⲁⲅⲕⲁⲍⲉ
ⲉⲃⲟⲗ	ⲉⲃⲟⲗ
ⲉⲛⲧⲁϥⲧⲉϩⲙⲧⲏⲩⲧⲛ	ⲉⲛⲧ|ⲁ|ϥ|ⲧⲉϩⲙ|ⲧⲏⲩⲧⲛ
ⲉϥⲓⲗⲁⲁⲩ	ⲉ|ϥⲓ|ⲗⲁⲁⲩ
ⲉϫⲱⲛ	ⲉϫⲱ|ⲛ
ⲡⲉϥ[.....]	ⲡⲉϥ|[.....]
ⲡⲉⲛⲧⲁⲕϣⲁϫⲉ	ⲡⲉ|ⲛⲧ|ⲁ|ⲕ|ϣⲁϫⲉ
ⲁϥⲕⲧⲉⲓⲁⲧϥ	ⲁ|ϥ|ⲕⲧⲉⲓⲁⲧ|ϥ
ϩⲛⲟⲩⲉⲓⲣⲏⲛⲏ	ϩⲛ|ⲟⲩ|ⲉⲓⲣⲏⲛⲏ
ⲉⲓϫⲉⲣⲟⲕ	ⲉ|ⲓ|ϫⲉⲣⲟ|ⲕ
ϫⲉⲉⲣⲉⲛⲁⲓ	ϫⲉ|ⲉⲣⲉ|ⲛⲁⲓ
ⲛⲧⲉⲡⲣⲱ	ⲛ|ⲧⲉ|ⲡⲣⲱ
ⲕ	ⲕ
ϫⲉⲕⲁⲣⲱ	ϫⲉ|ⲕⲁ|ⲣⲱ
ⲛⲧⲉⲣⲉⲡⲛⲁⲩ	ⲛⲧⲉⲣⲉ|ⲡ|ⲛⲁⲩ
ⲛϥⲧⲣⲉⲛϣⲟϫⲛⲉ	ⲛ|ϥ|ⲧⲣⲉ|ⲛ|ϣⲟϫⲛⲉ
ⲛⲙⲙⲁⲓ	ⲛⲙⲙⲁ|ⲓ
ⲉⲡⲣⲁⲛ	ⲉ|ⲡ|ⲣⲁⲛ
ⲉⲩⲛⲁ	ⲉ|ⲩ|ⲛⲁ
ⲛⲛⲉⲧϩⲓⲧⲟⲩⲱⲟⲩ	ⲛ|ⲛ|ⲉⲧ|ϩⲓⲧⲟⲩⲱ|ⲟⲩ
ⲉⲕⲟ	ⲉ|ⲕ|ⲟ
ⲡⲗⲁⲛⲁ	ⲡⲗⲁⲛⲁ
ⲉⲣⲉⲛⲉⲩⲥⲁⲛⲇⲁⲗⲓⲟⲛ	ⲉⲣⲉ|ⲛⲉⲩ|ⲥⲁⲛⲇⲁⲗⲓⲟⲛ
ⲉϥⲥⲟⲧⲡ	ⲉ|ϥ|ⲥⲟⲧⲡ
ϩⲓⲧⲛⲟⲩϩⲟⲟⲩ	ϩⲓⲧⲛ|ⲟⲩ|ϩⲟⲟⲩ
ⲙⲁⲣⲛϫⲡⲓⲟ	ⲙⲁⲣ|ⲛ|ϫⲡⲓⲟ
ⲛⲧⲉϥϩⲉ	ⲛ|ⲧⲉϥ|ϩⲉ
ⲙⲡⲉϩⲣⲟⲩⲃⲃⲁⲉⲓ	ⲙ|ⲡⲉ|ϩⲣⲟⲩⲃⲃⲁⲉⲓ
ⲛⲧⲉⲧⲛⲙⲧⲟⲛ	ⲛ|ⲧⲉⲧⲛ|ⲙⲧⲟⲛ
ⲛⲛⲉⲧⲟⲩⲉⲣⲏⲧⲉ	ⲛⲛⲉ|ⲧ|ⲟⲩⲉⲣⲏⲧⲉ
ⲉ	ⲉ
ϩⲛⲟⲩⲕⲱⲙϣ	ϩⲛ|ⲟⲩ|ⲕⲱⲙϣ
ⲛⲉⲧⲛϫⲓϫⲉⲉⲩⲉ	ⲛⲉⲧⲛ|ϫⲓϫⲉⲉⲩⲉ
ϫⲓϫⲉⲉⲩⲉ	ϫⲓϫⲉⲉⲩⲉ
ϫⲉⲛⲉⲣⲉⲡⲟⲩⲁ	ϫⲉ|ⲛⲉⲣⲉ|ⲡ|ⲟⲩⲁ
ⲉϯϯⲥⲃⲱ	ⲉ|ϯ|ϯⲥⲃⲱ
ϩⲛⲛⲁⲥⲡⲉ	ϩⲛ|ⲛ|ⲁⲥⲡⲉ
ⲉⲡⲉⲓϩⲱⲃ	ⲉ|ⲡⲉⲓ|ϩⲱⲃ
ⲛⲥϫⲓϭⲟⲗ	ⲛ|ⲥ|ϫⲓ|ϭⲟⲗ
ⲥⲁⲭⲑⲁⲛⲉⲓ	ⲥⲁⲭⲑⲁⲛⲉⲓ
ϯⲟⲃⲉ	ϯ|ⲟⲃⲉ
ⲙⲡⲉⲕⲥⲱϣ	ⲙ|ⲡⲉⲕ|ⲥⲱϣ
ⲛⲧⲁϥⲛⲁϩⲙⲟⲩ	ⲛⲧ|ⲁ|ϥ|ⲛⲁϩⲙ|ⲟⲩ
ⲛⲉⲥⲓⲟⲩⲣ	ⲛⲉ|ⲥⲓⲟⲩⲣ
ⲡⲕⲉⲧⲃⲧ	ⲡ|ⲕⲉ|ⲧⲃⲧ
ⲡⲉⲛⲧⲁϥⲥⲟⲩⲛ	ⲡ|ⲉⲛⲧ|ⲁ|ϥ|ⲥⲟⲩⲛ
ⲙⲡⲉⲧⲛⲟϣⲥ	ⲙⲡⲉ|ⲧⲛ|ⲟϣ|ⲥ
ⲙⲡⲉⲛϫⲟⲉⲓⲥ	ⲙ|ⲡⲉⲛ|ϫⲟⲉⲓⲥ
ⲛⲁⲧⲛⲁϩⲧⲉ	ⲛ|ⲁⲧⲛⲁϩⲧⲉ
ⲡⲉⲩⲣⲟⲟⲩϣ	ⲡⲉⲩ|ⲣⲟⲟⲩϣ
ⲉϥⲧⲁⲩⲟ	ⲉ|ϥ|ⲧⲁⲩⲟ
ⲉⲥϩⲏⲙ	ⲉ|ⲥ|ϩⲏⲙ
ⲁϫⲛⲏⲣⲡ	ⲁϫⲛ|ⲏⲣⲡ
ϩⲓϩⲱⲃ	ϩⲓ|ϩⲱⲃ
ϫⲉⲧⲛⲛⲁⲙⲟⲩ	ϫⲉ|ⲧⲛ|ⲛⲁ|ⲙⲟⲩ
ϩⲙⲡⲅⲉⲛⲏⲙⲁ	ϩⲙ|ⲡ|ⲅⲉⲛⲏⲙⲁ
ⲁⲩⲣϣⲡⲏⲣⲉ	ⲁ|ⲩ|ⲣϣⲡⲏⲣⲉ
ϩⲛⲛⲏⲓ	ϩⲛ|ⲛ|ⲏⲓ
ⲧⲉϣⲡⲏⲣⲉ	ⲧⲉ|ϣⲡⲏⲣⲉ
ⲛⲧⲉⲣⲟⲩⲣϩⲛⲁⲩ	ⲛⲧⲉⲣ|ⲟⲩ|ⲣ|ϩⲛⲁⲩ
ⲥⲉⲥⲏϩ	ⲥⲉ|ⲥⲏϩ
ⲉⲧⲛⲙⲙⲁⲥ	ⲉⲧ|ⲛⲙⲙⲁ|ⲥ
ϫⲉⲙⲡⲣⲣϩⲟⲧⲉ	ϫⲉ|ⲙⲡⲣ|ⲣϩⲟⲧⲉ
ⲡⲁⲓ	ⲡⲁⲓ
ⲥⲱⲛⲉ	ⲥⲱⲛⲉ
ⲙⲛⲛⲉⲩⲉⲣⲏⲩ	ⲙⲛ|ⲛⲉⲩ|ⲉⲣⲏⲩ
ⲛⲅⲛⲁⲩ	ⲛ|ⲅ|ⲛⲁⲩ
ⲛϩⲁⲉ	ⲛ|ϩⲁⲉ
ϫⲉⲟⲩⲣⲙⲛⲕⲁϩ	ϫⲉ|ⲟⲩ|ⲣⲙⲛⲕⲁϩ
ⲙⲡⲙⲉϩϣⲟⲙⲧⲥⲱⲱⲡ	ⲙ|ⲡ|ⲙⲉϩϣⲟⲙⲧⲥⲱⲱⲡ
ⲉⲧⲁⲕⲉⲧⲟⲩⲯⲩⲭⲏ	ⲉ|ⲧⲁⲕⲉ|ⲧⲟⲩ|ⲯⲩⲭⲏ
ⲉⲧⲣⲉⲩⲧⲁⲁⲩ	ⲉ|ⲧⲣⲉ|ⲩ|ⲧⲁⲁ|ⲩ
ⲙⲡⲡⲁⲥⲭⲁ	ⲙ|ⲡ|ⲡⲁⲥⲭⲁ
ⲛⲧⲉⲣⲟⲩϥⲓⲧⲟⲩ	ⲛⲧⲉⲣ|ⲟⲩ|ϥⲓⲧ|ⲟⲩ
ⲉⲩϣⲟϣⲟⲩ	ⲉ|ⲩ|ϣⲟϣ|ⲟⲩ
ⲉⲟⲩⲛϭⲟⲙ	ⲉ|ⲟⲩⲛ|ϭⲟⲙ
ⲙⲛⲛⲟⲣⲫⲁⲛⲟⲥ	ⲙⲛ|ⲛ|ⲟⲣⲫⲁⲛⲟⲥ
ⲉϣⲙⲧϣⲉ	ⲉ|ϣⲙⲧ|ϣⲉ
ⲡⲉⲧϫⲱ	ⲡ|ⲉⲧ|ϫⲱ
ⲉϩⲣⲁϥ	ⲉϩⲣⲁ|ϥ
ⲉⲓⲉⲕⲏⲣⲩⲥⲥⲉ	ⲉ|ⲓ|ⲉ|ⲕⲏⲣⲩⲥⲥⲉ
ϩⲉⲑⲛⲓⲕⲟⲥ	ϩⲉⲑⲛⲓⲕⲟⲥ
ϩⲙⲡϩⲏⲧ	ϩⲙ|ⲡ|ϩⲏⲧ
ⲡⲛⲁⲍⲱⲣⲁⲓⲟⲥ	ⲡ|ⲛⲁⲍⲱⲣⲁⲓⲟⲥ
ⲉⲩⲣⲡⲙⲉⲉⲩⲉ	ⲉ|ⲩ|ⲣ|ⲡ|ⲙⲉⲉⲩⲉ
ϫⲉⲛⲧⲉⲧⲛⲥⲟⲟⲩⲛ	ϫⲉ|ⲛ|ⲧⲉⲧⲛ|ⲥⲟⲟⲩⲛ
ⲛⲧⲉⲧⲙⲡⲱⲣϫ	ⲛⲧⲉ|ⲧⲙ|ⲡⲱⲣϫ
ⲉⲧⲑⲗⲓⲃⲉ	ⲉⲧ|ⲑⲗⲓⲃⲉ
ⲉⲛⲛⲁϣϫⲱ	ⲉ|ⲛ|ⲛⲁ|ϣ|ϫⲱ
ⲉⲙⲡⲕϫⲓ	ⲉ|ⲙⲡ|ⲕ|ϫⲓ
ⲙⲡⲙⲛⲧⲟⲩⲉ	ⲙ|ⲡ|ⲙⲛⲧ|ⲟⲩⲉ
ⲛⲧⲉⲕⲕⲗⲏⲥⲓⲁ	ⲛ|ⲧ|ⲉⲕⲕⲗⲏⲥⲓⲁ
ⲛϥⲧⲟⲩⲛⲟⲥⲥⲡⲉⲣⲙⲁ	ⲛ|ϥ|ⲧⲟⲩⲛⲟⲥ|ⲥⲡⲉⲣⲙⲁ
ⲁⲩⲱⲛⲑⲉ	ⲁⲩⲱ|ⲛ|ⲧ|ϩⲉ
ⲡⲉⲧⲉⲩⲛϭⲟⲙ	ⲡ|ⲉⲧⲉ|ⲩⲛ|ϭⲟⲙ
]	]
ⲙⲁⲗⲓⲥⲧⲁ	ⲙⲁⲗⲓⲥⲧⲁ
ⲛⲧⲁⲩⲕⲁⲁϥ	ⲛⲧ|ⲁ|ⲩ|ⲕⲁⲁ|ϥ
ⲁⲩⲣⲙⲛⲧⲣⲉ	ⲁ|ⲩ|ⲣⲙⲛⲧⲣⲉ
ϫⲉⲉⲕⲉⲉⲓⲣⲉ	ϫⲉ|ⲉⲕⲉ|ⲉⲓⲣⲉ
ⲟⲩⲉⲓⲛⲉ	ⲟⲩⲉⲓⲛⲉ
ϩⲛⲟⲩϣⲁϫⲉ	ϩⲛ|ⲟⲩ|ϣⲁϫⲉ
ⲛⲟⲩⲧⲃⲁ	ⲛ|ⲟⲩⲧⲃⲁ
ⲙⲛⲟⲩⲙⲛⲧⲃⲁⲃⲉ	ⲙⲛ|ⲟⲩ|ⲙⲛⲧⲃⲁⲃⲉ
ⲉⲧⲕϣⲙϣⲉ	ⲉⲧ|ⲕ|ϣⲙϣⲉ
ⲉⲕⲛⲁϯϩⲟⲓ	ⲉ|ⲕ|ⲛⲁ|ϯ|ϩⲟⲓ
ⲛϣⲟⲙⲛⲧ	ⲛ|ϣⲟⲙⲛⲧ
[....]ϫⲉ	[....]ϫⲉ
ⲉⲡⲱⲧⲛ	ⲉ|ⲡⲱ|ⲧⲛ
ⲛⲧⲉⲣⲟⲩⲙⲟⲟϣⲉ	ⲛⲧⲉⲣ|ⲟⲩ|ⲙⲟⲟϣⲉ
ⲛϭⲟⲓⲗⲉ	ⲛ|ϭⲟⲓⲗⲉ
ⲉⲩⲡⲏⲧ	ⲉ|ⲩ|ⲡⲏⲧ
ⲛⲧⲕⲡⲉⲧⲟⲩⲁⲁⲃ	ⲛⲧⲕ|ⲡ|ⲉⲧ|ⲟⲩⲁⲁⲃ
ⲛϩⲧⲏϥ	ⲛ|ϩⲧⲏ|ϥ
ⲛⲛϩⲟϥ	ⲛ|ⲛ|ϩⲟϥ
ⲛⲃⲁⲃⲉⲣⲱⲙⲉ	ⲛ|ⲃⲁⲃⲉ|ⲣⲱⲙⲉ
ⲙⲛⲡⲉⲩⲉⲓⲱⲧ	ⲙⲛ|ⲡⲉⲩ|ⲉⲓⲱⲧ
ⲉⲧⲉⲙⲛⲛⲉϩ	ⲉⲧⲉ|ⲙⲛ|ⲛⲉϩ
ⲛϩⲟⲟⲗⲉ	ⲛ|ϩⲟⲟⲗⲉ
ⲟⲩϭⲟⲙ	ⲟⲩ|ϭⲟⲙ
ⲧⲁⲥⲱⲛⲉ	ⲧⲁ|ⲥⲱⲛⲉ
ⲉⲩⲥⲱⲃⲉ	ⲉ|ⲩ|ⲥⲱⲃⲉ
ϣⲁⲧⲉⲧⲛϭⲱ	ϣⲁ|ⲧⲉⲧⲛ|ϭⲱ
ⲉⲧⲓ	ⲉⲧⲓ
ⲛⲥⲱⲙⲁ	ⲛ|ⲥⲱⲙⲁ
ⲛⲛⲛⲟⲃⲉ	ⲛ|ⲛ|ⲛⲟⲃⲉ
ϩⲛϩⲉⲛⲥⲧⲟⲗⲏ	ϩⲛ|ϩⲉⲛ|ⲥⲧⲟⲗⲏ
ⲉⲧϩⲏⲡ	ⲉⲧ|ϩⲏⲡ
ϫⲉⲛⲓⲙ	ϫⲉ|ⲛⲓⲙ
ⲁⲩⲕⲱⲱⲃⲉ	ⲁ|ⲩ|ⲕⲱⲱⲃⲉ
ⲁⲩⲥⲧⲁⲩⲣⲟⲩ	ⲁ|ⲩ|ⲥⲧⲁⲩⲣⲟⲩ
ⲙⲛⲛϩⲏⲣⲱⲇⲓⲁⲛⲟⲥ	ⲙⲛ|ⲛ|ϩⲏⲣⲱⲇⲓⲁⲛⲟⲥ
ⲛⲛⲥⲱⲧⲡ	ⲛ|ⲛ|ⲥⲱⲧⲡ
ⲉⲧⲉⲣⲉⲡⲉⲭⲣⲓⲥⲧⲟⲥ	ⲉⲧⲉⲣⲉ|ⲡⲉ|ⲭⲣⲓⲥⲧⲟⲥ
ⲉⲩⲛⲁϫⲟⲟⲥ	ⲉ|ⲩ|ⲛⲁ|ϫⲟⲟ|ⲥ
ⲉⲙⲉⲣⲓⲧϥ	ⲉ|ⲙⲉⲣⲓⲧ|ϥ
ⲛⲁⲡⲟⲥⲧⲟⲗⲟⲥ	ⲛ|ⲁⲡⲟⲥⲧⲟⲗⲟⲥ
ϫⲉⲁⲛⲉⲛⲉⲓⲟⲧⲉ	ϫⲉ|ⲁ|ⲛⲉⲛ|ⲉⲓⲟⲧⲉ
ϩⲛⲧⲉⲥⲧⲁⲥⲓⲥ	ϩⲛ|ⲧⲉ|ⲥⲧⲁⲥⲓⲥ
ⲛϩⲏⲕⲉ	ⲛ|ϩⲏⲕⲉ
ⲛϭⲓⲡⲉⲛϫⲟⲉⲓⲥ	ⲛϭⲓ|ⲡⲉⲛ|ϫⲟⲉⲓⲥ
ϫⲛⲣⲡⲉⲧϩⲟⲟⲩ	ϫⲛ|ⲣ|ⲡ|ⲉⲧ|ϩⲟⲟⲩ
ⲡϩⲁⲙϣⲉ	ⲡ|ϩⲁⲙϣⲉ
ⲉⲧⲃⲉⲡⲉⲙⲧⲟⲛ	ⲉⲧⲃⲉ|ⲡⲉ|ⲙⲧⲟⲛ
ⲁⲩⲥⲱⲧⲙ	ⲁ|ⲩ|ⲥⲱⲧⲙ
ϩⲓⲡⲃⲁⲧⲟⲥ	ϩⲓ|ⲡ|ⲃⲁⲧⲟⲥ
ⲛⲟⲩⲙⲏⲏϣⲉ	ⲛ|ⲟⲩ|ⲙⲏⲏϣⲉ
ϫⲉⲉϥⲛⲁϭⲱⲗⲡ	ϫⲉ|ⲉ|ϥ|ⲛⲁ|ϭⲱⲗⲡ
ⲛⲉⲣⲁⲙⲉⲗⲉⲧⲁ	ⲛⲉⲣ|ⲁ|ⲙⲉⲗⲉⲧⲁ
ⲡⲉⲟⲩⲛⲧⲏⲧⲛ	ⲡⲉ|ⲟⲩⲛⲧⲏ|ⲧⲛ
ⲙⲛⲛⲁⲡⲟⲥⲧⲟⲗⲟⲥ	ⲙⲛ|ⲛ|ⲁⲡⲟⲥⲧⲟⲗⲟⲥ
ⲡⲟⲩⲁ	ⲡ|ⲟⲩⲁ
ⲛⲉⲅⲣⲁⲙⲙⲁⲧⲉⲩⲥ	ⲛⲉ|ⲅⲣⲁⲙⲙⲁⲧⲉⲩⲥ
ϩⲛⲛⲉϥϩⲃⲏⲩⲉ	ϩⲛ|ⲛⲉϥ|ϩⲃⲏⲩⲉ
ϩⲙⲡⲟⲩⲉ	ϩⲙ|ⲡ|ⲟⲩⲉ
ⲛⲥⲁⲧϩⲉ	ⲛⲥⲁ|ⲧ|ϩⲉ
ⲛⲙϩⲉⲛⲥⲏϥⲉ	ⲛⲙ|ϩⲉⲛ|ⲥⲏϥⲉ
ⲟⲩⲡⲉ	ⲟⲩ|ⲡⲉ
ⲡⲥⲁⲧⲁⲛⲁⲥ	ⲡ|ⲥⲁⲧⲁⲛⲁⲥ
ⲉⲧⲉⲧⲛⲧⲣⲉⲩⲣⲕⲃⲁ	ⲉ|ⲧⲉⲧⲛ|ⲧⲣⲉ|ⲩ|ⲣⲕⲃⲁ
ⲉⲛϯⲛⲏⲩ	ⲉ|ⲛ|ϯ|ⲛⲏⲩ
ⲙⲡⲉⲓⲗⲁⲟⲥ	ⲙ|ⲡⲉⲓ|ⲗⲁⲟⲥ
ⲉⲩⲉϫⲱϩ	ⲉⲩⲉ|ϫⲱϩ
ⲣⲙⲛⲧⲣⲉ	ⲣⲙⲛⲧⲣⲉ
ϩⲉⲛⲕⲉϩⲓⲟⲙⲉ	ϩⲉⲛ|ⲕⲉ|ϩⲓⲟⲙⲉ
ϣⲏⲙ	ϣⲏⲙ
ⲁⲥⲁⲁϥ	ⲁ|ⲥ|ⲁⲁ|ϥ
ⲡⲥⲟⲟϩⲉ	ⲡ|ⲥⲟⲟϩⲉ
ⲉⲣⲟⲙⲡⲉⲙϩⲁⲁⲩ	ⲉ|ⲣⲟ|ⲙ|ⲡⲉ|ⲙϩⲁⲁⲩ
ⲕⲟⲥⲙⲟⲥ	ⲕⲟⲥⲙⲟⲥ
ⲉⲛϣⲁϫⲉ	ⲉ|ⲛ|ϣⲁϫⲉ
ⲁϥϣⲁⲕⲧⲟⲩⲉⲓⲟⲙ	ⲁ|ϥ|ϣⲁⲕⲧ|ⲟⲩ|ⲉⲓⲟⲙ
ⲉϫⲱⲕⲡⲉ	ⲉϫⲱ|ⲕ|ⲡⲉ
ⲉⲩϭⲱϣⲧ	ⲉ|ⲩ|ϭⲱϣⲧ
ϫⲉⲛⲧⲛⲛⲁϥⲓ	ϫⲉ|ⲛ|ⲧⲛ|ⲛⲁ|ϥⲓ
ⲉⲣⲱϥ	ⲉⲣⲱ|ϥ
ϫⲉⲙⲛϩⲁϩ	ϫⲉ|ⲙⲛ|ϩⲁϩ
ⲛⲗⲩⲡⲏ	ⲛ|ⲗⲩⲡⲏ
ⲉⲡⲉⲩⲙⲕⲁϩ	ⲉ|ⲡⲉⲩ|ⲙⲕⲁϩ
ϫⲉⲙⲡϩⲙϩⲁⲗ	ϫⲉ|ⲙ|ⲡ|ϩⲙϩⲁⲗ
ⲉϫⲛⲟⲩϥ	ⲉ|ϫⲛⲟⲩ|ϥ
ⲉⲣϣⲁⲛ	ⲉⲣϣⲁⲛ
ϣⲁⲩϩⲉⲣⲙⲉⲛⲉⲩⲉ	ϣⲁ|ⲩ|ϩⲉⲣⲙⲉⲛⲉⲩⲉ
ⲛϩⲙⲉ	ⲛ|ϩⲙⲉ
ⲁⲗⲉⲝⲁⲛⲇⲣⲟⲥ	ⲁⲗⲉⲝⲁⲛⲇⲣⲟⲥ
ϩⲉⲛⲇⲓⲁⲕⲟⲛⲓⲁ	ϩⲉⲛ|ⲇⲓⲁⲕⲟⲛⲓⲁ
ⲟⲩⲥⲟⲫⲓⲁ	ⲟⲩ|ⲥⲟⲫⲓⲁ
ⲛⲧⲉⲣⲉϥⲉⲓⲙⲉ	ⲛⲧⲉⲣⲉ|ϥ|ⲉⲓⲙⲉ
ϩⲛⲟⲩⲭⲉⲓⲙⲏⲧⲓ	ϩⲛ|ⲟⲩ|ⲭⲉⲓⲙⲏⲧⲓ
ⲡⲉⲧⲉⲧⲛⲟⲩⲁϣϥ	ⲡ|ⲉⲧ|ⲉⲧⲛ|ⲟⲩⲁϣ|ϥ
ⲉⲛⲉϣⲱⲡⲉ	ⲉⲛⲉ|ϣⲱⲡⲉ
ⲙⲡϥⲁϩⲉⲣⲁⲧϥ	ⲙⲡ|ϥ|ⲁϩⲉⲣⲁⲧ|ϥ
ⲛⲧⲁⲙⲛⲧⲣⲣⲟ	ⲛ|ⲧⲁ|ⲙⲛⲧⲣⲣⲟ
ϫⲉⲛⲛⲉⲗⲁⲁⲩ	ϫⲉ|ⲛⲛⲉ|ⲗⲁⲁⲩ
ⲁⲩϫⲱ	ⲁ|ⲩ|ϫⲱ
ⲛⲉⲩⲛⲁⲕⲁⲁϥ	ⲛⲉ|ⲩ|ⲛⲁ|ⲕⲁⲁ|ϥ
ⲕⲕⲁϫⲣⲟⲡ	ⲕ|ⲕⲁ|ϫⲣⲟⲡ
ⲉϩⲟⲩⲉ	ⲉϩⲟⲩⲉ
ⲁⲩⲧⲁⲕⲟϥ	ⲁ|ⲩ|ⲧⲁⲕⲟ|ϥ
ϫⲉϥⲛⲁⲉⲓⲣⲉ	ϫⲉ|ϥ|ⲛⲁ|ⲉⲓⲣⲉ
ⲉⲛⲥⲱϣⲉ	ⲉ|ⲛ|ⲥⲱϣⲉ
ϩⲛⲛⲁⲓ	ϩⲛ|ⲛⲁⲓ
ⲛⲁⲛⲛⲁ	ⲛ|ⲁⲛⲛⲁ
ⲧⲁⲓ	ⲧⲁⲓ
ⲙⲛⲛⲉⲧⲧⲛⲧⲱⲛ	ⲙⲛ|ⲛ|ⲉⲧ|ⲧⲛⲧⲱⲛ
ⲉⲧϩⲙⲡⲉⲩⲕⲱⲧⲉ	ⲉⲧ|ϩⲙ|ⲡⲉⲩ|ⲕⲱⲧⲉ
ϩⲉⲛⲉⲃⲟⲗ	ϩⲉⲛ|ⲉⲃⲟⲗ
ϩⲁⲣⲱϥ	ϩⲁⲣⲱ|ϥ
ⲙⲡϣⲁ	ⲙⲡϣⲁ
ⲛⲧⲉⲧⲛⲟⲩⲕⲱⲧ	ⲛⲧⲉⲧⲛ|ⲟⲩ|ⲕⲱⲧ
ⲁϥⲡⲁⲣⲁⲇⲓⲇⲟⲩ	ⲁ|ϥ|ⲡⲁⲣⲁⲇⲓⲇⲟⲩ
ⲧⲡⲉ	ⲧ|ⲡⲉ
ⲛⲉⲧϩⲓϫⲱⲛ	ⲛ|ⲉⲧ|ϩⲓϫⲱ|ⲛ
ⲙⲡⲉⲙⲕⲁϩ	ⲙ|ⲡⲉ|ⲙⲕⲁϩ
ϫⲉⲗⲉⲅⲓⲱⲛ	ϫⲉ|ⲗⲉⲅⲓⲱⲛ
ⲉⲧⲃⲉⲧⲁⲓ	ⲉⲧⲃⲉ|ⲧⲁⲓ
ⲛⲉⲧⲉⲛⲥⲉϣⲟⲟⲡ	ⲛ|ⲉⲧⲉ|ⲛ|ⲥⲉ|ϣⲟⲟⲡ
ⲉⲙⲡⲟⲩⲟⲩⲉϩⲥⲁϩⲛⲉ	ⲉ|ⲙⲡ|ⲟⲩ|ⲟⲩⲉϩ|ⲥⲁϩⲛⲉ
ϫⲉⲁϣ	ϫⲉ|ⲁϣ
ϩⲉⲛⲡⲟⲗⲓⲥ	ϩⲉⲛ|ⲡⲟⲗⲓⲥ
ϫⲉⲥⲧⲁⲩⲣⲟⲩ	ϫⲉ|ⲥⲧⲁⲩⲣⲟⲩ
ϫⲉⲡⲉⲣⲟ	ϫⲉ|ⲡⲉ|ⲣⲟ
ⲙⲙⲉⲧⲁⲛⲟⲓⲁ	ⲙ|ⲙⲉⲧⲁⲛⲟⲓⲁ
ϩⲛⲕⲉⲙⲟⲣⲫⲏ	ϩⲛ|ⲕⲉ|ⲙⲟⲣⲫⲏ
ⲥⲁⲣⲕⲓⲕⲟⲥ	ⲥⲁⲣⲕⲓⲕⲟⲥ
ⲙⲛⲛⲉⲑⲏⲣⲓⲟⲛ	ⲙⲛ|ⲛⲉ|ⲑⲏⲣⲓⲟⲛ
ⲡⲁⲉⲓⲱⲧ	ⲡⲁ|ⲉⲓⲱⲧ
ⲉⲩⲉⲕⲁⲧⲏⲅⲟⲣⲉⲓ	ⲉⲩⲉ|ⲕⲁⲧⲏⲅⲟⲣⲉⲓ
ⲧⲁϫⲣⲟ	ⲧⲁϫⲣⲟ
ⲛⲧⲉⲛϩⲱⲧ	ⲛⲧⲉ|ⲛ|ϩⲱⲧ
ⲛⲧⲥⲏϥⲉ	ⲛ|ⲧ|ⲥⲏϥⲉ
ⲉⲁϥϫⲡⲟ	ⲉ|ⲁ|ϥ|ϫⲡⲟ
ϫⲉⲛⲧⲟⲟⲩ	ϫⲉ|ⲛⲧⲟ|ⲟⲩ
ⲛϭⲓϩⲉⲛⲉⲓⲟⲧⲉ	ⲛϭⲓ|ϩⲉⲛ|ⲉⲓⲟⲧⲉ
ⲙⲙⲁⲁϫⲉ	ⲙ|ⲙⲁⲁϫⲉ
ⲥⲉⲛⲁⲥⲕⲁⲛⲇⲁⲗⲓⲍⲉ	ⲥⲉ|ⲛⲁ|ⲥⲕⲁⲛⲇⲁⲗⲓⲍⲉ
ϩⲱⲧⲧⲏⲩⲧⲛ	ϩⲱⲧ|ⲧⲏⲩⲧⲛ
ⲛⲉⲟⲩⲛⲥⲁϣϥ	ⲛⲉ|ⲟⲩⲛ|ⲥⲁϣϥ
ⲙⲡⲙⲏⲏϣⲉ	ⲙ|ⲡ|ⲙⲏⲏϣⲉ
ⲛⲧⲃⲱ	ⲛ|ⲧ|ⲃⲱ
ϥⲥⲏϩ	ϥ|ⲥⲏϩ
ⲛⲧⲁϥⲥⲟⲧⲡⲟⲩ	ⲛⲧ|ⲁ|ϥ|ⲥⲟⲧⲡ|ⲟⲩ
ϩⲛⲧⲉⲣⲏⲙⲟⲥ	ϩⲛ|ⲧ|ⲉⲣⲏⲙⲟⲥ
ⲛⲛⲉⲧⲉⲟⲩⲛⲧⲁⲩ	ⲛ|ⲛ|ⲉⲧⲉ|ⲟⲩⲛⲧⲁ|ⲩ
ⲁϥⲧⲁⲙⲓⲟⲟⲩ	ⲁ|ϥ|ⲧⲁⲙⲓⲟ|ⲟⲩ
ⲛⲥⲟⲡ	ⲛ|ⲥⲟⲡ
ⲥⲩⲛⲍⲏⲧⲏⲧⲏⲥ	ⲥⲩⲛⲍⲏⲧⲏⲧⲏⲥ
ⲉⲧⲉⲧⲛⲁϣⲓ	ⲉ|ⲧ|ⲉⲧ|ⲛⲁ|ϣⲓ
ⲉϣⲁⲩϩⲉⲣⲙⲏⲛⲉⲩⲉ	ⲉ|ϣⲁ|ⲩ|ϩⲉⲣⲙⲏⲛⲉⲩⲉ
ϫⲉⲉⲣⲉⲃⲉⲉⲗⲍⲉⲃⲟⲩⲗ	ϫⲉ|ⲉⲣⲉ|ⲃⲉⲉⲗⲍⲉⲃⲟⲩⲗ
ⲁⲛ	ⲁⲛ
ⲧⲉⲧⲛϩⲉ	ⲧⲉⲧⲛ|ϩⲉ
ⲛⲛⲁⲡⲣⲱⲙⲉ	ⲛ|ⲛⲁ|ⲡ|ⲣⲱⲙⲉ
ⲁⲙⲟⲩ	ⲁⲙⲟⲩ
ⲉⲛϣⲁⲛϣⲁϫⲉ	ⲉⲛϣⲁⲛ|ϣⲁϫⲉ
ϣⲁⲁⲣⲏϫⲥ	ϣⲁ|ⲁⲣⲏϫⲥ
ⲙⲛⲡⲉⲛϫⲟⲉⲓⲥ	ⲙⲛ|ⲡⲉⲛ|ϫⲟⲉⲓⲥ
ⲛⲁϥⲓⲟⲩ	ⲛⲁ|ϥⲓ|ⲟⲩ
ⲙⲛⲛⲉⲧⲛⲁⲛⲟⲩⲟⲩ	ⲙⲛ|ⲛ|ⲉⲧ|ⲛⲁⲛⲟⲩ|ⲟⲩ
ⲛⲉⲣⲁⲕⲁⲧⲁⲫⲣⲟⲛⲉⲓⲡⲉ	ⲛⲉⲣ|ⲁ|ⲕⲁⲧⲁⲫⲣⲟⲛⲉⲓ|ⲡⲉ
ⲉⲛⲉⲓⲱⲛⲉ	ⲉ|ⲛⲉⲓ|ⲱⲛⲉ
ⲛⲧⲉⲧⲛϥⲓⲧⲟⲩ	ⲛ|ⲧⲉⲧⲛ|ϥⲓⲧ|ⲟⲩ
ⲛϥϫⲱϩⲙ	ⲛ|ϥ|ϫⲱϩⲙ
ⲟⲩⲥⲟⲩⲟ	ⲟⲩ|ⲥⲟⲩⲟ
ⲛϣoⲙⲛⲧⲥⲱⲱⲡ	ⲛ|ϣoⲙⲛⲧ|ⲥⲱⲱⲡ
ϩⲁⲟⲩϣⲓ	ϩⲁ|ⲟⲩ|ϣⲓ
ⲛϩⲉⲛϣⲏⲣⲉ	ⲛ|ϩⲉⲛ|ϣⲏⲣⲉ
ⲛⲥⲉϯⲉⲟⲟⲩ	ⲛ|ⲥⲉ|ϯⲉⲟⲟⲩ
ⲉⲩϣⲁⲛϥⲓ	ⲉⲩ|ϣⲁⲛ|ϥⲓ
ⲛⲧⲉⲣⲉϥⲃⲱⲕ	ⲛⲧⲉⲣⲉ|ϥ|ⲃⲱⲕ
ⲁϥⲥⲟⲩⲧⲛⲧⲟⲟⲧϥ	ⲁ|ϥ|ⲥⲟⲩⲧⲛ|ⲧⲟⲟⲧ|ϥ
ⲥⲉⲛⲁϯ	ⲥⲉ|ⲛⲁ|ϯ
ⲛϭⲓⲡⲉⲧϫⲟⲟⲣ	ⲛϭⲓ|ⲡ|ⲉⲧ|ϫⲟⲟⲣ
ⲧⲁⲩⲟⲩⲟϥ	ⲧⲁⲩⲟⲩⲟ|ϥ
ⲧⲙⲧⲣⲉϥⲧⲱⲱⲃⲉ	ⲧⲙ|ⲧⲣⲉ|ϥ|ⲧⲱⲱⲃⲉ
ⲱ	ⲱ
ⲉⲡⲉⲙϩⲁⲟⲩ	ⲉ|ⲡⲉ|ⲙϩⲁⲟⲩ
ⲛⲁⲛ	ⲛⲁ|ⲛ
ⲉⲧⲃⲏⲏⲧ	ⲉⲧⲃⲏⲏⲧ
ⲛϭⲟⲛⲥ	ⲛ|ϭⲟⲛⲥ
ϩⲙⲡⲕⲁⲓⲣⲟⲥ	ϩⲙ|ⲡ|ⲕⲁⲓⲣⲟⲥ
ϩⲓⲧⲟⲟⲧⲥ	ϩⲓ|ⲧⲟⲟⲧ|ⲥ
ⲙⲙⲟⲥ	ⲙⲙⲟ|ⲥ
ϯⲱⲣⲕ	ϯ|ⲱⲣⲕ
ⲛⲧⲟⲣⲅⲏ	ⲛ|ⲧ|ⲟⲣⲅⲏ
ⲕⲁⲧⲁⲡⲉⲥⲙⲡϣⲁ	ⲕⲁⲧⲁ|ⲡⲉⲥ|ⲙⲡϣⲁ
ⲉⲧⲉϩⲉⲛⲉⲃⲟⲗ	ⲉⲧⲉ|ϩⲉⲛ|ⲉⲃⲟⲗ
ⲛϯⲙⲉ	ⲛ|ϯ|ⲙⲉ
ϫⲉⲡⲉⲧⲛⲁⲥⲱⲱϥ	ϫⲉ|ⲡ|ⲉⲧ|ⲛⲁ|ⲥⲱⲱϥ
ϣⲛϩⲧⲏⲕ	ϣⲛ|ϩⲧⲏ|ⲕ
ⲛⲉⲛⲁϣⲱⲟⲩ	ⲛⲉ|ⲛⲁϣⲱ|ⲟⲩ
ⲟⲩⲙⲁ	ⲟⲩ|ⲙⲁ
ϩⲓⲕⲗⲁϥⲧ	ϩⲓ|ⲕⲗⲁϥⲧ
ⲛⲧⲉⲧⲉⲓⲟⲩⲛⲟⲩ	ⲛⲧⲉ|ⲧⲉⲓ|ⲟⲩⲛⲟⲩ
ⲉⲧϩⲙⲡⲉⲭⲣⲓⲥⲧⲟⲥ	ⲉⲧ|ϩⲙ|ⲡⲉ|ⲭⲣⲓⲥⲧⲟⲥ
ⲉⲟ	ⲉ|ⲟ
ϩⲛⲟⲩⲏⲣ	ϩⲛ|ⲟⲩⲏⲣ
ϫⲉⲙⲏⲡⲟⲧⲉ	ϫⲉ|ⲙⲏⲡⲟⲧⲉ
ⲛⲛⲉⲉⲓϯϣⲓⲡⲉ	ⲛⲛⲉ|ⲉⲓ|ϯ|ϣⲓⲡⲉ
ϩⲛϩⲣⲁⲭⲏⲗ	ϩⲛ|ϩⲣⲁⲭⲏⲗ
ⲉϥⲑⲙⲟ	ⲉ|ϥ|ⲑⲙⲟ
ⲛⲁⲟⲩⲱϩ	ⲛⲁ|ⲟⲩⲱϩ
ⲛⲧⲉⲣⲟⲩⲡⲉ	ⲛⲧⲉⲣ|ⲟⲩ|ⲡⲉ
ⲁⲩⲱ	ⲁⲩⲱ
ⲉⲁⲓⲁⲁϥ	ⲉ|ⲁ|ⲓ|ⲁⲁ|ϥ
ⲃⲱⲗ	ⲃⲱⲗ
ⲏⲡ	ⲏⲡ
ⲛⲧⲉⲧⲛⲥⲟⲣϥ	ⲛ|ⲧⲉⲧⲛ|ⲥⲟⲣ|ϥ
ⲉⲣⲛϣⲧⲏⲛ	ⲉ|ⲣ|ⲛ|ϣⲧⲏⲛ
ⲡⲉⲧⲉⲩⲛⲧⲁϥ	ⲡ|ⲉⲧⲉ|ⲩⲛⲧⲁ|ϥ
ⲛⲇⲓⲕⲁⲓⲟⲛ	ⲛ|ⲇⲓⲕⲁⲓⲟⲛ
ⲙⲛⲧⲥⲛⲟⲟⲩⲥ	ⲙⲛⲧⲥⲛⲟⲟⲩⲥ
ⲉⲧⲉϩⲛⲏⲧⲛ	ⲉⲧⲉ|ϩⲛⲏ|ⲧⲛ
ⲛⲧⲉⲣⲉϥⲫⲱϭⲉ	ⲛⲧⲉⲣⲉ|ϥ|ⲫⲱϭⲉ
ⲙⲡⲉϥⲥⲱⲙⲁ	ⲙ|ⲡⲉϥ|ⲥⲱⲙⲁ
ⲉⲧⲣⲉⲩⲙⲟⲟⲩⲧϥ	ⲉ|ⲧⲣⲉ|ⲩ|ⲙⲟⲟⲩⲧ|ϥ
ϫⲉⲙⲡⲟⲩⲱϣ	ϫⲉ|ⲙⲡ|ⲟⲩ|ⲱϣ
ⲉⲁϥϯ	ⲉ|ⲁ|ϥ|ϯ
ⲉⲧⲣⲉϥⲁⲗⲉ	ⲉ|ⲧⲣⲉ|ϥ|ⲁⲗⲉ
ⲛⲁⲣⲧⲱⲛ	ⲛⲁ|ⲣⲧⲱⲛ
ϣⲟⲟⲡ	ϣⲟⲟⲡ
ⲙⲡⲣⲣϩⲟⲧⲉ	ⲙⲡⲣ|ⲣϩⲟⲧⲉ
ⲛϭⲓⲡⲙⲁⲕⲁⲣⲓⲟⲥ	ⲛϭⲓ|ⲡ|ⲙⲁⲕⲁⲣⲓⲟⲥ
ⲥⲛⲧⲉ	ⲥⲛⲧⲉ
ⲡⲕⲉⲛⲟϭ	ⲡ|ⲕⲉ|ⲛⲟϭ
ⲁϥⲛⲧϥ	ⲁ|ϥ|ⲛⲧ|ϥ
ⲁⲓⲉⲓⲃⲉ	ⲁ|ⲓ|ⲉⲓⲃⲉ
ⲉⲙⲡⲟⲩⲙⲓϣⲉ	ⲉ|ⲙⲡ|ⲟⲩ|ⲙⲓϣⲉ
ϫⲉⲕⲛⲁⲡⲁϩⲟⲩ	ϫⲉ|ⲕ|ⲛⲁ|ⲡⲁϩ|ⲟⲩ
ⲉⲕϯⲟⲩⲃⲉⲓⲏⲥⲟⲩⲥ	ⲉ|ⲕ|ϯ|ⲟⲩⲃⲉ|ⲓⲏⲥⲟⲩⲥ
ⲉⲛⲙⲏⲏϣⲉ	ⲉ|ⲛ|ⲙⲏⲏϣⲉ
ⲟⲩϩⲗⲗⲟ	ⲟⲩ|ϩⲗⲗⲟ
ⲙⲛⲟⲩ	ⲙⲛ|ⲟⲩ
ⲉⲟⲩⲛⲧⲉ	ⲉ|ⲟⲩⲛⲧ|ⲉ
ⲁⲩⲧⲁϩⲥⲟⲩ	ⲁ|ⲩ|ⲧⲁϩⲥ|ⲟⲩ
ⲛⲉⲡⲣⲁ	ⲛ|ⲉⲡⲣⲁ
ⲁϥⲟⲩⲟⲙⲟⲩ	ⲁ|ϥ|ⲟⲩⲟⲙ|ⲟⲩ
ⲉⲛⲧⲁϥⲕⲱ	ⲉⲛⲧ|ⲁ|ϥ|ⲕⲱ
ⲁⲩϭⲱ	ⲁ|ⲩ|ϭⲱ
ϫⲉⲕⲁⲁⲥⲉⲛⲛⲉⲡⲉⲧⲛⲡⲱⲧ	ϫⲉⲕⲁⲁⲥ|ⲉ|ⲛⲛⲉ|ⲡⲉⲧⲛ|ⲡⲱⲧ
ⲡϩⲏⲃⲥ	ⲡ|ϩⲏⲃⲥ
ⲉⲧϫⲟⲥⲉ	ⲉⲧ|ϫⲟⲥⲉ
ⲉϥϫⲓϣⲕⲁⲕ	ⲉ|ϥ|ϫⲓ|ϣⲕⲁⲕ
ⲉⲣⲉⲡϭⲟⲗ	ⲉⲣⲉ|ⲡ|ϭⲟⲗ
ⲛⲧⲁϩⲟⲓⲛⲉ	ⲛⲧ|ⲁ|ϩⲟⲓⲛⲉ
ⲛⲥⲉⲥⲉⲡⲥⲱⲡϥ	ⲛ|ⲥⲉ|ⲥⲉⲡⲥⲱⲡ|ϥ
ⲉϩⲉⲛⲉⲃⲟⲗ	ⲉ|ϩⲉⲛ|ⲉⲃⲟⲗ
ⲙⲙⲟⲟⲩ	ⲙⲙⲟ|ⲟⲩ
ⲉⲩⲇⲓⲁⲕⲟⲛⲓ	ⲉ|ⲩ|ⲇⲓⲁⲕⲟⲛⲓ
ⲛⲥⲁⲕⲣⲓⲥⲡⲟⲥ	ⲛⲥⲁ|ⲕⲣⲓⲥⲡⲟⲥ
ⲉⲧⲃⲉⲡⲛⲟⲩⲧⲉ	ⲉⲧⲃⲉ|ⲡ|ⲛⲟⲩⲧⲉ
ϩⲓⲧⲙⲡϩⲗⲗⲱ	ϩⲓⲧⲙ|ⲡ|ϩⲗⲗⲱ
ⲡⲉϥⲥⲟⲛ	ⲡⲉϥ|ⲥⲟⲛ
ⲉⲩⲥⲱⲕ	ⲉ|ⲩ|ⲥⲱⲕ
ⲥⲱⲟⲩϩ	ⲥⲱⲟⲩϩ
ⲉⲛⲙⲟⲩ	ⲉ|ⲛ|ⲙⲟⲩ
ⲉϩⲉⲛⲡⲟⲗⲉⲙⲟⲥ	ⲉ|ϩⲉⲛ|ⲡⲟⲗⲉⲙⲟⲥ
ⲟⲩⲉⲟⲟⲩ	ⲟⲩ|ⲉⲟⲟⲩ
ⲛⲥⲁⲡⲛⲟⲩⲧⲉ	ⲛⲥⲁ|ⲡ|ⲛⲟⲩⲧⲉ
ⲛⲥⲱⲧⲛ	ⲛⲥⲱ|ⲧⲛ
ⲟⲩⲥⲕⲁⲛⲇⲁⲗⲟⲛ	ⲟⲩ|ⲥⲕⲁⲛⲇⲁⲗⲟⲛ
ϩⲛⲛⲉϩⲓⲟⲙⲉ	ϩⲛ|ⲛⲉ|ϩⲓⲟⲙⲉ
ⲡⲉϥϣⲏⲣⲉ	ⲡⲉϥ|ϣⲏⲣⲉ
ⲛⲛϫⲱⲱⲣⲉ	ⲛ|ⲛ|ϫⲱⲱⲣⲉ
ⲉⲕϣⲟⲟⲡ	ⲉ|ⲕ|ϣⲟⲟⲡ
ⲉⲡⲱⲣϫ	ⲉ|ⲡⲱⲣϫ
ⲛⲥⲉϯ	ⲛ|ⲥⲉ|ϯ
ⲛⲉϥϩⲁⲧⲉⲑⲁⲗⲁⲥⲥⲁ	ⲛⲉ|ϥ|ϩⲁ|ⲧⲉ|ⲑⲁⲗⲁⲥⲥⲁ
ⲉⲛⲛⲁϣⲱⲡⲉ	ⲉ|ⲛ|ⲛⲁ|ϣⲱⲡⲉ
ⲧⲟ	ⲧⲟ
ϣⲁⲛⲉⲧϣⲟⲟⲡ	ϣⲁ|ⲛ|ⲉⲧ|ϣⲟⲟⲡ
ⲉⲧⲣⲉⲛⲁⲓ	ⲉ|ⲧⲣⲉ|ⲛⲁⲓ
ⲧⲉⲗⲱⲛⲏⲥ	ⲧⲉⲗⲱⲛⲏⲥ
ⲉⲉⲓⲣⲉ	ⲉ|ⲉⲓⲣⲉ
ⲙⲡⲉϥⲏⲓ	ⲙ|ⲡⲉϥ|ⲏⲓ
ϫⲉⲃⲁⲣⲁⲃⲃⲁⲥ	ϫⲉ|ⲃⲁⲣⲁⲃⲃⲁⲥ
ϯⲛⲁⲣϣⲟⲣⲡ	ϯ|ⲛⲁ|ⲣϣⲟⲣⲡ
ⲛϫⲓⲛϫⲏ	ⲛ|ϫⲓⲛϫⲏ
ⲙⲡϥϣⲓⲛⲉ	ⲙⲡ|ϥ|ϣⲓⲛⲉ
ⲉⲩⲙⲟⲟⲩⲧ	ⲉ|ⲩ|ⲙⲟⲟⲩⲧ
ⲉⲕϩⲓⲛⲉϩⲓⲟⲟⲩⲉ	ⲉ|ⲕ|ϩⲓ|ⲛⲉ|ϩⲓⲟⲟⲩⲉ
ⲥⲉⲛⲁϣⲱⲡⲉ	ⲥⲉ|ⲛⲁ|ϣⲱⲡⲉ
ⲉⲛⲣϩⲟⲧⲉ	ⲉ|ⲛ|ⲣϩⲟⲧⲉ
ⲁϥⲥⲟⲩⲧⲱⲛⲥ	ⲁ|ϥ|ⲥⲟⲩⲧⲱⲛ|ⲥ
ϩⲛⲧⲥⲱϣⲉ	ϩⲛ|ⲧ|ⲥⲱϣⲉ
ⲁⲡⲉϥⲥⲟⲉⲓⲧ	ⲁ|ⲡⲉϥ|ⲥⲟⲉⲓⲧ
ⲙⲛⲛⲉϥⲉⲓⲟⲧⲉ	ⲙⲛ|ⲛⲉ|ϥ|ⲉⲓⲟⲧⲉ
ⲉⲟⲩⲟⲛ	ⲉ|ⲟⲩⲟⲛ
ϩⲙⲡⲛⲟϭ	ϩⲙ|ⲡ|ⲛⲟϭ
ⲛⲟⲩⲟⲣⲅⲏ	ⲛ|ⲟⲩ|ⲟⲣⲅⲏ
ⲉⲧⲛⲁϫⲁϩⲙⲟⲩ	ⲉⲧ|ⲛⲁ|ϫⲁϩⲙ|ⲟⲩ
ⲛⲉϣⲁⲩϫⲱϩ	ⲛⲉ|ϣⲁ|ⲩ|ϫⲱϩ
ⲛⲟⲩⲡⲛⲟⲏ	ⲛ|ⲟⲩ|ⲡ|ⲛⲟⲏ
ⲙⲛⲧⲁⲛ	ⲙⲛⲧⲁ|ⲛ
ⲛϭⲉ	ⲛ|ϭⲉ
ⲉⲧⲣⲉⲩⲉⲓⲣⲉ	ⲉ|ⲧⲣⲉ|ⲩ|ⲉⲓⲣⲉ
ⲛⲥⲉϣⲟⲩⲱϩ	ⲛ|ⲥⲉ|ϣⲟⲩⲱϩ
ⲉⲡϫⲓⲛϭⲟⲛⲥ	ⲉ|ⲡ|ϫⲓⲛϭⲟⲛⲥ
ϣⲁ	ϣⲁ
ⲛⲧⲁϥⲉⲓ	ⲛⲧ|ⲁ|ϥ|ⲉⲓ
ⲙⲛⲟⲩⲙⲛⲧⲁⲧⲥⲃⲱ	ⲙⲛ|ⲟⲩ|ⲙⲛⲧⲁⲧⲥⲃⲱ
ⲙⲛⲡⲉϥⲏⲉⲓ	ⲙⲛ|ⲡⲉϥ|ⲏⲉⲓ
ⲉⲙⲉϥⲉⲓⲙⲉ	ⲉ|ⲙⲉ|ϥ|ⲉⲓⲙⲉ
ⲉⲣⲉⲛⲓⲙ	ⲉⲣⲉ|ⲛⲓⲙ
ⲁⲛⲟⲕ	ⲁⲛⲟⲕ
ⲉⲧⲛⲁⲣⲟⲩⲟⲉⲓⲛ	ⲉⲧ|ⲛⲁ|ⲣⲟⲩⲟⲉⲓⲛ
ⲡⲉⲧⲉⲙⲛⲧⲁϥ	ⲡ|ⲉⲧⲉ|ⲙⲛⲧⲁ|ϥ
ⲛⲧⲟⲕ	ⲛⲧⲟⲕ
ⲛⲛⲉⲧϣⲁⲁⲧ	ⲛ|ⲛ|ⲉⲧ|ϣⲁⲁⲧ
ϩⲙⲡⲥⲟⲟⲩⲛ	ϩⲙ|ⲡ|ⲥⲟⲟⲩⲛ
ⲧⲟⲧⲉ	ⲧⲟⲧⲉ
ⲱⲛⲉ	ⲱⲛⲉ
ⲧⲙ	ⲧⲙ
ⲧⲁⲣⲉⲡⲉⲛϩⲏⲧ	ⲧⲁⲣⲉ|ⲡⲉⲛ|ϩⲏⲧ
ⲉⲙⲁⲁⲃ	ⲉ|ⲙⲁⲁⲃ
ⲁⲩϯⲟⲩⲱ	ⲁ|ⲩ|ϯⲟⲩⲱ
ⲙⲛⲓⲏⲥⲟⲩⲥ	ⲙⲛ|ⲓⲏⲥⲟⲩⲥ
ⲉⲥⲣⲡϣⲁϫⲉ	ⲉ|ⲥⲣ|ⲡ|ϣⲁϫⲉ
ⲉⲕⲟⲧⲧ	ⲉ|ⲕⲟⲧ|ⲧ
ⲉⲧⲉϣϣⲉ	ⲉⲧ|ⲉϣϣⲉ
ⲙⲛⲛⲟⲩϫⲓⲟⲩⲉ	ⲙⲛ|ⲛⲟⲩ|ϫⲓⲟⲩⲉ
ϫⲓⲛⲧⲉⲛⲟⲩ	ϫⲓⲛ|ⲧⲉⲛⲟⲩ
ⲁϥⲥⲟⲟϥ	ⲁ|ϥ|ⲥⲟⲟ|ϥ
ⲛⲧⲕⲟⲩⲕⲱⲥⲙⲓⲕⲟⲛ	ⲛⲧⲕ|ⲟⲩ|ⲕⲱⲥⲙⲓⲕⲟⲛ
ⲉⲛϣⲁⲛϩⲉ	ⲉⲛϣⲁⲛ|ϩⲉ
ϩⲓⲏⲣⲡ	ϩⲓ|ⲏⲣⲡ
ⲙⲙⲛⲧϣⲁϥⲧⲉ	ⲙ|ⲙⲛⲧϣⲁϥⲧⲉ
ⲣϩⲱⲃ	ⲣ|ϩⲱⲃ
ⲙⲙⲓⲛⲙⲙⲟ	ⲙⲙⲓⲛⲙⲙⲟ
ⲡⲉⲩϩⲏⲧ	ⲡⲉⲩ|ϩⲏⲧ
ⲉⲧⲙⲏⲧⲉ	ⲉ|ⲧ|ⲙⲏⲧⲉ
ⲛϩⲉⲛⲣⲱⲙⲉ	ⲛ|ϩⲉⲛ|ⲣⲱⲙⲉ
ⲛⲧⲉⲧⲛϣⲱⲡⲉ	ⲛ|ⲧⲉⲧⲛ|ϣⲱⲡⲉ
ⲛⲉⲩⲱϣ	ⲛⲉ|ⲩ|ⲱϣ
ϫⲉⲁⲕⲧⲛⲛⲟⲟⲩ	ϫⲉ|ⲁ|ⲕ|ⲧⲛⲛⲟⲟⲩ
ⲣⲣⲟⲟⲩϣ	ⲣⲣⲟⲟⲩϣ
ⲛⲟⲃⲉ	ⲛⲟⲃⲉ
ⲛⲁⲧⲥⲃⲱ	ⲛ|ⲁⲧⲥⲃⲱ
ϫⲉⲁⲧⲉⲧⲛⲕⲱ	ϫⲉ|ⲁ|ⲧⲉⲧⲛ|ⲕⲱ
ⲥϩⲟⲩⲟⲣⲧ	ⲥϩⲟⲩⲟⲣⲧ
ϫⲉⲛⲧⲁⲧⲉⲧⲛⲉⲓ	ϫⲉ|ⲛⲧ|ⲁ|ⲧⲉⲧⲛ|ⲉⲓ
ⲉⲩϫⲱⲙⲙⲟⲥ	ⲉ|ⲩ|ϫⲱ|ⲙⲙⲟ|ⲥ
ⲉⲧⲉⲧⲛⲡⲏⲧ	ⲉ|ⲧⲉⲧⲛ|ⲡⲏⲧ
ⲙⲡⲓⲃⲱⲕ	ⲙⲡ|ⲓ|ⲃⲱⲕ
ϩⲛⲟⲩⲕⲣⲟϥ	ϩⲛ|ⲟⲩ|ⲕⲣⲟϥ
ⲛⲧⲉⲣⲉⲡⲣⲏ	ⲛⲧⲉⲣⲉ|ⲡ|ⲣⲏ
ⲉⲛⲛⲉⲟⲩⲁ	ⲉⲛⲛⲉ|ⲟⲩⲁ
ⲛϭⲓⲛϩⲁⲗⲁⲧⲉ	ⲛϭⲓ|ⲛ|ϩⲁⲗⲁⲧⲉ
ϥⲙⲡϣⲁ	ϥ|ⲙⲡϣⲁ
ϫⲉⲉϣⲱⲡⲉ	ϫⲉ|ⲉϣⲱⲡⲉ
ⲛⲁϣ	ⲛ|ⲁϣ
ⲟⲩⲛϭⲟⲙ	ⲟⲩⲛ|ϭⲟⲙ
ⲉⲧⲡⲉⲓⲑⲉ	ⲉⲧ|ⲡⲉⲓⲑⲉ
ⲛⲕⲉⲥⲟⲡ	ⲛ|ⲕⲉ|ⲥⲟⲡ
ⲁⲓⲙⲉⲥⲧⲱϥ	ⲁ|ⲓ|ⲙⲉⲥⲧⲱ|ϥ
ⲉⲁⲧⲉⲧⲛϣⲓⲕⲉ	ⲉ|ⲁ|ⲧⲉⲧⲛ|ϣⲓⲕⲉ
ⲧⲛϩⲕⲁⲉⲓⲧ	ⲧⲛ|ϩⲕⲁⲉⲓⲧ
ϫⲉⲉⲕⲁⲓⲥⲑⲁⲛⲉ	ϫⲉ|ⲉ|ⲕ|ⲁⲓⲥⲑⲁⲛⲉ
ⲉⲣϣⲁⲛⲗⲁⲁⲩ	ⲉⲣϣⲁⲛ|ⲗⲁⲁⲩ
ⲉⲧⲙⲉⲉⲩⲉ	ⲉⲧ|ⲙⲉⲉⲩⲉ
ⲉⲧⲣⲉⲩⲟⲩⲱⲙ	ⲉ|ⲧⲣⲉ|ⲩ|ⲟⲩⲱⲙ
ⲁⲩⲡⲱⲧ	ⲁ|ⲩ|ⲡⲱⲧ
ⲡⲉⲛⲧⲁϥⲙⲟⲩϩ	ⲡ|ⲉⲛⲧ|ⲁ|ϥ|ⲙⲟⲩϩ
ⲛⲥⲉⲙⲟⲩ	ⲛ|ⲥⲉ|ⲙⲟⲩ
ⲧⲧⲟⲉⲓⲥ	ⲧ|ⲧⲟⲉⲓⲥ
ⲡⲛⲟⲩⲧⲉ	ⲡ|ⲛⲟⲩⲧⲉ
ϩⲓⲡⲣⲏϣ	ϩⲓ|ⲡⲣⲏϣ
ϩⲁⲡϩⲟ	ϩⲁ|ⲡ|ϩⲟ
ⲁⲓϫⲟⲟⲥ	ⲁ|ⲓ|ϫⲟⲟ|ⲥ
ⲉⲛⲧⲁⲩⲧⲁⲁϥ	ⲉⲛⲧ|ⲁ|ⲩ|ⲧⲁⲁ|ϥ
ⲛⲉⲩⲛⲁϣϫⲱ	ⲛⲉ|ⲩ|ⲛⲁ|ϣ|ϫⲱ
ⲙⲡϫⲱⲱⲣ	ⲙ|ⲡ|ϫⲱⲱⲣ
ϩⲛⲟⲩⲑⲁⲃ	ϩⲛ|ⲟⲩ|ⲑⲁⲃ
ϯⲛⲁⲗⲟ	ϯ|ⲛⲁ|ⲗⲟ
ⲛⲛⲥⲁⲃⲃⲁⲧⲟⲛ	ⲛ|ⲛ|ⲥⲁⲃⲃⲁⲧⲟⲛ
ⲛⲛⲉⲕⲛⲟⲩⲧⲉ	ⲛ|ⲛⲉⲕ|ⲛⲟⲩⲧⲉ
ⲟⲩϩⲁⲧ	ⲟⲩ|ϩⲁⲧ
ⲙⲡⲧⲉⲗⲱⲛⲏⲥ	ⲙ|ⲡ|ⲧⲉⲗⲱⲛⲏⲥ
ⲁⲩⲥⲙⲓⲛⲉ	ⲁ|ⲩ|ⲥⲙⲓⲛⲉ
ⲛⲧⲁⲕⲱ	ⲛⲧ|ⲁ|ⲕⲱ
ⲛⲧⲁⲩⲛⲟⲩϫⲉ	ⲛⲧ|ⲁ|ⲩ|ⲛⲟⲩϫⲉ
ϩⲛⲟⲩⲛⲁ	ϩⲛ|ⲟⲩ|ⲛⲁ
ⲡⲉ	ⲡⲉ
ⲙⲡⲉⲧⲛⲙⲁ	ⲙ|ⲡⲉⲧⲛ|ⲙⲁ
ⲁⲩϣⲁϫⲉ	ⲁ|ⲩ|ϣⲁϫⲉ
ϫⲉⲛⲧⲁⲡⲁⲓ	ϫⲉ|ⲛⲧ|ⲁ|ⲡⲁⲓ
ⲉⲩϣⲟⲃⲉ	ⲉ|ⲩ|ϣⲟⲃⲉ
ⲛⲅⲕⲁⲧⲟⲟⲧⲕ	ⲛ|ⲅ|ⲕⲁ|ⲧⲟⲟⲧ|ⲕ
ϩⲓϫⲛⲧⲗⲩⲭⲛⲓⲁ	ϩⲓϫⲛ|ⲧ|ⲗⲩⲭⲛⲓⲁ
ϫⲛⲟⲩϥ	ϫⲛⲟⲩ|ϥ
ⲙⲛⲡϭⲟⲗ	ⲙⲛ|ⲡ|ϭⲟⲗ
ⲁⲓϯ	ⲁ|ⲓ|ϯ
ⲉⲧⲅⲁⲗⲓⲗⲁⲓⲁ	ⲉ|ⲧ|ⲅⲁⲗⲓⲗⲁⲓⲁ
ⲉⲧⲉⲣⲉⲡⲉⲩⲉⲓⲱⲧ	ⲉⲧⲉⲣⲉ|ⲡⲉⲩ|ⲉⲓⲱⲧ
ϫⲉⲉⲓⲛⲁⲧⲛⲧⲛ	ϫⲉ|ⲉ|ⲓ|ⲛⲁ|ⲧⲛⲧⲛ
ⲙⲛⲡⲥⲩⲛϩⲉⲇⲣⲓⲟⲛ	ⲙⲛ|ⲡ|ⲥⲩⲛϩⲉⲇⲣⲓⲟⲛ
ⲛⲥⲁⲡⲉⲡⲛⲉⲩⲙⲁ	ⲛⲥⲁ|ⲡⲉ|ⲡⲛⲉⲩⲙⲁ
ⲉϣϫⲉⲉϩⲉ	ⲉϣϫⲉ|ⲉϩⲉ
ⲛⲛⲉⲧⲁⲣⲭⲉⲓ	ⲛ|ⲛ|ⲉⲧ|ⲁⲣⲭⲉⲓ
ⲁⲩⲥⲟϣϥ	ⲁ|ⲩ|ⲥⲟϣ|ϥ
ⲉⲡⲟⲩⲙⲕⲁϩ	ⲉ|ⲡⲟⲩ|ⲙⲕⲁϩ
ⲁⲙⲏⲓⲧⲛ	ⲁⲙⲏⲓ|ⲧⲛ
ⲉⲧⲟⲩϯⲥⲃⲱ	ⲉⲧ|ⲟⲩ|ϯⲥⲃⲱ
ⲕⲛⲁⲁⲡⲁⲣⲛⲁ	ⲕ|ⲛⲁ|ⲁⲡⲁⲣⲛⲁ
ⲉⲥⲛⲁⲣⲥϩⲓⲙⲉ	ⲉ|ⲥ|ⲛⲁ|ⲣⲥϩⲓⲙⲉ
ⲛⲙⲡϣⲁ	ⲛ|ⲙⲡϣⲁ
ⲉⲧⲙⲟⲩϩ	ⲉⲧ|ⲙⲟⲩϩ
ⲁϥⲧⲁϩⲟ	ⲁ|ϥ|ⲧⲁϩⲟ
ⲟⲩϣⲡⲏⲣⲉ	ⲟⲩ|ϣⲡⲏⲣⲉ
ⲁⲥⲣϣⲟⲣⲡ	ⲁ|ⲥ|ⲣϣⲟⲣⲡ
ⲉⲩⲛⲟⲩϫϣⲛⲉ	ⲉ|ⲩ|ⲛⲟⲩϫ|ϣⲛⲉ
ⲛⲥⲉⲛⲁϣϭⲙϭⲟⲙ	ⲛ|ⲥⲉ|ⲛⲁ|ϣ|ϭⲙϭⲟⲙ
ⲛⲟⲩⲡⲗⲏⲅⲏ	ⲛ|ⲟⲩ|ⲡⲗⲏⲅⲏ
ⲉⲧϫⲓ	ⲉⲧ|ϫⲓ
ⲧⲉⲩⲙⲛⲧⲙⲛⲧⲣⲉ	ⲧⲉⲩ|ⲙⲛⲧⲙⲛⲧⲣⲉ
ⲛϭⲓⲡϩⲗⲗⲟ	ⲛϭⲓ|ⲡ|ϩⲗⲗⲟ
ⲉⲓϣⲁⲛϥⲓ	ⲉⲓϣⲁⲛ|ϥⲓ
ⲛϩⲗⲗⲟ	ⲛ|ϩⲗⲗⲟ
ⲛⲧⲉⲣⲉⲓⲙⲟϣⲧϥ	ⲛⲧⲉⲣⲉ|ⲓ|ⲙⲟϣⲧ|ϥ
ⲉⲣⲉⲟⲩⲡⲛⲉⲩⲙⲁ	ⲉⲣⲉ|ⲟⲩ|ⲡⲛⲉⲩⲙⲁ
ⲙⲛⲧϭⲟⲙ	ⲙⲛ|ⲧ|ϭⲟⲙ
ϩⲓⲟⲩⲁⲛⲓⲙ	ϩⲓ|ⲟⲩⲁ|ⲛⲓⲙ
ⲛⲛⲉⲅⲣⲁⲫⲏ	ⲛ|ⲛⲉ|ⲅⲣⲁⲫⲏ
ⲉⲣⲉⲛⲉⲩϩⲓⲟⲙⲉ	ⲉⲣⲉ|ⲛⲉⲩ|ϩⲓⲟⲙⲉ
ⲁⲧⲉⲩⲛⲟⲩ	ⲁ|ⲧⲉ|ⲩⲛⲟⲩ
ⲙⲡⲕⲁϩ	ⲙⲡ|ⲕⲁϩ
ⲙⲛⲛⲉϥⲥⲛⲏⲩ	ⲙⲛ|ⲛⲉϥ|ⲥⲛⲏⲩ
ⲛϭⲟⲙ	ⲛ|ϭⲟⲙ
ⲛⲧⲁⲩϫⲟⲟⲩ	ⲛⲧ|ⲁ|ⲩ|ϫⲟ|ⲟⲩ
ϫⲉⲡⲁⲙⲡϣⲁⲡⲉ	ϫⲉ|ⲡⲁ|ⲙⲡϣⲁ|ⲡⲉ
ⲙⲙⲁⲩⲁⲁϥ	ⲙ|ⲙⲁⲩⲁⲁ|ϥ
ϩⲙⲡⲕⲟⲥⲙⲟⲥ	ϩⲙ|ⲡ|ⲕⲟⲥⲙⲟⲥ
ⲙⲡⲉⲥⲧⲁⲩⲣⲟⲥ	ⲙ|ⲡⲉ|ⲥⲧⲁⲩⲣⲟⲥ
ϩⲓⲧⲟⲟⲧϥ	ϩⲓⲧⲟⲟⲧ|ϥ
ⲛϭⲓⲛⲉⲧϥⲓ	ⲛϭⲓ|ⲛ|ⲉⲧ|ϥⲓ
ⲛⲛⲉⲩⲁⲓⲧⲏⲙⲁ	ⲛ|ⲛⲉⲩ|ⲁⲓⲧⲏⲙⲁ
ⲉⲡⲉⲧⲓϭⲱϣⲧ	ⲉ|ⲡ|ⲉⲧ|ⲓ|ϭⲱϣⲧ
ⲛϩⲉⲛϩⲏⲃⲥ	ⲛ|ϩⲉⲛ|ϩⲏⲃⲥ
ⲛⲉϣⲁⲩ	ⲛ|ⲉϣⲁⲩ
ⲁϥⲁⲣⲭⲉⲥⲑⲁⲓ	ⲁ|ϥ|ⲁⲣⲭⲉⲥⲑⲁⲓ
ⲙⲡϥϣⲁϫⲉ	ⲙⲡ|ϥ|ϣⲁϫⲉ
ⲉⲙⲕⲁϩ	ⲉ|ⲙⲕⲁϩ
ϯϩⲧⲏⲧⲛ	ϯ|ϩⲧⲏ|ⲧⲛ
ⲉⲩⲛⲟⲃⲉ	ⲉ|ⲩ|ⲛⲟⲃⲉ
ⲁⲟⲩⲙⲏⲏϣⲉ	ⲁ|ⲟⲩ|ⲙⲏⲏϣⲉ
ⲉⲗⲉⲟⲩⲉⲓ	ⲉ|ⲗⲉⲟⲩⲉⲓ
ⲡⲉⲛⲛⲟⲩⲧⲉ	ⲡⲉⲛ|ⲛⲟⲩⲧⲉ
ϩⲛⲉⲩⲥⲩⲛⲁⲅⲱⲅⲏ	ϩⲛ|ⲉ|ⲩ|ⲥⲩⲛⲁⲅⲱⲅⲏ
ⲉϩⲏⲗⲉⲓⲁⲥ	ⲉ|ϩⲏⲗⲉⲓⲁⲥ
ⲁⲓⲥϩⲁⲓ	ⲁ|ⲓ|ⲥϩⲁⲓ
ⲉⲛⲉϣⲁⲩ	ⲉ|ⲛ|ⲉϣⲁⲩ
ⲙⲁⲣⲛⲣϣⲁ	ⲙⲁⲣ|ⲛ|ⲣϣⲁ
ⲉⲧⲉⲧⲛϣⲁⲛⲛⲁⲩ	ⲉ|ⲧⲉⲧⲛ|ϣⲁⲛ|ⲛⲁⲩ
ⲉⲧⲃⲉϩⲏⲣⲱⲇⲓⲁⲥ	ⲉⲧⲃⲉ|ϩⲏⲣⲱⲇⲓⲁⲥ
ϩⲛⲛⲉⲧⲛⲕⲃⲁ	ϩⲛ|ⲛⲉⲧⲛ|ⲕⲃⲁ
ϫⲉϫⲓⲧϥ	ϫⲉ|ϫⲓⲧ|ϥ
ⲛⲓⲱⲥⲏⲫ	ⲛ|ⲓⲱⲥⲏⲫ
ⲛⲛⲉⲧⲉⲓⲛⲉ	ⲛ|ⲛ|ⲉⲧ|ⲉⲓⲛⲉ
ⲁϫⲛϩⲟⲧⲉ	ⲁϫⲛ|ϩⲟⲧⲉ
ⲡⲉⲡⲣⲟⲫⲏⲧⲏⲥ	ⲡⲉ|ⲡⲣⲟⲫⲏⲧⲏⲥ
ϩⲁⲡⲣⲁⲛ	ϩⲁ|ⲡ|ⲣⲁⲛ
ⲙⲛⲡⲁϣⲏⲣⲉ	ⲙⲛ|ⲡⲁ|ϣⲏⲣⲉ
ⲛⲥⲱⲓ	ⲛⲥⲱ|ⲓ
ⲙⲛⲟⲩⲁ	ⲙⲛ|ⲟⲩⲁ
ⲉⲩⲣⲓ	ⲉ|ⲩ|ⲣⲓ
ⲙⲉ	ⲙⲉ
ϫⲉⲟⲩⲁ	ϫⲉ|ⲟⲩⲁ
ⲛⲁⲣⲭⲓⲧⲉⲕⲧⲱⲛ	ⲛ|ⲁⲣⲭⲓⲧⲉⲕⲧⲱⲛ
ⲡⲉⲧⲥⲟⲟⲩⲛ	ⲡ|ⲉⲧ|ⲥⲟⲟⲩⲛ
ⲉϣⲁⲧⲉⲧⲛⲥⲟⲟⲩϩⲟⲩ	ⲉ|ϣⲁ|ⲧⲉⲧⲛ|ⲥⲟⲟⲩϩ|ⲟⲩ
ⲛⲥⲉϩⲓⲟⲩⲉ	ⲛ|ⲥⲉ|ϩⲓⲟⲩⲉ
ⲉⲡⲙⲏⲏϣⲉ	ⲉ|ⲡ|ⲙⲏⲏϣⲉ
ⲛⲙⲓⲱⲥⲏ	ⲛⲙ|ⲓⲱⲥⲏ
ⲛⲧⲉⲣⲉⲥⲉⲓ	ⲛⲧⲉⲣⲉ|ⲥ|ⲉⲓ
ⲉⲧϫⲱ	ⲉⲧ|ϫⲱ
ⲙⲡⲥⲱⲙⲁ	ⲙ|ⲡ|ⲥⲱⲙⲁ
ⲧⲉⲩϩⲉⲗⲡⲓⲥ	ⲧⲉⲩ|ϩⲉⲗⲡⲓⲥ
ⲁϥⲥⲗⲡⲡⲉϥⲙⲁⲁϫⲉ	ⲁ|ϥ|ⲥⲗⲡ|ⲡⲉϥ|ⲙⲁⲁϫⲉ
ⲙⲡϫⲟⲉⲓ	ⲙ|ⲡ|ϫⲟⲉⲓ
ⲧⲙⲁⲁⲩ	ⲧ|ⲙⲁⲁⲩ
ⲁⲥⲟϣⲥ	ⲁ|ⲥ|ⲟϣ|ⲥ
ⲁⲩⲁⲙⲁϩⲧⲉ	ⲁ|ⲩ|ⲁⲙⲁϩⲧⲉ
ϯⲟⲩⲱ	ϯⲟⲩⲱ
ϩⲙⲡⲧⲣⲉⲡⲁⲣⲁⲃⲁ	ϩⲙ|ⲡ|ⲧⲣⲉ|ⲡⲁⲣⲁⲃⲁ
ϯϣⲡϩⲙⲟⲧ	ϯ|ϣⲡϩⲙⲟⲧ
ϩⲙⲡⲉⲧⲛⲙⲁ	ϩⲙ|ⲡⲉⲧⲛ|ⲙⲁ
ϩⲛⲙⲁ	ϩⲛ|ⲙⲁ
ⲙⲛⲛⲉϥⲙⲁⲑⲏⲧⲏⲥ	ⲙⲛ|ⲛⲉϥ|ⲙⲁⲑⲏⲧⲏⲥ
ⲛⲉϥϩⲙⲟⲟⲥ	ⲛⲉ|ϥ|ϩⲙⲟⲟⲥ
ⲉϥⲛⲏϫ	ⲉ|ϥ|ⲛⲏϫ
ϫⲓⲛ	ϫⲓⲛ
ⲁⲩⲧϭⲁⲓⲟϥ	ⲁ|ⲩ|ⲧϭⲁⲓⲟ|ϥ
ϩⲛⲛⲧⲟ	ϩⲛ|ⲛ|ⲧⲟ
ⲁⲥϩⲉ	ⲁ|ⲥ|ϩⲉ
ⲙⲡⲣⲟⲩⲱⲙ	ⲙⲡⲣ|ⲟⲩⲱⲙ
ⲛⲁⲕⲣⲓⲛⲉ	ⲛⲁ|ⲕⲣⲓⲛⲉ
ⲇⲁⲩⲉⲓⲇ	ⲇⲁⲩⲉⲓⲇ
ⲉⲧⲙⲣⲛⲟⲃⲉ	ⲉ|ⲧⲙ|ⲣ|ⲛⲟⲃⲉ
ⲉ[.....]ⲛⲥⲁ	ⲉ[.....]|ⲛⲥⲁ
ⲁϩⲉ	ⲁϩⲉ
ϩⲛⲍⲉⲗⲫⲁ	ϩⲛ|ⲍⲉⲗⲫⲁ
ⲁⲛⲇⲣⲉⲁⲥ	ⲁⲛⲇⲣⲉⲁⲥ
ⲛⲧⲉⲛⲧⲁⲥⲙⲟⲩ	ⲛⲧⲉ|ⲛ|ⲧⲁ|ⲥ|ⲙⲟⲩ
ⲡⲁⲣⲭⲏⲉⲡⲓⲥⲕⲟⲡⲟⲥ	ⲡ|ⲁⲣⲭⲏⲉⲡⲓⲥⲕⲟⲡⲟⲥ
ⲛⲥⲉⲁⲡⲟⲧⲁⲥⲥⲉ	ⲛ|ⲥⲉ|ⲁⲡⲟⲧⲁⲥⲥⲉ
ⲉⲧⲣⲉϩⲉⲛϣⲏⲣⲉϣⲱⲡⲉ	ⲉ|ⲧⲣⲉ|ϩⲉⲛ|ϣⲏⲣⲉ|ϣⲱⲡⲉ
ⲉⲛⲟⲛϩ	ⲉ|ⲛ|ⲟⲛϩ
ⲛⲧϩⲟ	ⲛ|ⲧ|ϩⲟ
ϩⲛⲧⲉϩⲣⲱ	ϩⲛ|ⲧⲉ|ϩⲣⲱ
ⲛⲛϩⲏⲕⲉ	ⲛ|ⲛ|ϩⲏⲕⲉ
ⲡⲉϥⲟⲩⲟⲉⲓ	ⲡⲉϥ|ⲟⲩⲟⲉⲓ
ⲙⲡⲁⲧⲉⲧⲛⲕⲁⲡⲓⲥⲧⲓⲥ	ⲙⲡⲁⲧⲉ|ⲧⲛ|ⲕⲁ|ⲡⲓⲥⲧⲓⲥ
ϫⲉⲧⲁⲟⲩⲉ	ϫⲉ|ⲧⲁⲟⲩⲉ
ⲉⲧⲙⲁⲥⲧⲓⲅⲟⲩ	ⲉⲧ|ⲙⲁⲥⲧⲓⲅⲟⲩ
ϩⲉⲛϩⲃⲏⲩⲉ	ϩⲉⲛ|ϩⲃⲏⲩⲉ
ⲉⲛⲛⲁⲕⲁⲁⲥ	ⲉ|ⲛ|ⲛⲁ|ⲕⲁⲁ|ⲥ
ⲉⲧⲉⲛⲉⲧⲙⲟⲟϣⲉ	ⲉⲧⲉ|ⲛ|ⲉⲧ|ⲙⲟⲟϣⲉ
ϩⲙⲡⲁϣⲁⲓ	ϩⲙ|ⲡ|ⲁϣⲁⲓ
ⲛⲛⲉⲕϭⲓϫ	ⲛ|ⲛⲉ|ⲕ|ϭⲓϫ
ⲁⲓⲧⲛⲛⲟⲟⲩⲟⲟⲩ	ⲁ|ⲓ|ⲧⲛⲛⲟⲟⲩ|ⲟⲟⲩ
ⲛⲕⲉⲡⲁⲣⲁⲃⲟⲗⲏ	ⲛ|ⲕⲉ|ⲡⲁⲣⲁⲃⲟⲗⲏ
ⲉⲁⲡϫⲟⲉⲓⲥ	ⲉ|ⲁ|ⲡ|ϫⲟⲉⲓⲥ
ϩⲓϫⲙⲡⲓⲉⲣⲟ	ϩⲓϫⲙ|ⲡ|ⲓⲉⲣⲟ
ⲙⲡⲟⲩϩⲏⲧ	ⲙ|ⲡⲟⲩ|ϩⲏⲧ
ϫⲉⲟⲩⲡⲛⲉⲩⲙⲁ	ϫⲉ|ⲟⲩ|ⲡⲛⲉⲩⲙⲁ
ⲛⲅⲥⲟⲧⲟⲩ	ⲛ|ⲅ|ⲥⲟⲧ|ⲟⲩ
ϩⲙⲡⲁⲓ	ϩⲙ|ⲡⲁⲓ
ⲟⲩⲥⲙⲏ	ⲟⲩ|ⲥⲙⲏ
ϩⲛⲕⲉⲥⲟⲡ	ϩⲛ|ⲕⲉ|ⲥⲟⲡ
ⲉⲩⲛϩⲉⲛⲕⲟⲟⲩⲉ	ⲉⲩ|ⲛ|ϩⲉⲛ|ⲕⲟⲟⲩⲉ
ϩⲱⲱⲧⲉ	ϩⲱⲱ|ⲧⲉ
ⲉⲧⲃⲉⲛⲥⲱⲧⲡ	ⲉⲧⲃⲉ|ⲛ|ⲥⲱⲧⲡ
ⲙⲙⲓⲛ	ⲙⲙⲓⲛ
ⲙⲛⲛⲟⲩϩⲃⲏⲩⲉ	ⲙⲛ|ⲛⲟⲩ|ϩⲃⲏⲩⲉ
ⲁⲛⲅⲡⲁⲡⲁⲩⲗⲟⲥ	ⲁⲛⲅ|ⲡⲁ|ⲡⲁⲩⲗⲟⲥ
ⲙⲛⲛϩⲩⲡⲏⲣⲉⲧⲏⲥ	ⲙⲛ|ⲛ|ϩⲩⲡⲏⲣⲉⲧⲏⲥ
ⲉⲧϥⲓ	ⲉⲧ|ϥⲓ
ⲉϥⲛⲉϫ	ⲉ|ϥ|ⲛⲉϫ
ⲗⲩⲡⲉⲓ	ⲗⲩⲡⲉⲓ
ϩⲛⲧϭⲓϫ	ϩⲛ|ⲧ|ϭⲓϫ
ⲙⲛⲧⲓⲣⲏⲛⲏ	ⲙⲛ|ⲧ|ⲓⲣⲏⲛⲏ
ⲛⲧⲟⲗⲏ	ⲛⲧⲟⲗⲏ
ⲥⲟ	ⲥⲟ
ⲁⲧⲉⲧⲛⲥⲱⲧⲙ	ⲁ|ⲧⲉⲧⲛ|ⲥⲱⲧⲙ
ⲛⲁⲣⲱⲕϩ	ⲛⲁ|ⲣⲱⲕϩ
ⲟⲩⲱϣ	ⲟⲩⲱϣ
ⲉⲡⲟⲩϣⲁϫⲉ	ⲉ|ⲡⲟⲩ|ϣⲁϫⲉ
ⲛϥⲧⲱⲟⲩⲛ	ⲛ|ϥ|ⲧⲱⲟⲩⲛ
ⲙⲁⲧⲙⲙⲟϥ	ⲙⲁ|ⲧⲙⲙⲟ|ϥ
ϫⲉⲉⲕϣⲁⲛⲟⲩⲱϣ	ϫⲉ|ⲉ|ⲕ|ϣⲁⲛ|ⲟⲩⲱϣ
ⲉⲣⲡⲉⲓⲑⲉⲓ	ⲉ|ⲣⲡⲉⲓⲑⲉⲓ
ⲛⲧⲉⲥⲡⲓⲣⲁ	ⲛ|ⲧⲉ|ⲥⲡⲓⲣⲁ
ⲛⲛⲁⲛⲟⲩⲡⲉⲧⲛϣⲟⲩϣⲟⲩ	ⲛ|ⲛⲁⲛⲟⲩ|ⲡⲉⲧⲛ|ϣⲟⲩϣⲟⲩ
ⲙⲛⲛⲥⲁⲧⲣⲁⲧⲱⲟⲩⲛ	ⲙⲛⲛⲥⲁ|ⲧⲣ|ⲁ|ⲧⲱⲟⲩⲛ
ⲛⲧⲉⲡⲛⲟⲩⲧⲉ	ⲛⲧⲉ|ⲡ|ⲛⲟⲩⲧⲉ
ⲣ	ⲣ
ϫⲉⲁⲛⲅⲡⲁⲁⲡⲟⲗⲗⲱ	ϫⲉ|ⲁⲛⲅ|ⲡⲁ|ⲁⲡⲟⲗⲗⲱ
ϫⲉϯϩⲧⲏⲧⲛ	ϫⲉ|ϯ|ϩⲧⲏ|ⲧⲛ
ⲙⲡⲃⲓⲟⲥ	ⲙ|ⲡ|ⲃⲓⲟⲥ
ⲉⲧⲉⲧⲛⲕⲧⲟ	ⲉ|ⲧⲉⲧⲛ|ⲕⲧⲟ
ⲉⲛⲉϫⲧⲁϥ	ⲉ|ⲛⲉϫⲧⲁϥ
ⲙⲛⲛⲁⲙⲁⲑⲏⲧⲏⲥ	ⲙⲛ|ⲛⲁ|ⲙⲁⲑⲏⲧⲏⲥ
ⲉⲉⲓⲙⲉ	ⲉ|ⲉⲓⲙⲉ
ⲙⲁⲩⲁⲁⲧⲉ	ⲙⲁⲩⲁⲁⲧ|ⲉ
ⲙⲛϫⲓⲛϭⲟⲛⲥ	ⲙⲛ|ϫⲓ|ⲛ|ϭⲟⲛⲥ
ⲡⲉⲧⲉⲣⲉⲡⲉϥϩⲱⲃ	ⲡ|ⲉⲧⲉⲣⲉ|ⲡⲉϥ|ϩⲱⲃ
ⲛⲧⲁⲩ	ⲛⲧ|ⲁ|ⲩ
ⲙⲡⲣϣⲧⲟⲣⲧⲣ	ⲙⲡⲣ|ϣⲧⲟⲣⲧⲣ
ϩⲉⲛϭⲉⲣⲱⲃ	ϩⲉⲛ|ϭⲉⲣⲱⲃ
ϫⲉⲙⲡⲁⲧⲛⲱⲥⲕ	ϫⲉ|ⲙⲡⲁ|ⲧⲛ|ⲱⲥⲕ
ⲛⲧⲁⲩⲉⲓ	ⲛⲧ|ⲁ|ⲩ|ⲉⲓ
ⲃⲃⲟⲗ	ⲃⲃⲟⲗ
ϫⲉⲉⲓⲉⲛⲁⲩ	ϫⲉ|ⲉ|ⲓ|ⲉ|ⲛⲁⲩ
ⲉϫⲛⲛⲉⲩⲉⲓⲟⲧⲉ	ⲉϫⲛ|ⲛⲉⲩ|ⲉⲓⲟⲧⲉ
ⲛⲣⲉϥⲣⲛⲟⲃⲉ	ⲛ|ⲣⲉϥⲣ|ⲛⲟⲃⲉ
ⲙⲛⲛⲉϥϣⲏⲣⲉ	ⲙⲛ|ⲛⲉϥ|ϣⲏⲣⲉ
ⲙⲡⲉϥϩⲟⲩⲟ	ⲙ|ⲡⲉϥ|ϩⲟⲩⲟ
ϩⲓϫⲛⲟⲩⲡⲓⲛⲁⲝ	ϩⲓϫⲛ|ⲟⲩ|ⲡⲓⲛⲁⲝ
ⲛⲏ	ⲛⲏ
ⲉⲛϫⲟⲓ	ⲉ|ⲛ|ϫⲟⲓ
ⲁϥⲧⲟⲩⲛⲟⲥ	ⲁ|ϥ|ⲧⲟⲩⲛⲟⲥ
ϫⲉⲛϯⲛⲁⲙⲟⲩⲧⲉ	ϫⲉ|ⲛ|ϯ|ⲛⲁ|ⲙⲟⲩⲧⲉ
ⲕⲁⲧⲁⲛⲉⲅⲣⲁⲫⲏ	ⲕⲁⲧⲁ|ⲛⲉ|ⲅⲣⲁⲫⲏ
ⲛϥⲧⲙⲣϣⲁⲩ	ⲛ|ϥ|ⲧⲙ|ⲣϣⲁⲩ
ⲛϩⲉⲛϣⲧⲏⲛ	ⲛ|ϩⲉⲛ|ϣⲧⲏⲛ
ⲛⲧϭⲟⲙ	ⲛ|ⲧ|ϭⲟⲙ
ⲥⲟⲛⲧϥ	ⲥⲟⲛⲧ|ϥ
ⲉⲡⲙⲟⲟⲩ	ⲉ|ⲡ|ⲙⲟⲟⲩ
ϩⲙⲡⲉⲕϩⲏⲧ	ϩⲙ|ⲡⲉⲕ|ϩⲏⲧ
ⲛⲉⲧⲧⲁϩⲉ	ⲛ|ⲉⲧ|ⲧⲁϩⲉ
ⲉⲡϩⲱⲃ	ⲉ|ⲡ|ϩⲱⲃ
ⲛⲟⲩⲱϩⲉ	ⲛ|ⲟⲩⲱϩⲉ
ⲙⲛⲁⲛⲛⲁ	ⲙⲛ|ⲁⲛⲛⲁ
ⲧⲃⲃⲟ	ⲧⲃⲃⲟ
ϩⲛⲛⲣⲓ	ϩⲛ|ⲛ|ⲣⲓ
ⲡⲕⲁⲛⲁⲛⲁⲓⲟⲥ	ⲡ|ⲕⲁⲛⲁⲛⲁⲓⲟⲥ
ⲙⲁⲧⲥⲟϥ	ⲙⲁ|ⲧⲥⲟ|ϥ
ϫⲉⲉⲧⲃⲉⲟⲩ	ϫⲉ|ⲉⲧⲃⲉ|ⲟⲩ
ⲉⲡⲉⲛⲕⲁⲣⲱϥ	ⲉ|ⲡⲉⲛ|ⲕⲁⲣⲱϥ
ⲛⲧⲁⲩⲧⲁⲁⲥ	ⲛⲧ|ⲁ|ⲩ|ⲧⲁⲁ|ⲥ
ⲛⲉⲧⲙⲙⲁⲩ	ⲛ|ⲉⲧ|ⲙⲙⲁⲩ
ⲛⲉϥϫⲱ	ⲛⲉ|ϥ|ϫⲱ
ⲛⲛⲉⲩⲉⲣⲏⲧ	ⲛ|ⲛⲉⲩ|ⲉⲣⲏⲧ
ϫⲉⲙⲡⲛⲛⲁⲩ	ϫⲉ|ⲙⲡ|ⲛ|ⲛⲁⲩ
ⲛⲥⲉⲛⲁϭⲙϭⲟⲙ	ⲛ|ⲥⲉ|ⲛⲁ|ϭⲙϭⲟⲙ
ⲉⲁⲩϣⲱⲡⲉ	ⲉ|ⲁ|ⲩ|ϣⲱⲡⲉ
ⲧⲟⲟⲧϥ	ⲧⲟⲟⲧ|ϥ
ϩⲛⲛⲉⲧⲟⲩⲁⲁⲃ	ϩⲛ|ⲛ|ⲉⲧ|ⲟⲩⲁⲁⲃ
ⲉⲛⲛⲉⲧⲛⲃⲱⲕ	ⲉ|ⲛⲛⲉ|ⲧⲛ|ⲃⲱⲕ
ⲁⲩⲧⲁⲗⲉ	ⲁ|ⲩ|ⲧⲁⲗⲉ
ⲉⲡϣⲁϫⲉ	ⲉ|ⲡ|ϣⲁϫⲉ
ⲛⲥⲉⲛⲁⲗⲟ	ⲛ|ⲥⲉ|ⲛⲁ|ⲗⲟ
ⲛⲛⲉϥⲕⲗⲏⲣⲟⲛⲟⲙⲉⲓ	ⲛⲛⲉ|ϥ|ⲕⲗⲏⲣⲟⲛⲟⲙⲉⲓ
ⲙⲡϥⲕⲁⲗⲁⲁⲩ	ⲙⲡ|ϥ|ⲕⲁ|ⲗⲁⲁⲩ
ϫⲉⲁⲩⲙⲉⲣⲉ	ϫⲉ|ⲁ|ⲩ|ⲙⲉⲣⲉ
ⲛⲧⲉⲣⲉϥⲙⲕⲁϩ	ⲛⲧⲉⲣⲉ|ϥ|ⲙⲕⲁϩ
ⲉⲩⲙⲟⲟⲛⲉ	ⲉ|ⲩ|ⲙⲟⲟⲛⲉ
ⲉⲧⲥⲩⲛⲁⲅⲱⲅⲏ	ⲉ|ⲧ|ⲥⲩⲛⲁⲅⲱⲅⲏ
ϫⲉⲥⲣϥⲉ	ϫⲉ|ⲥⲣϥⲉ
ϫⲉⲃⲉⲉⲗⲍⲉⲃⲟⲩⲗ	ϫⲉ|ⲃⲉⲉⲗⲍⲉⲃⲟⲩⲗ
ⲙⲡⲕⲉⲛⲧⲩⲣⲓⲱⲛ	ⲙ|ⲡ|ⲕⲉⲛⲧⲩⲣⲓⲱⲛ
ϩⲛⲥⲉ	ϩⲛ|ⲥⲉ
ϫⲉⲉⲩⲉϫⲱϩ	ϫⲉ|ⲉⲩⲉ|ϫⲱϩ
ⲁⲟⲩⲁ	ⲁ|ⲟⲩⲁ
ⲉϥⲉϣⲱⲡⲉ	ⲉ|ϥ|ⲉ|ϣⲱⲡⲉ
ⲉⲧⲉϥⲡⲟⲗⲓⲥ	ⲉ|ⲧⲉϥ|ⲡⲟⲗⲓⲥ
ⲙⲡⲣⲣϩⲟⲧⲉϩⲏⲧⲟⲩ	ⲙⲡⲣ|ⲣ|ϩⲟⲧⲉ|ϩⲏⲧ|ⲟⲩ
ϩⲩⲡⲏⲣⲉⲧⲏⲥ	ϩⲩⲡⲏⲣⲉⲧⲏⲥ
ϫⲉⲛⲧⲟⲕ	ϫⲉ|ⲛⲧⲟⲕ
ⲁⲡⲣⲱⲙⲉ	ⲁ|ⲡ|ⲣⲱⲙⲉ
ⲃⲏⲑⲥⲁⲓⲇⲁ	ⲃⲏⲑⲥⲁⲓⲇⲁ
ⲁⲡⲙⲏⲏϣⲉ	ⲁ|ⲡ|ⲙⲏⲏϣⲉ
ⲛϩⲁϩ	ⲛ|ϩⲁϩ
ⲡⲃⲟⲗ	ⲡ|ⲃⲟⲗ
ⲛϩⲏⲧⲕ	ⲛϩⲏⲧ|ⲕ
ⲉⲩⲥⲏϩ	ⲉ|ⲩ|ⲥⲏϩ
ⲛⲙϩⲉⲛϩⲁⲗⲩⲥⲓⲥ	ⲛⲙ|ϩⲉⲛ|ϩⲁⲗⲩⲥⲓⲥ
ⲉⲡⲟⲟⲩ	ⲉ|ⲡ|ⲟⲟⲩ
ⲇⲓⲁⲃⲟⲗⲟⲥ	ⲇⲓⲁⲃⲟⲗⲟⲥ
ⲙⲉⲉⲩⲉ	ⲙⲉⲉⲩⲉ
ⲛⲉϩⲉⲛⲟⲩⲱϩⲉ	ⲛⲉ|ϩⲉⲛ|ⲟⲩⲱϩⲉ
ϣⲏⲣⲉ	ϣⲏⲣⲉ
ⲛϭⲓⲁⲡⲁ	ⲛϭⲓ|ⲁⲡⲁ
ⲁⲩⲁⲩⲝⲁⲛⲉ	ⲁ|ⲩ|ⲁⲩⲝⲁⲛⲉ
ⲡⲉⲛ	ⲡⲉⲛ
ⲡⲙⲁⲑⲏⲧⲏⲥ	ⲡ|ⲙⲁⲑⲏⲧⲏⲥ
ⲙⲙⲛⲧⲥⲟϭ	ⲙ|ⲙⲛⲧⲥⲟϭ
ⲛⲟⲓ	ⲛⲟⲓ
ϫⲉⲛⲧⲛⲟⲩⲉϣϫⲱⲕⲙ	ϫⲉ|ⲛ|ⲧⲛ|ⲟⲩⲉϣ|ϫⲱⲕⲙ
ⲉⲙⲡϥⲕⲁⲥⲡⲉⲣⲙⲁ	ⲉ|ⲙⲡ|ϥ|ⲕⲁ|ⲥⲡⲉⲣⲙⲁ
ⲉⲧⲉⲧⲛϫⲏⲕ	ⲉ|ⲧⲉⲧⲛ|ϫⲏⲕ
ⲙⲡⲣⲱⲙⲉ	ⲙ|ⲡ|ⲣⲱⲙⲉ
ⲛⲧⲉⲩⲁⲡⲉ	ⲛ|ⲧⲉⲩ|ⲁⲡⲉ
ⲛⲉⲧⲉⲧⲛⲑⲗⲓⲃⲉ	ⲛⲉ|ⲧⲉⲧⲛ|ⲑⲗⲓⲃⲉ
ⲁⲓϫⲡⲉⲧⲏⲩⲧⲛ	ⲁ|ⲓ|ϫⲡⲉ|ⲧⲏⲩⲧⲛ
ⲉⲧⲙϥⲓ	ⲉ|ⲧⲙ|ϥⲓ
ⲁϥϫⲡⲟ	ⲁ|ϥ|ϫⲡⲟ
ϣⲁϥⲣ	ϣⲁ|ϥ|ⲣ
ⲕⲁⲧⲁⲡⲉⲙⲡϣⲁ	ⲕⲁⲧⲁ|ⲡⲉ|ⲙⲡϣⲁ
ⲛⲟⲩⲥⲟⲡ	ⲛ|ⲟⲩ|ⲥⲟⲡ
ⲟⲩⲟⲙϥ	ⲟⲩⲟⲙ|ϥ
ⲧⲟⲟⲃⲉϥ	ⲧⲟⲟⲃⲉ|ϥ
ⲙⲉϩⲣⲟ	ⲙⲉϩⲣⲟ